GEOID,COUNTY,POP_TOT,MALE_POP,FEMALE_POP,GDP,DEGREE_TOT,BACHELOR,MASTER,PROFFE,DOCTOR,TOT_NO_INS,MALE_INS,FEMALE_INS,BOTH_INS,TOT_POV,MALE_POV,FEMALE_POV,TOT_COMM,OTHER_COMM,preciMax,maxTemp,PER_PROF,PER_POV,POP_GRAD,PER_NO_INS,PER_COMM,PER_MALE
01001,"Autauga County, Alabama",55049,26877,28172,27824,36466,5204,3041,480,243,54387,2279,2573,4852,6697,2764,3933,24302,275,8.83,94,6.837544732874348,12.165525259314428,3764,98.79743501244346,44.146124361932095,0.48823775182110485
01003,"Baldwin County, Alabama",199510,97371,102139,29364,139946,27056,10063,2967,1264,197046,12704,10551,23255,25551,11658,13893,86310,697,9.36,92.1,7.1645531552303146,12.806876848278282,14294,98.76497418675756,43.26098942408902,0.48805072427447244
01005,"Barbour County, Alabama",26614,14239,12375,17561,18387,1431,736,124,75,23682,1752,1327,3079,6235,2673,3562,8783,134,6,94.4,3.5131885473810778,23.427519350717667,935,88.98324190275795,33.00142781994439,0.5350191628466221
01007,"Bibb County, Alabama",22572,12084,10488,20911,15750,971,763,56,100,20598,820,1039,1859,3390,1439,1951,8280,111,6.63,93,4.071415913521177,15.018607123870282,919,91.25465178096756,36.68261562998405,0.5353535353535354
01009,"Blount County, Alabama",57704,28572,29132,22021,39472,3522,1261,239,129,57255,3457,2931,6388,9441,4461,4980,21350,74,6.03,91.2,2.8230278663524193,16.361084153611536,1629,99.22189103008456,36.999168168584504,0.4951476500762512
01011,"Bullock County, Alabama",10552,5719,4833,20856,7333,356,270,90,36,10170,1151,551,1702,2728,1215,1513,4165,112,6.97,94.3,3.7528430629264595,25.85291887793783,396,96.37983320697498,39.47119029567855,0.5419825625473844
01013,"Butler County, Alabama",20280,9522,10758,19004,13949,1328,674,136,105,19998,1107,1250,2357,5126,2099,3027,7691,49,6.27,92.8,4.511834319526627,25.276134122287967,915,98.6094674556213,37.92406311637081,0.4695266272189349
01015,"Calhoun County, Alabama",115883,55742,60141,23638,78661,8247,4138,860,641,114387,6718,5697,12415,22135,9138,12997,45797,380,6.91,93.2,4.866114960779407,19.10116237929636,5639,98.7090427413857,39.52003313687081,0.48101964912886275
01017,"Chambers County, Alabama",34018,16299,17719,22002,23854,2086,624,203,65,33647,1922,2057,3979,6805,2953,3852,13846,44,8.67,93.3,2.6221412193544595,20.004115468281498,892,98.90940090540302,40.70198130401552,0.47912869657240287
01019,"Cherokee County, Alabama",25897,12883,13014,23010,18694,1463,766,279,102,25566,1259,1158,2417,4188,2037,2151,9952,22,7.84,92.8,4.429084449936286,16.171757346410782,1147,98.72185967486581,38.429161678958955,0.49747074950766496
01021,"Chilton County, Alabama",43817,21559,22258,23368,29735,2830,1243,236,108,43491,3405,3470,6875,8779,4051,4728,17304,287,8.31,92.9,3.6218819179770407,20.035602619987674,1587,99.25599653102677,39.491521555560624,0.4920236437912226
01023,"Choctaw County, Alabama",13287,6349,6938,20994,9448,740,296,81,13,13159,797,719,1516,2743,1152,1591,4143,76,7.94,92.3,2.9351998193723188,20.644238729585307,390,99.03665236697523,31.180853465793632,0.4778354782870475
01025,"Clarke County, Alabama",24847,11738,13109,20765,17022,1317,551,110,88,24561,1539,1716,3255,6023,2517,3506,8011,211,7.62,92,3.0144484243570653,24.24035094780054,749,98.84895560832294,32.24131685917817,0.4724111562764116
01027,"Clay County, Alabama",13483,6532,6951,21330,9446,626,291,64,64,13214,914,791,1705,2195,909,1286,5382,28,6.74,92.5,3.107616999184158,16.27975969739672,419,98.00489505302974,39.916932433434695,0.4844619150040792
01029,"Cleburne County, Alabama",14991,7423,7568,20873,10366,651,340,138,66,14807,1056,993,2049,2889,1266,1623,5575,48,6.8,92.7,3.628843973050497,19.271562937762656,544,98.77259689146821,37.188980054699485,0.49516376492562203
01031,"Coffee County, Alabama",50991,25210,25781,26216,34614,5251,2252,436,253,49139,2749,2504,5253,8219,3669,4550,21990,160,8.98,92.9,5.767684493341962,16.118530721107646,2941,96.36798650742288,43.12525739836442,0.4944009727206762
01033,"Colbert County, Alabama",54377,26271,28106,23675,38271,4501,1990,353,225,53950,2608,2324,4932,8910,3715,5195,21628,101,5.83,91.6,4.722584916416867,16.385604207661327,2568,99.21474152674844,39.774169225959504,0.48312705739559003
01035,"Conecuh County, Alabama",12697,6028,6669,16337,8808,434,281,39,9,12648,1121,1292,2413,4107,1805,2302,3753,3,6.93,92.3,2.591163266913444,32.346223517366305,329,99.61408206662992,29.558163345672206,0.4747578168071198
01037,"Coosa County, Alabama",10864,5355,5509,20342,7907,489,259,7,31,10524,719,602,1321,1610,650,960,3630,19,8.18,93.5,2.73379970544919,14.81958762886598,297,96.87039764359352,33.41310751104565,0.49291237113402064
01039,"Covington County, Alabama",37729,18219,19510,22431,26492,2653,977,272,51,37212,2384,2233,4617,7031,3088,3943,14210,189,8.21,92.4,3.4456253810066526,18.635532349121366,1300,98.62970129078428,37.663335895465025,0.48289114474277084
01041,"Crenshaw County, Alabama",13896,6863,7033,21580,9551,1045,318,21,15,13718,821,728,1549,2484,1107,1377,5550,36,6.8,92.9,2.547495682210708,17.875647668393782,354,98.71905584340817,39.939550949913645,0.49388313183649973
01043,"Cullman County, Alabama",81316,40200,41116,21857,56323,5435,2159,641,196,80496,5878,5826,11704,13718,6382,7336,31809,261,6.23,90.7,3.6843917556200503,16.869988686113434,2996,98.99158837129224,39.117762801908604,0.4943676521225835
01045,"Dale County, Alabama",49607,24443,25164,23194,33363,3540,1445,292,84,46897,3204,2926,6130,9897,4311,5586,20525,293,8.49,93.5,3.670852903824057,19.950813393271112,1821,94.53706130183241,41.375209143870826,0.4927328804402604
01047,"Dallas County, Alabama",41426,19128,22298,18248,27038,2233,1134,277,83,41115,2719,2422,5141,14027,5546,8481,13879,205,8.18,94.2,3.6064307439772123,33.86037754067494,1494,99.24926374740501,33.503113986385365,0.4617390044899339
01049,"DeKalb County, Alabama",70937,35134,35803,20020,47440,3154,1630,371,237,70207,5846,5400,11246,13872,6092,7780,27645,196,8.66,89.9,3.154912105107349,19.55538012602732,2238,98.97091785668974,38.971199797002974,0.4952845482611331
01051,"Elmore County, Alabama",80957,39347,41610,26251,54950,7600,3736,571,313,75952,3648,3017,6665,10893,4478,6415,32720,153,8.4,94.7,5.706733204046593,13.455291080450115,4620,93.8177056956162,40.41651741047717,0.4860234445446348
01053,"Escambia County, Alabama",37875,19390,18485,18164,25762,1901,759,259,76,35409,2751,3493,6244,8894,3778,5116,11737,49,7.34,92.3,2.8884488448844885,23.48250825082508,1094,93.48910891089109,30.98877887788779,0.5119471947194719
01055,"Etowah County, Alabama",103363,50007,53356,22278,71696,7513,3101,805,405,102507,6824,5541,12365,18713,8174,10539,40546,163,7.94,92.1,4.170738078422646,18.10415719357991,4311,99.17185066222923,39.226802627632715,0.48379981231194913
01057,"Fayette County, Alabama",16783,8311,8472,21191,11806,1048,521,19,82,16591,779,621,1400,2863,1239,1624,6057,21,6.17,92.8,3.7061312041947208,17.058928677828757,622,98.85598522314247,36.09009116367753,0.49520347971161294
01059,"Franklin County, Alabama",31573,15553,16020,19314,20928,1660,702,131,100,31322,2018,2397,4415,6951,2689,4262,12197,449,6.37,90.7,2.955056535647547,22.01564628004941,933,99.20501694485795,38.63110885883508,0.49260444050296137
01061,"Geneva County, Alabama",26765,13072,13693,21084,18805,1559,588,46,0,26412,2019,1864,3883,6011,2521,3490,10100,212,12.03,93.3,2.368765178404633,22.45843452269755,634,98.6811133943583,37.735849056603776,0.4883990285821035
01063,"Greene County, Alabama",8587,4092,4495,14197,5965,457,103,30,5,8534,718,481,1199,3233,1458,1775,2330,38,7.23,93.8,1.6070804704786306,37.6499359496914,138,99.38278793525096,27.134039827646443,0.47653429602888087
01065,"Hale County, Alabama",15159,7121,8038,20269,10229,992,302,121,20,14922,856,793,1649,3858,1546,2312,4933,62,6.31,93.9,2.9223563559601557,25.45022758757174,443,98.43657233326736,32.541724388152254,0.46975394155287287
01067,"Henry County, Alabama",17187,8301,8886,23983,12221,1102,722,120,29,16936,1072,868,1940,2586,1203,1383,6958,221,7.98,94.1,5.067783790073893,15.046255891080468,871,98.53959387909467,40.4840868097981,0.48298132309303543
01069,"Houston County, Alabama",103891,49782,54109,24781,70773,9614,3799,951,511,102993,6644,5838,12482,19415,8297,11118,43371,265,10.44,93.6,5.0639612670972465,18.687855540903445,5261,99.13563253794842,41.746638303606666,0.479175289486096
01071,"Jackson County, Alabama",52608,25763,26845,20946,37119,2929,1378,183,179,52100,3492,2731,6223,9780,4443,5337,20676,162,7.38,90.7,3.3074817518248176,18.590328467153284,1740,99.03436739659368,39.30200729927007,0.4897163929440389
01073,"Jefferson County, Alabama",659096,311971,347125,29456,446097,84843,34094,13929,7388,651846,37463,33618,71081,116750,50114,66636,292781,1869,6.96,92.7,8.407121269132267,17.7136562807239,55411,98.9000084964861,44.42160170900749,0.4733316542658429
01075,"Lamar County, Alabama",14066,6813,7253,21152,9998,814,380,64,48,13922,830,938,1768,3322,1301,2021,5093,23,6.53,93,3.497796104080762,23.617233044220104,492,98.97625479880563,36.207877150575854,0.48435944831508604
01077,"Lauderdale County, Alabama",92641,44261,48380,25803,63148,8196,4132,725,637,91796,5124,4991,10115,16538,6886,9652,38705,157,6.17,91.8,5.93041957664533,17.851707127513738,5494,99.08787685797864,41.77955764726201,0.47776902235511276
01079,"Lawrence County, Alabama",33433,16272,17161,22419,23427,1700,619,73,23,33206,1989,1680,3669,6050,2774,3276,12429,45,6,91.1,2.1386055693476504,18.095893279095506,715,99.32103011994137,37.17584422576496,0.4867047527891604
01081,"Lee County, Alabama",153947,76027,77920,26170,90099,17732,8781,1497,2995,152225,7870,6599,14469,34085,15745,18340,70201,382,9.05,93.6,8.621798411141496,22.140736747062302,13273,98.88143322052395,45.6007587026704,0.4938517801581064
01083,"Limestone County, Alabama",90257,45146,45111,26685,62036,9700,3843,477,410,87228,5552,5361,10913,12290,5359,6931,37985,167,6.63,91.8,5.240590757503573,13.616672391061082,4730,96.64402761004686,42.085378419402375,0.5001938907785546
01085,"Lowndes County, Alabama",10565,5045,5520,18976,7165,679,162,20,19,10470,806,519,1325,3005,1380,1625,3390,25,6.95,94.2,1.902508282063417,28.442972077614765,201,99.10080454330335,32.08707998106957,0.477520113582584
01087,"Macon County, Alabama",19684,9072,10612,19564,12414,1369,793,175,151,19476,1282,816,2098,4442,1978,2464,7375,104,7.85,94.7,5.684820158504369,22.566551513919936,1119,98.9433042064621,37.46697825645194,0.46088193456614507
01089,"Madison County, Alabama",349973,171085,178888,34232,236871,60122,28283,3884,4051,345445,18552,17185,35737,45287,20613,24674,165459,1743,6.95,92,10.348798335871624,12.94014109659888,36218,98.70618590576987,47.27764713277882,0.4888519971540662
01091,"Marengo County, Alabama",20066,9433,10633,22996,13679,1414,455,90,64,19852,1247,1184,2431,5504,2176,3328,6554,144,7.11,94.4,3.0349845509817603,27.42948270706668,609,98.93351938602612,32.66221469151799,0.47009867437456393
01093,"Marion County, Alabama",30239,14958,15281,21835,21538,1713,816,123,33,29669,1535,1303,2838,5509,2603,2906,11521,130,6.79,91.7,3.2143920103178014,18.21819504613248,972,98.11501703098648,38.09980488772777,0.49465921492112835
01095,"Marshall County, Alabama",94534,46597,47937,22710,63366,6877,2765,546,310,93661,7629,6760,14389,19138,8207,10931,37549,166,7.12,91,3.830367909958322,20.244568091903442,3621,99.07652273256183,39.72010070450843,0.4929126028730404
01097,"Mobile County, Alabama",414291,198297,215994,24347,274893,41373,15122,3390,2000,405929,26880,26501,53381,78633,31981,46652,169768,1327,9.56,91.9,4.9511092444682605,18.980137149974293,20512,97.98161195874397,40.977959936373225,0.4786418242250013
01099,"Monroe County, Alabama",21975,10522,11453,17264,14893,1158,505,57,126,21750,1772,1799,3571,6972,3135,3837,6424,53,7.35,92.5,3.130830489192264,31.726962457337883,688,98.97610921501706,29.233219567690558,0.4788168373151308
01101,"Montgomery County, Alabama",227392,107740,119652,26712,150072,28639,13291,3287,1995,222470,14598,12332,26930,46982,20176,26806,100032,518,7.15,95,8.167833520968196,20.66123698283141,18573,97.83545595271602,43.990993526597244,0.4738073459048691
01103,"Morgan County, Alabama",119555,58849,60706,25013,82033,11960,4384,853,382,117739,7737,7105,14842,19172,7992,11180,49680,244,6.36,91.5,4.699928903015349,16.03613399690519,5619,98.48103383380034,41.55409644096859,0.49223369997072475
01105,"Perry County, Alabama",9856,4671,5185,13449,5941,475,307,13,66,9707,710,783,1493,3605,1846,1759,2477,95,7.55,94.3,3.916396103896104,36.57670454545455,386,98.48823051948052,25.131899350649352,0.473924512987013
01107,"Pickens County, Alabama",20042,9877,10165,20089,14084,1105,354,60,47,19132,1300,820,2120,4575,1969,2606,6728,45,7.48,93.4,2.300169643748129,22.82706316734857,461,95.45953497654925,33.56950404151282,0.49281508831453946
01109,"Pike County, Alabama",33277,15865,17412,20808,19618,2888,1425,123,270,33074,1804,1686,3490,8074,3842,4232,14002,43,6.29,93.2,5.463232863539382,24.263004477567087,1818,99.3899690476906,42.077110316434776,0.47675571716200377
01111,"Randolph County, Alabama",22615,11025,11590,20983,15599,1555,723,60,61,22369,1363,1307,2670,4542,2093,2449,8266,54,6.71,92.9,3.732036259120053,20.08401503426929,844,98.91222639840814,36.55096175105019,0.4875082909573292
01113,"Russell County, Alabama",58636,28519,30117,21279,38568,4152,1862,336,212,56906,4563,4090,8653,12423,5158,7265,24308,114,6.9,94.5,4.11010300839075,21.186643017941197,2410,97.04959410600996,41.45576096595948,0.48637355890579165
01115,"St. Clair County, Alabama",86576,43498,43078,24686,60054,6314,2493,471,393,84654,4092,3519,7611,11582,5103,6479,37613,453,6.69,92.6,3.87751801885049,13.377841434115691,3357,97.77998521530216,43.44506560709665,0.5024256144890039
01117,"Shelby County, Alabama",205951,100098,105853,35330,139017,38107,14250,3520,1708,204231,9053,7633,16686,17227,7524,9703,101261,521,6.79,93.1,9.457589426611184,8.364610999703814,19478,99.16484989147904,49.16752042961675,0.4860282300158776
01119,"Sumter County, Alabama",13285,6135,7150,14739,8278,907,464,61,68,13155,1229,1163,2392,4582,2012,2570,4199,9,8.28,93.9,4.463680843056078,34.49002634550244,593,99.02145276627776,31.607075649228452,0.4617990214527663
01121,"Talladega County, Alabama",81057,39342,41715,21382,55993,4519,2197,408,206,78252,4665,4023,8688,16119,6947,9172,30027,198,6.44,93.6,3.4679299752026354,19.886006143824716,2811,96.5394722232503,37.04430215774085,0.4853621525593101
01123,"Tallapoosa County, Alabama",40958,19395,21563,22430,28910,3372,1189,326,119,40412,2147,2191,4338,9431,3812,5619,14904,91,8.23,94,3.9894526099907224,23.02602666145808,1634,98.6669270960496,36.3884955320084,0.4735338639582011
01125,"Tuscaloosa County, Alabama",202471,97672,104799,24895,123155,22314,9408,1937,2511,200972,10356,9191,19547,34470,14323,20147,88779,390,5.62,92.9,6.843449185315428,17.024660321725086,13856,99.25964706056669,43.84776091390866,0.48239994863461927
01127,"Walker County, Alabama",65593,31944,33649,21217,45633,2805,1409,480,117,64876,4261,3945,8206,14174,6461,7713,23352,171,6.32,92.2,3.0582531672587012,21.60901315689174,2006,98.90689555287912,35.60135990120897,0.48700318631561296
01129,"Washington County, Alabama",16909,8389,8520,23239,11524,710,321,77,1,16778,1011,1285,2296,3585,1497,2088,5536,39,8.36,92,2.359690105860784,21.20172689100479,399,99.2252646519605,32.739960967532085,0.4961263232598025
01131,"Wilcox County, Alabama",11119,5362,5757,15774,7441,545,184,81,31,10843,902,743,1645,3768,1676,2092,2961,21,6.21,93.6,2.6621099019696017,33.88793956291033,296,97.51776238870401,26.630092634229698,0.48223761129597986
01133,"Winston County, Alabama",24013,11814,12199,20580,17274,1387,615,132,127,23694,1537,1515,3052,4833,1933,2900,8471,122,6.89,90.5,3.639695165118894,20.126598092699787,874,98.67155290884105,35.27672510723358,0.49198350893266146
04001,"Apache County, Arizona",72346,35740,36606,13865,43657,3129,1416,145,138,71536,9038,7840,16878,25658,12634,13024,18056,127,2.65,88.6,2.348436679291184,35.465678821220244,1699,98.88038039421669,24.957841483979763,0.4940148729715534
04003,"Cochise County, Arizona",128177,65281,62896,24896,88171,13036,5886,853,648,115890,5744,5910,11654,22184,9444,12740,46332,570,3.48,95.2,5.7631244294998325,17.307317225399252,7387,90.41403683968262,36.14689062780374,0.5093035411969387
04005,"Coconino County, Arizona",138064,68229,69835,25722,80322,16006,7938,1640,1893,137298,12218,10291,22509,28193,13307,14886,63961,898,3.08,91.3,8.308465639123884,20.420239888747247,11471,99.44518484181249,46.32706570865685,0.4941838567620814
04007,"Gila County, Arizona",53179,26432,26747,22433,38557,4161,1987,331,360,52446,3787,3573,7360,11097,5018,6079,17506,283,3.39,95.2,5.035822411102127,20.867259632561726,2678,98.62163636021738,32.91900938340322,0.4970383045939187
04009,"Graham County, Arizona",37529,20148,17381,17874,22996,1863,944,171,86,33491,2125,1675,3800,7419,3352,4067,11566,119,3.62,95.2,3.200191851634736,19.768712195901834,1201,89.24032081856697,30.818833435476567,0.5368648245356924
04011,"Greenlee County, Arizona",9224,4905,4319,24935,5772,546,153,5,0,9184,521,531,1052,1216,588,628,3545,64,3.1,90.3,1.7129228100607112,13.183000867302688,158,99.56634865568083,38.43235039028621,0.531764960971379
04012,"La Paz County, Arizona",20304,10366,9938,21707,15369,1021,433,37,113,20114,1227,1235,2462,4243,1987,2256,6263,38,1.94,107.5,2.8713553979511426,20.89736012608353,583,99.06422379826635,30.84613869188337,0.5105397951142632
04013,"Maricopa County, Arizona",4088549,2021817,2066732,30186,2672410,527975,216435,52167,31038,4059129,305121,251219,556340,666513,309270,357243,1844233,22411,1.78,106.8,7.3287613772025235,16.301944773072304,299640,99.28042931612168,45.10727399867288,0.4945072200431009
04015,"Mohave County, Arizona",203629,102473,101156,23527,151909,11921,4326,1006,792,197267,14928,12633,27561,37884,17942,19942,65396,868,3.02,98.7,3.00743017939488,18.604422749215484,6124,96.8756905941688,32.115268453903916,0.5032338222944669
04017,"Navajo County, Arizona",108209,54271,53938,17685,68065,5990,2975,502,397,105980,9716,8044,17760,31575,14551,17024,31629,601,2.41,91,3.580108863403229,29.179643098078717,3874,97.94009740409763,29.229546525704887,0.5015386890184735
04019,"Pima County, Arizona",1003338,493568,509770,27323,662883,117924,58810,14222,13216,984069,65235,55785,121020,186299,86015,100284,423598,5638,2.37,102.1,8.596106197512702,18.567920282098356,86248,98.07951059363843,42.21887340058883,0.49192595117497795
04021,"Pinal County, Arizona",397604,207471,190133,22944,269816,32073,13874,1809,2083,374716,23275,20206,43481,61430,28302,33128,138406,1562,1.97,103.4,4.468264906791682,15.450045774187382,17766,94.24351867687447,34.810011971710544,0.5218031005724288
04023,"Santa Cruz County, Arizona",46547,22284,24263,19482,28782,4333,1342,513,286,46228,3369,3776,7145,10083,4519,5564,17222,218,4.38,93.4,4.59965196468086,21.661976067200893,2141,99.31467119255807,36.999162137194666,0.47874191677229466
04025,"Yavapai County, Arizona",218586,106905,111681,27504,165655,25781,11918,2566,2046,217066,14415,13468,27883,31512,14837,16675,81006,618,4.2,95.6,7.562240948642639,14.416293815706403,16530,99.3046215219639,37.05909802091625,0.48907523812138015
04027,"Yuma County, Arizona",203292,104216,99076,20600,126271,11922,4789,1020,435,195819,18921,16253,35174,40330,18268,22062,74388,531,1,108.7,3.071444031245696,19.838458965429037,6244,96.32400684729355,36.59170060799244,0.5126419140940126
05001,"Arkansas County, Arkansas",18569,8798,9771,23766,12745,1276,451,22,90,18335,980,768,1748,3587,1386,2201,7864,42,13.75,91.8,3.031934945339006,19.317141472346385,563,98.73983520921966,42.350153481609134,0.4738004200549303
05003,"Ashley County, Arkansas",20989,10185,10804,20703,14337,1330,475,70,73,20822,1224,1312,2536,4131,1946,2185,7856,179,19.93,93.9,2.9443994473295536,19.681738053265995,618,99.20434513316499,37.42912954404688,0.4852541807613512
05005,"Baxter County, Arkansas",40992,19848,21144,24737,31435,3869,1257,321,129,40535,2156,1579,3735,5600,2766,2834,15045,112,7.9,90.3,4.164227166276347,13.66120218579235,1707,98.88514832162373,36.702283372365336,0.484192037470726
05007,"Benton County, Arkansas",245231,121493,123738,30611,158777,32516,12489,2548,1228,243727,14477,13504,27981,27562,12673,14889,114069,559,7.54,89.2,6.632521989471152,11.239198959348533,16265,99.38670070260285,46.514918586964946,0.49542268310287035
05009,"Boone County, Arkansas",37301,18285,19016,22288,26136,2542,1067,122,181,36886,2380,1843,4223,6409,2798,3611,14916,148,6.35,88.7,3.6728237848851237,17.181844990750918,1370,98.8874292914399,39.98820406959599,0.49020133508485025
05011,"Bradley County, Arkansas",11096,5485,5611,21575,7582,798,221,38,22,11005,788,789,1577,3163,1328,1835,3934,93,14.34,94,2.5324441240086517,28.505767844268206,281,99.17988464311463,35.45421773612112,0.49432227829848596
05013,"Calhoun County, Arkansas",5210,2679,2531,22866,3704,312,102,10,21,5152,319,312,631,969,458,511,2158,22,12.9,93.9,2.55278310940499,18.598848368522074,133,98.88675623800384,41.42034548944338,0.5142034548944338
05015,"Carroll County, Arkansas",27690,13639,14051,21754,19478,2157,951,119,219,27466,2156,2399,4555,4789,2069,2720,11116,35,6.32,88.5,4.6551101480678945,17.295052365474902,1289,99.19104369808595,40.14445648248465,0.4925604911520404
05017,"Chicot County, Arkansas",11189,5452,5737,20560,7728,718,220,58,19,10515,645,698,1343,3252,1320,1932,3660,94,19.2,93.4,2.6543927071230673,29.064259540620252,297,93.97622665117527,32.710698006971135,0.48726427741531864
05019,"Clark County, Arkansas",22684,10769,11915,20382,13141,2010,928,96,214,22352,1298,1185,2483,4762,1806,2956,9908,33,9.62,93.7,5.457591253747134,20.99277023452654,1238,98.53641333098219,43.67836360430259,0.47473990477869865
05021,"Clay County, Arkansas",15202,7490,7712,19171,10812,775,354,67,31,15070,947,838,1785,3340,1513,1827,6174,49,9.32,90.9,2.9732929877647676,21.97079331666886,452,99.13169319826339,40.6130772266807,0.49269832916721484
05023,"Cleburne County, Arkansas",25587,12731,12856,26189,18821,1817,690,242,146,25237,1877,1596,3473,3901,1728,2173,9625,135,8.96,90.7,4.213076953140266,15.24602337124321,1078,98.63211787235706,37.61675851018095,0.49755735334349477
05025,"Cleveland County, Arkansas",8421,4216,4205,23171,5760,594,250,52,11,8331,363,432,795,1671,752,919,3152,64,12.88,92.8,3.7168982306139413,19.843249020306377,313,98.93124332027075,37.43023393896212,0.5006531290820567
05027,"Columbia County, Arkansas",24168,11514,12654,20296,15040,2240,939,49,68,23748,1235,1509,2744,5581,2363,3218,9930,60,12,94.2,4.369414101290963,23.092519033432637,1056,98.26216484607745,41.08738828202582,0.47641509433962265
05029,"Conway County, Arkansas",21060,10306,10754,22365,14516,1641,633,76,106,20904,1100,1173,2273,4482,2073,2409,8222,83,9.45,93.5,3.869895536562203,21.28205128205128,815,99.25925925925925,39.040835707502374,0.489363722697056
05031,"Craighead County, Arkansas",102884,50128,52756,25594,65447,10543,4154,973,948,101881,7715,6191,13906,18682,8451,10231,46201,344,12.22,91.7,5.904708215077174,18.1583142179542,6075,99.02511566424323,44.90591345593095,0.48722833482368494
05033,"Crawford County, Arkansas",61927,30446,31481,22104,41418,3906,1180,266,260,61391,4086,3761,7847,11491,5578,5913,25208,36,5.95,91.7,2.754856524617695,18.555718830235598,1706,99.13446477303923,40.70599253960308,0.49164338656805595
05035,"Crittenden County, Arkansas",49511,23382,26129,20721,31056,3688,1347,250,116,48967,2676,2956,5632,11991,4975,7016,19914,413,14.33,92,3.4598372078931954,24.21886045525237,1713,98.9012542667286,40.221364949203206,0.47225868998808346
05037,"Cross County, Arkansas",17329,8379,8950,22894,11608,1047,520,103,42,17105,957,817,1774,3364,1338,2026,7002,115,13.69,91.8,3.837497835997461,19.412545444053322,665,98.7073691499798,40.406255410006345,0.4835247273356801
05039,"Dallas County, Arkansas",7738,3748,3990,18309,5399,503,166,16,0,7161,392,429,821,1054,481,573,2914,16,11.53,92.6,2.3520289480485914,13.621090721116568,182,92.54329284052727,37.65830964073404,0.48436288446627035
05041,"Desha County, Arkansas",12234,5608,6626,18187,8010,726,299,15,16,12164,607,796,1403,3859,1537,2322,4375,82,16.58,92.1,2.697400686611084,31.543240150400525,330,99.42782409677946,35.76099395128331,0.45839463789439266
05043,"Drew County, Arkansas",18688,9034,9654,20300,11575,1572,571,55,99,18289,1415,911,2326,4851,2222,2629,7279,31,17.12,93.5,3.8794948630136985,25.957833904109588,725,97.86494006849315,38.950128424657535,0.4834118150684932
05045,"Faulkner County, Arkansas",120417,59053,61364,25240,72992,13492,5737,869,1153,119053,7420,6471,13891,18590,8274,10316,56370,462,8.96,94.4,6.4434423710937825,15.438019548734813,7759,98.86726957157212,46.8123271631082,0.49040417881196174
05047,"Franklin County, Arkansas",17799,8795,9004,19988,12041,1125,312,88,42,17472,912,798,1710,3684,1784,1900,6382,18,6.37,91,2.483285577841452,20.697792010787122,442,98.16281813585033,35.85594696331255,0.4941288836451486
05049,"Fulton County, Arkansas",12186,6031,6155,19674,8909,605,360,8,10,12018,855,519,1374,2769,1319,1450,4275,40,8.33,90.8,3.1019202363367797,22.722796651895617,378,98.62136878385031,35.08124076809453,0.49491219432135236
05051,"Garland County, Arkansas",97119,46875,50244,25690,69592,9123,3757,820,652,95872,7547,6555,14102,19639,9032,10607,39036,158,9.38,92.6,5.3841163932907055,20.22158383014652,5229,98.71600819613052,40.193988817842026,0.48265529916906064
05053,"Grant County, Arkansas",18046,8867,9179,25814,12376,1619,677,71,88,17886,824,799,1623,2318,1041,1277,7621,72,12.43,93.2,4.632605563559792,12.844951789870331,836,99.11337692563448,42.230965310872215,0.4913554250249363
05055,"Greene County, Arkansas",43745,21558,22187,22094,29009,3262,1165,211,132,43269,2703,2420,5123,7621,3235,4386,17837,208,10.03,91.1,3.447251114413076,17.421419590810377,1508,98.91187564293062,40.77494570808092,0.4928106069265059
05057,"Hempstead County, Arkansas",22208,10653,11555,18817,14775,1173,614,31,46,21968,1548,1656,3204,5861,2623,3238,8480,98,9.79,94.3,3.111491354466859,26.391390489913544,691,98.9193083573487,38.184438040345825,0.4796920028818444
05059,"Hot Spring County, Arkansas",33440,17232,16208,20868,23482,2021,992,90,63,31449,1774,1924,3698,5347,2268,3079,13107,89,9.77,92.9,3.424043062200957,15.989832535885167,1145,94.04605263157895,39.19557416267943,0.5153110047846889
05061,"Howard County, Arkansas",13487,6493,6994,23627,9063,945,416,62,4,13311,970,1054,2024,2605,991,1614,5356,65,8.9,93.7,3.573811818788463,19.314895825609845,482,98.69503966782828,39.71231556313487,0.4814265589085786
05063,"Independence County, Arkansas",37030,17995,19035,23056,25007,2815,1136,249,206,36530,2456,2304,4760,6891,2868,4023,15376,179,9.16,91,4.29651633810424,18.60923575479341,1591,98.64974345125574,41.52308938698353,0.4859573318930597
05065,"Izard County, Arkansas",13461,6980,6481,19737,10025,839,371,11,20,12627,808,840,1648,2775,1364,1411,4458,16,8.94,90.6,2.986405170492534,20.615110318698463,402,93.80432360151549,33.1178961444172,0.5185350271153704
05067,"Jackson County, Arkansas",17495,8579,8916,19458,12561,766,290,22,8,14277,1166,794,1960,3866,1818,2048,5362,42,11.52,92,1.8290940268648186,22.097742212060588,320,81.60617319234066,30.648756787653614,0.49036867676478996
05069,"Jefferson County, Arkansas",72385,35626,36759,20371,48054,5384,1999,439,342,68132,3354,3801,7155,16959,7468,9491,26757,629,12.9,92.6,3.840574704704013,23.42888720038682,2780,94.1244733024798,36.96484078192996,0.4921737929128963
05071,"Johnson County, Arkansas",26025,12928,13097,18757,17050,1813,687,126,92,25840,1881,1459,3340,5418,2471,2947,10120,163,6.64,89.4,3.4774255523535063,20.818443804034583,905,99.28914505283382,38.88568683957733,0.49675312199807875
05073,"Lafayette County, Arkansas",7127,3498,3629,25140,5074,551,83,40,20,6995,508,447,955,1830,777,1053,2433,32,11.49,94.8,2.006454328609513,25.67700294654132,143,98.14788831205276,34.137785884663955,0.49080959730601936
05075,"Lawrence County, Arkansas",16915,8310,8605,19422,11438,969,471,32,62,16606,1086,1026,2112,3840,1799,2041,6313,75,12.44,91.4,3.3402305645876442,22.70174401418859,565,98.17321903635826,37.32190363582619,0.49127992905705
05077,"Lee County, Arkansas",9781,5575,4206,15610,6939,368,181,10,7,8175,746,424,1170,2447,1051,1396,2717,27,14.94,91.9,2.0243328902975155,25.017891831101114,198,83.58041100092015,27.778345772415907,0.5699826193640732
05079,"Lincoln County, Arkansas",13935,8622,5313,13142,10073,570,153,24,39,9248,542,630,1172,2158,934,1224,3140,29,15.34,92.7,1.55005382131324,15.486185862935056,216,66.36526731252242,22.53318980983136,0.6187298170075349
05081,"Little River County, Arkansas",12616,6266,6350,23412,8921,672,170,18,7,12453,893,733,1626,2384,1062,1322,4590,41,9.25,94.9,1.5456563094483196,18.896639188332276,195,98.70798985415345,36.38237159162968,0.4966708941027267
05083,"Logan County, Arkansas",21935,10961,10974,19708,15278,1519,406,41,22,21672,1016,1175,2191,4071,1873,2198,8337,62,7.42,91.6,2.138135400045589,18.55937998632323,469,98.80100296330066,38.00775017095965,0.4997036699338956
05085,"Lonoke County, Arkansas",71279,35076,36203,25184,46472,6390,2210,362,103,69752,3643,3420,7063,8535,3491,5044,32760,182,11.66,93.4,3.752858485668991,11.974073710349472,2675,97.85771405322745,45.96024074411818,0.4920944457694412
05087,"Madison County, Arkansas",15761,7918,7843,23203,10820,809,202,106,109,15678,1179,1161,2340,2823,1179,1644,6622,81,6.37,87,2.6457712074106974,17.911300044413426,417,99.47338366854895,42.015100564684985,0.5023792906541463
05089,"Marion County, Arkansas",16404,8105,8299,19200,12503,1253,573,61,28,16261,923,887,1810,3220,1392,1828,5337,0,6.76,89.7,4.035601072909047,19.629358693001706,662,99.12826139965863,32.53474762253109,0.4940868080955864
05091,"Miller County, Arkansas",43666,21577,22089,22227,29461,2885,1099,173,114,42496,3258,3358,6616,8749,3551,5198,17920,130,10.32,95,3.1740942609810836,20.036183758530665,1386,97.3205697796913,41.03879448541199,0.49413731507351255
05093,"Mississippi County, Arkansas",44199,21480,22719,20378,28100,2223,1001,120,207,43396,3023,2957,5980,11057,4678,6379,16709,330,11.68,91.4,3.004592864091948,25.016403086042672,1328,98.18321681486006,37.80402271544605,0.48598384578836623
05095,"Monroe County, Arkansas",7542,3509,4033,20486,5247,357,101,14,3,7471,535,523,1058,2139,929,1210,2869,17,14.47,91.9,1.5645717316361707,28.361177406523467,118,99.058605144524,38.04030761071334,0.4652612039246884
05097,"Montgomery County, Arkansas",9100,4529,4571,21480,6746,495,278,40,31,8959,744,569,1313,1677,755,922,3264,2,11.04,92.7,3.8351648351648353,18.428571428571427,349,98.45054945054945,35.86813186813187,0.4976923076923077
05099,"Nevada County, Arkansas",8668,4489,4179,18644,6017,598,240,43,25,8480,694,561,1255,2615,1403,1212,3102,59,9.55,94.5,3.553299492385787,30.168435625288417,308,97.83110290724504,35.786802030456855,0.5178818643285649
05101,"Newton County, Arkansas",7988,4013,3975,18053,5893,543,264,28,39,7927,555,507,1062,1713,722,991,2940,47,6.35,86.9,4.14371557336004,21.44466700050075,331,99.2363545317977,36.80520781171758,0.5023785678517777
05103,"Ouachita County, Arkansas",24728,11647,13081,19780,17182,1808,897,101,49,24335,1269,1265,2534,5970,2120,3850,10048,43,12.06,94.2,4.2340666450986735,24.14267227434487,1047,98.41070850857328,40.63409899708832,0.47100452927855063
05105,"Perry County, Arkansas",10246,5104,5142,21781,7171,529,186,25,22,10126,520,532,1052,1804,716,1088,3930,12,7.65,93.6,2.2740581690415773,17.60687097403865,233,98.82881124341206,38.35643177825493,0.4981456178020691
05107,"Phillips County, Arkansas",19929,9353,10576,17287,12645,891,400,102,82,19754,1646,1403,3049,6588,2909,3679,6564,81,14.94,92,2.93040293040293,33.05735360529881,584,99.12188268352652,32.93692608761102,0.46931607205579806
05109,"Pike County, Arkansas",11017,5412,5605,20180,7692,653,410,42,37,10872,853,770,1623,1997,916,1081,4452,97,9.78,93.6,4.438594898792775,18.12653172369974,489,98.68385222837433,40.410275029499864,0.4912408096578016
05111,"Poinsett County, Arkansas",24131,11833,12298,18361,16322,1069,363,72,59,23816,1693,1619,3312,5238,2365,2873,9060,83,13.05,92,2.047159255729145,21.70651858605114,494,98.69462517094195,37.545066511955575,0.4903650905474286
05113,"Polk County, Arkansas",20290,9887,10403,18735,14094,1119,479,61,70,20153,1393,1629,3022,5069,2427,2642,7101,40,8.73,92.2,3.0064070970921635,24.982750123213407,610,99.32479053721045,34.99753573188763,0.4872843765401676
05115,"Pope County, Arkansas",63107,31051,32056,21650,39650,5435,2225,433,366,62447,3669,3637,7306,11620,5418,6202,26984,366,7.69,90.8,4.791861441678419,18.413171280523557,3024,98.9541572250305,42.75912339360134,0.4920373334178459
05117,"Prairie County, Arkansas",8334,4093,4241,22653,5997,555,166,51,9,8201,517,476,993,1617,713,904,3326,46,12.05,92.6,2.7117830573554116,19.402447804175665,226,98.40412766978642,39.908807295416366,0.49112071034317256
05119,"Pulaski County, Arkansas",391806,187819,203987,29855,263171,54619,20840,6773,4439,386040,24817,19957,44774,69467,31575,37892,180388,1069,11.14,93.8,8.18057916417819,17.7299479844617,32052,98.52835331771335,46.040132106195415,0.4793673399590614
05121,"Randolph County, Arkansas",17584,8679,8905,20932,12276,1059,510,52,58,17241,1366,1005,2371,3357,1673,1684,6775,72,11.96,90.7,3.5259326660600547,19.091219290263876,620,98.04936305732484,38.529344858962695,0.493573703366697
05123,"St. Francis County, Arkansas",27023,14625,12398,16518,18555,1156,625,103,45,23540,1994,1469,3463,5761,2525,3236,8884,190,14.44,91.8,2.8605262184065428,21.318876512600376,773,87.11097953595086,32.875698479073385,0.5412056396403064
05125,"Saline County, Arkansas",115577,56728,58849,28410,79783,12870,4957,994,750,114378,5664,4276,9940,9706,4613,5093,54369,362,10.05,92.6,5.797866357493273,8.397864627045173,6701,98.96259636432855,47.04136636181939,0.4908242989522137
05127,"Scott County, Arkansas",10661,5397,5264,18077,7144,406,225,90,35,10592,607,497,1104,2204,1078,1126,4071,47,7.48,92,3.2829940906106367,20.673482787730983,350,99.3527811649939,38.18591126535972,0.5062376887721602
05129,"Searcy County, Arkansas",7938,3974,3964,21475,5871,528,284,25,11,7847,577,470,1047,1619,801,818,2964,57,7.73,88.6,4.031242126480222,20.395565633660873,320,98.85361552028219,37.33938019652305,0.5006298815822625
05131,"Sebastian County, Arkansas",127351,62214,65137,23916,83893,10756,3354,993,660,126307,8597,8648,17245,27745,12465,15280,54324,318,6.71,92.9,3.9316534616924876,21.78624431688797,5007,99.1802184513667,42.65690885819507,0.48852384355050216
05133,"Sevier County, Arkansas",17193,8586,8607,18388,10638,615,324,37,22,17030,1636,1538,3174,3804,1755,2049,7101,40,9.77,94.5,2.2276507881114407,22.125283545629035,383,99.05193974291863,41.301692549293314,0.49938928633746293
05135,"Sharp County, Arkansas",17027,8345,8682,20078,12290,767,348,65,60,16849,1353,1114,2467,3711,1510,2201,5799,93,10.89,90.8,2.7779409173665357,21.794796499676984,473,98.9546015152405,34.05767310741763,0.4901039525459564
05137,"Stone County, Arkansas",12503,6341,6162,19881,9144,727,395,199,0,12400,748,701,1449,2925,1318,1607,4257,107,9.29,89.7,4.750859793649524,23.394385347516597,594,99.17619771254898,34.047828521154926,0.507158282012317
05139,"Union County, Arkansas",40334,19599,20735,23463,27433,3875,1036,258,106,39945,2664,2555,5219,8220,3472,4748,16000,46,14.19,94.3,3.471017007983339,20.379828432587892,1400,99.0355531313532,39.668765805523876,0.485917588139039
05141,"Van Buren County, Arkansas",16892,8363,8529,20568,12417,1126,373,146,46,16699,1360,1207,2567,3084,1250,1834,5399,56,9.75,90.3,3.344778593417002,18.257163154155812,565,98.8574473123372,31.961875443997158,0.4950864314468387
05143,"Washington County, Arkansas",219930,109797,110133,26371,131905,23824,10905,3603,2792,218127,16238,13283,29521,40272,18790,21482,103030,377,7.21,88.5,7.866139226117401,18.311280862092485,17300,99.18019369799481,46.84672395762288,0.4992361205838221
05145,"White County, Arkansas",78823,38642,40181,23120,50487,5529,2974,418,844,78229,5307,4314,9621,13201,5859,7342,32003,80,10.33,92.8,5.374065945219035,16.747649797647895,4236,99.24641284904152,40.601093589434555,0.490237620998947
05147,"Woodruff County, Arkansas",6873,3266,3607,19987,4845,395,87,7,6,6752,629,471,1100,1622,689,933,2435,21,11.18,92.4,1.4549687181725592,23.59959260875891,100,98.2394878510112,35.42848828750182,0.47519278335515786
05149,"Yell County, Arkansas",21716,10731,10985,20209,14543,1482,483,90,36,21406,1560,1133,2693,3738,1539,2199,8623,150,7.02,92.8,2.8043838644317556,17.21311475409836,609,98.57248111991159,39.70804936452385,0.49415177749125067
06001,"Alameda County, California",1605217,786730,818487,41363,1113279,282754,141689,32639,31512,1594193,73903,59331,133234,189590,85682,103908,736979,8225,5.65,83.8,12.823188391351449,11.810864200914892,205840,99.31323926920784,45.91148735653809,0.49010819097978653
06003,"Alpine County, California",1184,692,492,27448,790,140,67,8,20,1184,121,54,175,221,106,115,401,1,8.87,76.5,8.02364864864865,18.66554054054054,95,100,33.86824324324324,0.5844594594594594
06005,"Amador County, California",36963,19839,17124,29628,28746,4212,1192,540,240,33012,1422,901,2323,3684,1767,1917,12196,105,9.96,91.9,5.335064794524254,9.966723480236993,1972,89.31093255417579,32.99515731948164,0.5367259151042935
06007,"Butte County, California",223877,110926,112951,26304,144395,25225,8002,2915,1611,221452,13358,10356,23714,46456,22614,23842,87941,576,14.46,93.2,5.595929907940521,20.750680060926314,12528,98.91681593017594,39.280944447174114,0.4954774273373326
06009,"Calaveras County, California",44787,22156,22631,31652,33853,4645,1550,424,226,44402,2078,1589,3667,5641,2346,3295,15995,75,9.56,92.3,4.9121396833902695,12.595172706365686,2200,99.1403755554067,35.71348828901244,0.4946971219327037
06011,"Colusa County, California",21361,11097,10264,25676,13392,1474,233,195,30,21174,1903,1393,3296,2859,1330,1529,8944,47,6.61,95.1,2.144094377604045,13.384204859323065,458,99.12457281962455,41.870698937315666,0.519498150835635
06013,"Contra Costa County, California",1107925,540671,567254,42898,752880,192616,73252,22496,14818,1102457,51057,42563,93620,111922,49151,62771,506484,5639,6.44,86.6,9.979556377913667,10.101947333980188,110566,99.50646478777895,45.71464674955435,0.4880032493174177
06015,"Del Norte County, California",27628,15168,12460,20809,19394,1688,678,311,214,24148,1384,1221,2605,5219,2282,2937,8396,62,22.7,82.3,4.3542782684233385,18.89025626176343,1203,87.40408281453598,30.389459968148255,0.5490082524974663
06017,"El Dorado County, California",183000,91349,91651,38156,130300,27316,10371,3390,1900,181900,7992,5920,13912,17839,8477,9362,78177,496,11.92,86.9,8.55792349726776,9.748087431693989,15661,99.39890710382514,42.71967213114754,0.4991748633879781
06019,"Fresno County, California",963160,480527,482633,22234,579136,76303,24116,8969,4887,951904,76567,58373,134940,254872,119535,135337,368119,5966,5.47,90.2,3.942439470077661,26.462062378005733,37972,98.83134681672827,38.219921923667926,0.49890672370115036
06021,"Glenn County, California",27976,14216,13760,21029,17855,1703,357,147,62,27665,2197,1818,4015,5578,2456,3122,10138,95,8.9,93,2.0231627108950527,19.93851873034029,566,98.88833285673434,36.23820417500715,0.5081498427223334
06023,"Humboldt County, California",135182,67449,67733,25208,90903,17031,5389,1872,1366,134149,10478,8788,19266,27641,13446,14195,57607,275,19.71,82.6,6.381766803272625,20.447248894083533,8627,99.23584500895089,42.61440132562028,0.4989495642911038
06025,"Imperial County, California",178807,91324,87483,17303,107679,10576,3627,680,146,168694,12918,12073,24991,40552,18244,22308,57190,876,1.39,109.3,2.4903946713495557,22.679201597252906,4453,94.34418115621871,31.98420643487112,0.5107406309596381
06027,"Inyo County, California",18326,9235,9091,30323,13233,1991,973,129,148,17879,917,927,1844,1905,841,1064,8087,34,1.02,98.6,6.82091018225472,10.395067117756193,1250,97.56084251882571,44.12856051511514,0.5039288442649787
06029,"Kern County, California",871337,447079,424258,21716,518804,54412,18553,5182,3122,842403,62396,50032,112428,194354,86664,107690,323691,6265,2.56,96.9,3.0822747111622713,22.30526191358797,26857,96.67935597822657,37.14877251855482,0.5130953924830461
06031,"Kings County, California",150261,83207,67054,19835,91823,8378,2128,969,268,131033,9180,7522,16702,28661,13081,15580,54567,433,2.39,99.6,2.239436713451927,19.074144322212682,3365,87.20359907094988,36.3148122267255,0.553749808666254
06033,"Lake County, California",64076,31982,32094,23345,46222,4821,1810,528,309,63400,5223,4063,9286,15561,7738,7823,21401,83,14.73,89.6,4.131031899619202,24.28522379674137,2647,98.94500280916412,33.39940071165491,0.4991260378300768
06035,"Lassen County, California",31945,21191,10754,20974,22818,1749,728,281,103,22153,945,864,1809,3558,1863,1695,8760,38,5.09,86.2,3.4809829394271405,11.137893254030365,1112,69.34731569885741,27.422131789012365,0.6633588981061199
06037,"Los Angeles County, California",10057155,4954616,5102539,30798,6712079,1348250,474729,155849,86083,9988629,867025,718412,1585437,1764081,805455,958626,4591360,50285,4.03,90.5,7.125882021307219,17.54055694677073,716661,99.31863434539888,45.65267215231345,0.4926458824588067
06039,"Madera County, California",153366,74035,79331,19975,95172,8636,2558,784,518,145553,12270,8531,20801,32043,14454,17589,47613,689,6.12,91,2.516855104782025,20.893157544697,3860,94.90565053532073,31.04534251398615,0.48273411316719483
06041,"Marin County, California",259358,126745,132613,66748,189717,61100,28898,12285,6010,254546,9025,7206,16231,20445,9631,10814,127178,735,10.73,73.3,18.196084177083414,7.882926302639595,47193,98.14464948064065,49.03569583355825,0.4886874513221108
06043,"Mariposa County, California",17645,8881,8764,28241,13540,1879,839,210,137,17475,711,556,1267,2849,1507,1342,6966,21,8.08,91,6.721450835930859,16.146217058656845,1186,99.0365542646642,39.47860583734769,0.5033153867951261
06045,"Mendocino County, California",87409,43634,43775,27093,61660,9665,3374,1139,669,86630,6449,4482,10931,17366,8005,9361,35629,75,16.86,84.6,5.928451303641501,19.867519362994656,5182,99.1087874246359,40.76124884165246,0.49919344689906076
06047,"Merced County, California",265001,133782,131219,20120,154008,13682,4956,1238,1165,261996,19864,14235,34099,62661,29744,32917,93760,2865,4.66,95.5,2.7769706529409324,23.645571148788118,7359,98.86604201493579,35.380998562269575,0.5048358308081856
06049,"Modoc County, California",9033,4637,4396,22052,6683,926,208,61,26,8786,734,527,1261,1483,722,761,3368,19,3.95,86,3.265803166168493,16.417579984501273,295,97.26558175578435,37.28550869035758,0.5133399756448578
06051,"Mono County, California",14051,7551,6500,30888,9287,2063,539,224,20,13964,1648,1135,2783,1222,571,651,7522,51,2.71,82.2,5.572557113372714,8.696889901074657,783,99.38082698740303,53.53355633051029,0.5373994733470927
06053,"Monterey County, California",430201,219883,210318,27168,270496,38978,16843,4788,3361,413350,37175,29395,66570,66289,31000,35289,182614,12969,6.92,86.7,5.809377477039802,15.408843773027026,24992,96.08299376338037,42.4485298732453,0.5111168965204637
06055,"Napa County, California",140823,70010,70813,40632,97243,21345,6815,2523,1452,138899,6714,5995,12709,12086,5660,6426,68274,322,9.62,89.2,7.662100651172039,8.582404862842008,10790,98.63374590798378,48.482137150891546,0.49714890323313665
06057,"Nevada County, California",98639,48833,49806,35581,74327,16694,6092,1966,818,97667,6227,4684,10911,11835,5434,6401,40067,454,14.62,85.9,8.998469165340282,11.998296819716339,8876,99.01458855016779,40.61983596751792,0.4950678737618994
06059,"Orange County, California",3132211,1546687,1585524,37603,2100472,520755,195472,58548,32797,3114968,204917,179323,384240,385556,176600,208956,1501853,12403,4.35,85.4,9.157014007038478,12.309387841368286,286817,99.44949430290616,47.94865352302256,0.4938003857339113
06061,"Placer County, California",370571,180790,189781,39734,256598,63509,21583,6611,2986,367805,16085,12241,28326,31932,15094,16838,163251,1282,12.37,87.1,8.414042113387179,8.616972186166754,31180,99.25358433336662,44.053905999120275,0.4878687215135561
06063,"Plumas County, California",18754,9484,9270,32056,14499,1828,988,271,94,18597,1139,769,1908,2346,1003,1343,7189,41,11.99,85.2,7.214460915004799,12.509331342646902,1353,99.16284525967794,38.33315559347339,0.5057054495041058
06065,"Riverside County, California",2323892,1156126,1167766,25700,1468896,198192,79849,20311,12893,2301893,183509,154958,338467,376689,174616,202073,923845,8037,2.81,102.4,4.864812994751907,16.20940215810373,113053,99.05335531943825,39.754214051255396,0.4974955806896362
06067,"Sacramento County, California",1479300,722955,756345,29693,978644,189759,64859,22097,9868,1464006,83477,68179,151656,260877,121935,138942,632480,5440,5.86,95.2,6.545257892246333,17.63516528087609,96824,98.96613263029812,42.75535726357061,0.48871425674305413
06069,"San Benito County, California",58051,29062,28989,30012,36661,4777,1439,500,233,57892,3810,2784,6594,6224,2664,3560,25603,124,5.78,89.8,3.741537613477804,10.721606862930871,2172,99.7261029095106,44.10432206163546,0.5006287574718782
06071,"San Bernardino County, California",2106754,1047925,1058829,22867,1293779,162213,63738,14542,9429,2059141,154411,135858,290269,392195,177523,214672,834181,4848,2.1,102.6,4.163229309164715,18.616079523285585,87709,97.73998293108735,39.595557905669104,0.4974121325983005
06073,"San Diego County, California",3253356,1635137,1618219,34350,2161760,487026,199234,58066,44596,3154251,206057,179882,385939,444024,206662,237362,1536747,12269,4.2,92.4,9.279525511502584,13.648183598720829,301896,96.95376097789483,47.23574671815811,0.5026000843436746
06075,"San Francisco County, California",850282,433226,417056,59508,668995,220335,95666,32831,17732,845883,33199,25520,58719,104180,49680,54500,479139,5660,7.46,72.2,17.19770617277562,12.252405672471015,146229,99.48264222928393,56.35059897775091,0.5095086100846543
06077,"San Joaquin County, California",714860,355719,359141,24694,442112,55004,16993,5472,2828,706531,46997,35651,82648,124587,58002,66585,277798,2015,4.86,94.5,3.5381753070531294,17.428167753126488,25293,98.83487675908569,38.86047617715357,0.49760652435441904
06079,"San Luis Obispo County, California",278680,141572,137108,33972,184345,39994,15020,4296,3476,272052,15205,12286,27491,37208,17548,19660,127442,701,5.29,89.8,8.178556049949764,13.35151428161332,22792,97.62164489737333,45.73058705325104,0.5080091861633415
06081,"San Mateo County, California",754748,371545,383203,53516,535502,148547,66121,20918,16375,750878,29874,24272,54146,57490,25845,31645,387602,3543,8.73,75.4,13.701791856354705,7.617111936699402,103414,99.48724607418634,51.35515430315814,0.49227689241972156
06083,"Santa Barbara County, California",439395,220159,219236,32872,270363,51832,22062,7146,6101,432111,32822,26148,58970,66880,31737,35143,202069,1229,5.22,83.8,8.035821982498662,15.220928777068469,35309,98.34226607039224,45.98800623584702,0.5010503078096018
06085,"Santa Clara County, California",1885056,949223,935833,48689,1284765,342701,208794,34369,44998,1876213,80071,64182,144253,172213,79442,92771,912304,7520,7.73,84.8,15.286601565152441,9.135696764446255,288161,99.53088926801114,48.39665240714334,0.5035516186256536
06087,"Santa Cruz County, California",270931,134367,136564,36388,175387,40953,18085,4872,4476,269538,15491,12109,27600,39211,17568,21643,128893,3304,11.48,79.1,10.125456296990746,14.472688618135244,27433,99.48584694996143,47.5741055840786,0.49594546212873386
06089,"Shasta County, California",179228,87903,91325,26455,125235,16539,5537,2228,857,177820,11305,9242,20547,30945,14031,16914,69150,424,13.62,92.5,4.810632267279666,17.26571741022608,8622,99.21440846296338,38.58214118329725,0.4904535005691075
06091,"Sierra County, California",2931,1449,1482,31750,2381,352,82,20,17,2902,168,68,236,329,179,150,1186,0,13.34,83.3,4.060047765267827,11.224837939269873,119,99.01057659501876,40.464005458887755,0.49437052200614123
06093,"Siskiyou County, California",43668,21713,21955,24605,31725,4715,1640,491,183,43514,2383,1908,4291,9524,4520,5004,15770,108,10.96,86.4,5.299074837409544,21.81002106805899,2314,99.64733901254924,36.11340111752313,0.4972290922414583
06095,"Solano County, California",429596,213518,216078,31934,289265,50923,14765,4536,2445,416581,21048,17165,38213,53265,23732,29533,189124,1147,6.71,90,5.0619651952066596,12.398858462369295,21746,96.97040940790883,44.02368737139079,0.4970204564288308
06097,"Sonoma County, California",497776,243919,253857,37767,350617,74393,26826,10000,4723,493344,27304,22588,49892,55095,25512,29583,238691,1611,12.73,80.9,8.346927131882614,11.068231493683905,41549,99.10963967728456,47.95148821960078,0.4900175982771367
06099,"Stanislaus County, California",530561,262151,268410,24007,331349,36783,11983,4428,1544,527228,34244,26472,60716,95739,42967,52772,206066,1681,5.05,95.2,3.384153754233726,18.04486194801352,17955,99.37179702239705,38.83926636145514,0.49410152649742445
06101,"Sutter County, California",95406,47486,47920,24849,61269,7623,2310,766,269,94171,6955,5443,12398,16535,7623,8912,37746,157,6.8,97.2,3.5060688007043583,17.33119510303335,3345,98.70553214682515,39.56354946229797,0.49772550992600045
06103,"Tehama County, California",63015,31379,31636,22631,42822,3939,1353,441,179,62487,3623,3138,6761,13363,6347,7016,22690,214,12.23,92.7,3.131000555423312,21.206062048718557,1973,99.16210426089026,36.007299849242244,0.49796080298341666
06105,"Trinity County, California",13180,6752,6428,23575,10187,1594,339,72,39,12996,1230,905,2135,2607,1334,1273,4590,72,19.74,90.8,3.4142640364188166,19.77996965098634,450,98.60394537177542,34.825493171471926,0.5122913505311077
06107,"Tulare County, California",455769,227963,227806,18962,263099,24659,8033,2901,1220,451619,37969,29158,67127,127130,61486,65644,165799,2009,4.99,88,2.6667017721696737,27.893516233004,12154,99.08945101575578,36.377858081615905,0.5001722363741281
06109,"Tuolumne County, California",53864,28134,25730,31570,40694,5312,1929,538,255,50802,2545,1864,4409,7176,3129,4047,19075,107,9.76,83.6,5.053467993465023,13.322441705034903,2722,94.31531263923956,35.41326303282341,0.5223154611614437
06111,"Ventura County, California",843110,417442,425668,35771,555316,111571,45763,12888,8589,836448,56903,46114,103017,88486,40194,48292,395139,2138,4.78,86,7.975234548279584,10.49519042592307,67240,99.2098302712576,46.86683825360866,0.49512163300162493
06113,"Yolo County, California",209671,102268,107403,30615,122238,25078,12765,4541,6541,208157,11017,8631,19648,38898,18187,20711,91743,474,6.69,95.2,11.37353282046635,18.551921820375732,23847,99.27791635466994,43.75569344353773,0.4877546251031378
06115,"Yuba County, California",73897,37471,36426,22814,45723,4885,1693,432,99,71472,4769,3981,8750,15080,6977,8103,27106,172,12.28,94.1,3.009594435498058,20.406782413359135,2224,96.71840534798436,36.68078541754063,0.5070706523945492
08001,"Adams County, Colorado",479977,241414,238563,27487,303509,46224,17121,2733,1810,476508,40963,33355,74318,61265,27138,34127,235043,1523,2.89,90.5,4.513549607585364,12.764153282344779,21664,99.27725703523294,48.969638128493656,0.502969933976003
08003,"Alamosa County, Colorado",16353,7971,8382,19217,9332,1408,751,89,160,15910,1189,896,2085,4786,2037,2749,6238,26,2.76,83.9,6.115085916957133,29.26680119855684,1000,97.29101693878799,38.1459059499786,0.4874334984406531
08005,"Arapahoe County, Colorado",617668,303932,313736,36951,413227,108428,44392,10204,5282,612295,37492,32062,69554,65383,29560,35823,316545,2278,2.9,89.4,9.694204653632696,10.585460150113006,59878,99.1301152075225,51.248405292163426,0.4920636976498702
08007,"Archuleta County, Colorado",12355,6274,6081,29344,9115,2110,759,154,161,12252,1429,1059,2488,1369,612,757,5547,37,3.64,80.9,8.692836908134359,11.080534196681505,1074,99.16632942128693,44.89680291380008,0.507810602994739
08009,"Baca County, Colorado",3648,1743,1905,22853,2619,411,105,52,4,3548,250,212,462,634,258,376,1607,12,3.47,94.4,4.413377192982456,17.37938596491228,161,97.25877192982456,44.0515350877193,0.4777960526315789
08011,"Bent County, Colorado",5816,3821,1995,14028,4688,309,123,6,7,3758,330,225,555,943,429,514,1301,17,3.81,95.9,2.33837689133425,16.213892709766164,136,64.61485557083907,22.369325997248968,0.6569807427785419
08013,"Boulder County, Colorado",313961,157617,156344,42119,202434,64270,37367,7700,10732,311909,12614,10546,23160,40732,19741,20991,164848,1563,3.14,82.1,17.772589589152794,12.97358589124127,55799,99.34641563761105,52.505884488837786,0.5020273218648176
08014,"Broomfield County, Colorado",62449,30980,31469,43736,42402,13968,6315,980,980,62115,2084,1357,3441,3667,1551,2116,32938,398,2.72,90.4,13.250812663133116,5.871991545100802,8275,99.46516357347596,52.743838972601644,0.49608480520104403
08015,"Chaffee County, Colorado",18507,9854,8653,28907,14370,2991,1338,459,157,17405,1348,930,2278,1673,743,930,8119,13,3.15,74.1,10.55816717998595,9.039822769762793,1954,94.04549629869778,43.86988706975739,0.5324471821472956
08017,"Cheyenne County, Colorado",2071,1057,1014,23698,1323,247,59,0,2,2029,194,166,360,229,105,124,963,19,3.77,92.6,2.94543698696282,11.057460164171898,61,97.97199420569773,46.499275712216324,0.5103814582327378
08019,"Clear Creek County, Colorado",9238,4779,4459,41257,7172,2085,839,154,118,9113,541,298,839,677,348,329,5039,93,4.32,72,12.026412643429314,7.328426066248106,1111,98.646893266940893,54.546438623078586,0.5173197661831566
08021,"Conejos County, Colorado",8213,4100,4113,19047,5289,718,207,20,25,8173,672,614,1286,1805,940,865,2812,48,3.52,77,3.0683063436016074,21.977352976987703,252,99.51296724704737,34.23840253257031,0.49920857177645195
08023,"Costilla County, Colorado",3590,1924,1666,20737,2611,234,228,27,34,3590,251,259,510,1092,536,556,1131,0,3.27,80.4,8.050139275766016,30.41782729805014,289,100,31.5041782729805,0.5359331476323119
08025,"Crowley County, Colorado",5537,3173,2364,14393,3737,237,136,5,5,4308,181,267,448,1479,604,875,1605,3,3.08,95.5,2.6368069351634458,26.71121545963518,146,77.80386490879538,28.986815965324183,0.5730540003612065
08027,"Custer County, Colorado",4375,2146,2229,26032,3350,631,265,49,40,4359,387,342,729,772,373,399,1241,0,4.31,79,8.09142857142857,17.645714285714284,354,99.63428571428571,28.365714285714287,0.49051428571428574
08029,"Delta County, Colorado",30221,15127,15094,25546,21753,2807,1128,263,67,29195,2490,2171,4661,4890,2039,2851,10984,48,2.65,84.3,4.824459812713014,16.180801429469575,1458,96.60500976142417,36.345587505377054,0.500545977962344
08031,"Denver County, Colorado",663303,331602,331701,38991,468263,131013,56260,18163,8649,657039,49598,35791,85389,106745,50708,56037,353976,2691,2.56,90.5,12.523989790487907,16.09294696390639,83072,99.05563520743914,53.36565641946441,0.49992537347185223
08033,"Dolores County, Colorado",1789,946,843,23190,1336,192,73,6,0,1789,103,82,185,346,187,159,734,1,4.33,79,4.415874790385691,19.340413638904415,79,100,41.02850754611515,0.5287870318613751
08035,"Douglas County, Colorado",314238,156120,158118,48725,203279,76292,31364,5603,3680,313326,7158,6184,13342,11807,5168,6639,162627,1548,2.82,84.9,12.93510014702232,3.7573431602797878,40647,99.7097741202528,51.75281156321005,0.4968208809882955
08037,"Eagle County, Colorado",52894,28064,24830,40450,36594,12134,3018,1054,274,52844,5600,4107,9707,4237,2212,2025,32016,102,3.67,75.8,8.216432865731463,8.010360343328166,4346,99.90547131999848,60.52860437856846,0.5305705751124892
08039,"Elbert County, Colorado",24225,12223,12002,42522,16940,3923,1230,270,137,24126,973,817,1790,1221,562,659,12408,94,3.11,88.6,6.757481940144479,5.040247678018575,1637,99.59133126934985,51.21981424148607,0.5045614035087719
08041,"El Paso County, Colorado",665171,334605,330566,31217,422966,94598,47296,7424,5344,633612,32779,26511,59290,73012,32977,40035,320427,2552,2.66,87.8,9.029858487516744,10.97642561085796,60064,95.25550572709875,48.172124160554205,0.5030360614037593
08043,"Fremont County, Colorado",46835,27365,19470,20919,36329,3606,1911,255,185,36309,1814,1720,3534,6012,2754,3258,14100,207,2.88,84,5.019750186826092,12.836553859293264,2351,77.52535496957404,30.105690188961248,0.5842852567524287
08045,"Garfield County, Colorado",57495,29406,28089,31483,37845,7176,2933,619,298,56799,7099,6243,13342,6274,3130,3144,29417,303,3.19,79.8,6.696234455170015,10.912253239412124,3850,98.7894599530394,51.16444908252892,0.5114531698408558
08047,"Gilpin County, Colorado",5708,3019,2689,45110,4394,1025,339,24,122,5657,306,295,601,392,185,207,3124,26,3.73,74.3,8.496846531184303,6.867554309740715,485,99.10651716888577,54.7302032235459,0.5289067974772249
08049,"Grand County, Colorado",14490,7752,6738,32919,10737,3030,691,208,62,14430,1398,1146,2544,1523,787,736,8234,54,3.51,74.3,6.63216011042098,10.510697032436163,961,99.58592132505176,56.82539682539682,0.5349896480331263
08051,"Gunnison County, Colorado",15889,8606,7283,27669,10085,3883,1052,177,192,15840,1272,822,2094,2319,1055,1264,8908,50,3.58,73.8,8.943294102838442,14.595002832148026,1421,99.69161054817799,56.063943608785955,0.541632575995972
08053,"Hinsdale County, Colorado",856,407,449,29574,701,221,31,17,18,856,49,53,102,96,45,51,407,4,4.19,68.4,7.710280373831775,11.214953271028037,66,100,47.546728971962615,0.47546728971962615
08055,"Huerfano County, Colorado",6521,3283,3238,25547,5148,807,416,70,45,6361,506,345,851,1086,579,507,2303,16,3.21,85.9,8.14292286459132,16.6538874405766,531,97.54638859070695,35.316669222511884,0.5034503910443183
08057,"Jackson County, Colorado",1306,634,672,24299,991,146,16,16,11,1301,94,65,159,179,73,106,723,25,3.47,74,3.2924961715160794,13.705972434915774,43,99.61715160796325,55.35987748851455,0.48545176110260335
08059,"Jefferson County, Colorado",558810,277758,281052,40187,395230,105643,45927,8943,6354,552426,25132,19294,44426,44629,20267,24362,295608,2220,3.16,83.3,10.956138938100606,7.986435461069058,61224,98.85757234122511,52.89955441026467,0.49705266548558547
08061,"Kiowa County, Colorado",1465,699,766,23621,944,124,58,4,5,1439,98,66,164,154,50,104,668,14,3.45,93.8,4.573378839590443,10.511945392491468,67,98.22525597269625,45.59726962457338,0.47713310580204776
08063,"Kit Carson County, Colorado",8174,4682,3492,26125,5813,540,188,53,23,7304,667,479,1146,1033,446,587,3618,46,4.39,91.3,3.229752874969415,12.637631514558356,264,89.35649620748715,44.26229508196721,0.5727917788108637
08065,"Lake County, Colorado",7401,4110,3291,28492,5098,1217,189,54,116,7339,686,532,1218,836,453,383,4191,47,4.15,69.8,4.850695851911904,11.295770841778138,359,99.16227536819349,56.6274827725983,0.5553303607620592
08067,"La Plata County, Colorado",53994,27292,26702,34501,37860,10138,3905,1124,1112,53516,4047,2834,6881,5569,2398,3171,27714,307,3.89,82,11.373485942882542,10.314108975071305,6141,99.11471644997593,51.32792532503611,0.5054635700262993
08069,"Larimer County, Colorado",325228,161828,163400,34087,210378,58408,25672,4457,6711,322804,15668,11930,27598,41640,19368,22272,165414,1130,3.18,80.3,11.327437981969572,12.803325666916747,36840,99.25467671910168,50.86093448288585,0.497583233915899
08071,"Las Animas County, Colorado",14322,7392,6930,24268,10360,1225,617,101,20,13784,728,788,1516,1926,853,1073,6106,76,3.18,91.1,5.152911604524507,13.447842480100544,738,96.24354140483173,42.63371037564586,0.5161290322580645
08073,"Lincoln County, Colorado",5515,3460,2055,14765,4079,415,112,17,14,3518,111,116,227,597,233,364,1353,17,2.63,91.5,2.5929283771532186,10.825022665457842,143,63.789664551223936,24.533091568449684,0.6273798730734361
08075,"Logan County, Colorado",21862,11972,9890,24595,14675,1655,569,142,87,21263,1740,1016,2756,3394,1621,1773,10351,74,3,89.7,3.6501692434360993,15.524654651907419,798,97.26008599396212,47.34699478547251,0.5476168694538469
08077,"Mesa County, Colorado",148166,73393,74773,27612,99979,17395,6219,1287,1194,146965,9841,8881,18722,23633,10888,12745,66979,852,2.09,85,5.871792449009894,15.950352982465613,8700,99.18942267456771,45.20537775198088,0.4953430611611301
08079,"Mineral County, Colorado",793,414,379,33018,713,192,73,17,21,793,38,22,60,65,28,37,310,0,4.18,69.8,13.997477931904161,8.19672131147541,111,100,39.09205548549811,0.5220680958385876
08081,"Moffat County, Colorado",13034,6761,6273,27331,8676,1097,473,30,37,12911,1057,764,1821,1419,725,694,6258,15,2.71,84.6,4.143010587693724,10.88691115543962,540,99.05631425502531,48.01288936627282,0.5187202700629124
08083,"Montezuma County, Colorado",26006,12843,13163,24440,18206,2883,1579,246,211,25822,2803,2212,5015,4811,2325,2486,10839,73,3.32,87.3,7.828962547104514,18.499577020687532,2036,99.29247096823809,41.67884334384373,0.49384757363685305
08085,"Montrose County, Colorado",40866,20143,20723,24308,28950,4230,2076,363,216,40485,3076,2955,6031,7278,3193,4085,16553,166,2.14,85.4,6.496843341653208,17.80942592864484,2655,99.06768462780796,40.50555473988157,0.4929036362746537
08087,"Morgan County, Colorado",28288,14071,14217,24077,18182,1805,815,237,71,27958,1368,1262,2630,2986,1057,1929,13009,30,3.51,91.1,3.969881221719457,10.555712669683258,1123,98.83342760180996,45.987697963800905,0.49741940045248867
08089,"Otero County, Colorado",18440,9072,9368,20358,12348,1425,533,131,24,18251,1204,1090,2294,4154,2026,2128,7155,17,3.33,96.2,3.7310195227765726,22.52711496746204,688,98.97505422993493,38.80151843817787,0.49197396963123646
08091,"Ouray County, Colorado",4651,2216,2435,35544,3762,1211,580,138,121,4651,327,249,576,425,201,224,2242,29,3.62,77.8,18.039131369597936,9.13781982369383,839,100,48.20468716405074,0.47645667598365943
08093,"Park County, Colorado",16440,8640,7800,34377,12809,2720,872,104,208,16299,1254,641,1895,1022,436,586,8744,147,2.87,75,7.201946472019465,6.21654501216545,1184,99.14233576642336,53.18734793187348,0.5255474452554745
08095,"Phillips County, Colorado",4347,2256,2091,27790,3035,445,121,27,26,4280,296,264,560,509,217,292,2056,0,3.76,89.1,4.002760524499655,11.709224752703014,174,98.45870715435933,47.29698642742121,0.5189786059351277
08097,"Pitkin County, Colorado",17543,9208,8335,65800,13484,5803,1513,659,174,17498,1388,1008,2396,1507,659,848,10539,78,4.56,72.1,13.372855269908225,8.59032092572536,2346,99.74348743088412,60.07524368694066,0.524881719204241
08099,"Prowers County, Colorado",12121,6089,6032,22033,7821,846,296,30,32,11934,1001,517,1518,2422,1059,1363,5379,106,3.88,94.6,2.9535516871545253,19.981849682369443,358,98.45722300140253,44.37752660671562,0.5023512911475951
08101,"Pueblo County, Colorado",162158,79805,82353,23110,108786,14603,6607,1075,820,158695,8945,5981,14926,31907,14623,17284,64701,460,2.86,93.5,5.243034571220662,19.676488363201322,8502,97.86442852033203,39.89997409933522,0.4921434650156021
08103,"Rio Blanco County, Colorado",6658,3403,3255,28185,4261,623,250,20,38,6552,373,308,681,788,377,411,3189,7,2.99,82.7,4.6260138179633525,11.835386001802343,308,98.40793030940222,47.89726644638029,0.5111144487834185
08105,"Rio Grande County, Colorado",11623,5733,5890,22412,7808,1081,465,136,80,11426,862,750,1612,2174,1057,1117,4681,18,3,76.4,5.859072528607072,18.70429321173535,681,98.30508474576271,40.27359545728297,0.49324614987524734
08107,"Routt County, Colorado",23980,12465,11515,38111,17382,5677,2069,610,233,23881,1525,1230,2755,2408,1372,1036,13875,112,3.54,76.7,12.14345287739783,10.041701417848207,2912,99.58715596330275,57.86071726438699,0.5198081734778982
08109,"Saguache County, Colorado",6255,3074,3181,22267,4429,768,282,15,63,6234,753,791,1544,1409,573,836,2445,24,3.09,76.1,5.755395683453237,22.5259792166267,360,99.6642685851319,39.08872901678657,0.4914468425259792
08111,"San Juan County, Colorado",552,291,261,28889,457,110,18,0,2,552,49,51,100,21,11,10,349,0,5.95,65.6,3.6231884057971016,3.8043478260869565,20,100,63.22463768115942,0.5271739130434783
08113,"San Miguel County, Colorado",7767,4118,3649,42015,5766,2237,680,174,84,7736,534,427,961,923,398,525,4557,161,3.72,81.1,12.07673490408137,11.883610145487317,938,99.60087549890562,58.67130166087292,0.5301918372602035
08115,"Sedgwick County, Colorado",2367,1121,1246,24666,1701,226,94,7,10,2338,173,107,280,342,147,195,988,10,3.73,88.7,4.689480354879595,14.448669201520913,111,98.77482044782425,41.74059991550486,0.4735952682720744
08117,"Summit County, Colorado",29269,16153,13116,37192,21914,7638,2502,390,409,29189,3228,2460,5688,3522,1682,1840,17764,83,4.49,70.7,11.278144111517305,12.033209197444394,3301,99.7266732720626,60.69219993850149,0.5518808295466193
08119,"Teller County, Colorado",23472,11986,11486,34974,17572,3622,1648,291,163,23235,1002,995,1997,1752,827,925,11634,178,3.27,77.3,8.955351056578051,7.4642126789366054,2102,98.9902862985685,49.56543967280164,0.5106509884117246
08121,"Washington County, Colorado",4814,2477,2337,26279,3383,411,106,14,10,4548,215,144,359,529,230,299,2140,18,3.35,89.7,2.700457000415455,10.988782717075198,130,94.47444952222683,44.4536767760698,0.5145409223099294
08123,"Weld County, Colorado",278065,139799,138266,29226,175279,32451,10966,1841,1650,275485,15625,14612,30237,34050,15245,18805,131610,862,2.59,90.1,5.199144085016093,12.245338320176938,14457,99.07215938719364,47.33066009745923,0.5027565497275817
08125,"Yuma County, Colorado",10150,4968,5182,24789,6671,965,436,7,19,10011,806,710,1516,1459,712,747,4804,11,4.1,90.4,4.551724137931035,14.374384236453203,462,98.63054187192118,47.330049261083744,0.4894581280788177
09001,"Fairfield County, Connecticut",941618,458490,483128,53433,636392,165089,95188,24779,9991,933085,51627,42169,93796,81553,35680,45873,458236,3128,4.9,85.9,13.801562841831826,8.660943185028323,129958,99.09379387394888,48.664745151430836,0.48691719996856475
09003,"Hartford County, Connecticut",895699,434485,461214,37817,619328,129822,71798,18356,8346,881190,29593,22280,51873,100830,45278,55552,433633,3193,5.29,86.8,10.99699787540234,11.257129906363634,98500,98.38014779518566,48.412803854866425,0.4850792509537244
09005,"Litchfield County, Connecticut",185141,91469,93672,40619,135352,26729,14833,2894,1587,183779,6385,4628,11013,12706,6179,6527,96122,659,5.5,84.2,10.432049086912137,6.862877482567341,19314,99.26434447259116,51.918267698672906,0.49405048044463407
09007,"Middlesex County, Connecticut",164438,80412,84026,43695,118519,26923,16395,3030,2160,162549,4703,3417,8120,11193,4885,6308,87312,726,4.34,84.9,13.126527931500018,6.8068208078424695,21585,98.8512387647624,53.09721597197728,0.48901105583867477
09009,"New Haven County, Connecticut",860874,415286,445588,35085,591915,109536,63749,16955,12717,850312,33267,26698,59965,106796,46555,60241,414017,2366,4.88,84.9,10.851878439818138,12.40553205230963,93421,98.7731073304572,48.09263608844035,0.4824004441997319
09011,"New London County, Connecticut",272033,136190,135843,36881,188716,33597,20758,3781,3038,260184,8608,5519,14127,25645,11356,14289,138562,1055,6.44,84.2,10.137373039300378,9.42716508658876,27577,95.6442784515114,50.935732061918955,0.5006377902680925
09013,"Tolland County, Connecticut",151689,75894,75795,37830,95330,20999,11962,1956,2128,148651,3354,2654,6008,9223,4051,5172,76855,438,4.99,84.8,10.578222547449057,6.080203574418712,16046,97.99721799207589,50.6661656415429,0.5003263255740363
09015,"Windham County, Connecticut",117078,58044,59034,29993,80577,11675,5883,792,873,115389,4253,3060,7313,12518,5239,7279,56779,341,6,84.2,6.446984061907446,10.692017287620219,7548,98.55737200840466,48.496728676608754,0.4957720494029621
10001,"Kent County, Delaware",171474,82687,88787,27420,112384,16203,7280,1332,1170,168146,7313,5747,13060,21866,9363,12503,76484,521,9.98,89.1,5.704654933109393,12.751787442994273,9782,98.05918098370599,44.60384664730513,0.4822130468759112
10003,"New Castle County, Delaware",551997,267276,284721,34541,373316,77943,38515,7779,8026,543604,20688,17010,37698,60817,26035,34782,265673,1647,6.16,88.5,9.840633191847058,11.017632342204758,54320,98.47952072203292,48.12942823964623,0.4841982836863244
10005,"Sussex County, Delaware",211224,102453,108771,31874,155215,21624,11442,2539,1468,208518,10180,7839,18019,26765,11489,15276,90267,974,11.91,89.2,7.314036283755634,12.671382039919706,15449,98.71889558004773,42.735200545392566,0.48504431314623336
12001,"Alachua County, Florida",256581,124004,132577,26431,153641,32800,16729,6619,7636,253897,17118,14087,31205,58387,28205,30182,115452,1050,8.68,94.6,12.075718778865154,22.75577692814355,30984,98.95393657363562,44.9963169525413,0.4832937746754436
12003,"Baker County, Florida",27312,14280,13032,22440,17878,1616,441,101,124,24749,1571,1517,3088,4522,1998,2524,10048,76,7.81,96.2,2.4384885764499122,16.556824838898653,666,90.61584651435267,36.789689513766845,0.5228471001757469
12005,"Bay County, Florida",178361,88681,89680,26742,124142,18379,6980,1587,1028,174105,15012,12989,28001,27363,12090,15273,80604,615,11.08,91.9,5.379539249051081,15.341358256569542,9595,97.61382813507437,45.19149365612438,0.4971994998906712
12007,"Bradford County, Florida",26919,14875,12044,19656,19390,1624,516,111,33,23658,2165,1582,3747,4559,2034,2525,9174,52,7.48,95.2,2.4517998439763735,16.93599316467922,660,87.88587986180765,34.08001783127159,0.5525836769567963
12009,"Brevard County, Florida",560683,273945,286738,29405,412117,70806,33608,5224,4636,555674,39287,33906,73193,77357,35249,42108,230437,3112,10.29,92.2,7.752687347395944,13.79692268180059,43468,99.10662531234227,41.099337771967406,0.48859159275383773
12011,"Broward County, Florida",1863780,906235,957545,30109,1304351,259844,98835,31505,14370,1852454,172573,160742,333315,265521,119083,146438,892638,10246,8.7,92.6,7.7643284078592965,14.246370279754048,144710,99.3923102512099,47.893957441328915,0.4862349633540439
12013,"Calhoun County, Florida",14550,7936,6614,15927,10376,858,212,13,4,12510,1096,1308,2404,1623,710,913,4541,66,8.61,92.9,1.5738831615120275,11.154639175257731,229,85.97938144329896,31.209621993127147,0.5454295532646048
12015,"Charlotte County, Florida",169642,82682,86960,29243,137850,18551,8227,2019,984,166246,12072,11201,23273,20511,9216,11295,55864,1013,11.49,94,6.61982292121055,12.09075582697681,11230,97.99813725374612,32.930524280543736,0.48739109418658116
12017,"Citrus County, Florida",140453,67884,72569,25034,111198,13034,4708,1380,722,138504,8720,7854,16574,24409,10619,13790,42809,734,13.2,94.3,4.848597039579076,17.378767274461918,6810,98.61234719087524,30.479235046599218,0.4833218229585698
12019,"Clay County, Florida",200346,98575,101771,28599,134708,22683,7631,1077,856,197148,12699,10728,23427,20243,9039,11204,89297,778,6.18,95.1,4.773741427330718,10.104020045321594,9564,98.40376149261778,44.5713914927176,0.4920237988280275
12021,"Collier County, Florida",348236,171049,177187,41239,260789,51687,23756,8863,4052,346338,34539,29826,64365,45375,21364,24011,141497,2015,10.25,93.1,10.530502303035872,13.029956696033723,36671,99.45496732101219,40.63250209627954,0.4911870111074099
12023,"Columbia County, Florida",68198,35318,32880,22855,46923,4526,2110,612,217,63440,4396,4772,9168,12229,5360,6869,24864,103,10.38,95.5,4.309510542831168,17.931610897680283,2939,93.02325581395348,36.4585471714713,0.5178744244699258
12027,"DeSoto County, Florida",35134,19905,15229,17892,24454,1705,564,128,58,33288,5764,2349,8113,9920,5551,4369,12343,89,9.49,94,2.134684351340582,28.23475835373143,750,94.74583024990038,35.1312119314624,0.5665452268457905
12029,"Dixie County, Florida",16084,8779,7305,19342,12021,574,138,44,13,14559,1361,1213,2574,3109,1376,1733,4793,68,14.8,94.4,1.21238497886098,19.329768714250186,195,90.51852772942054,29.79980104451629,0.5458219348420791
12031,"Duval County, Florida",900890,436406,464484,28593,607088,116512,38607,10695,4713,881774,64578,57220,121798,146252,63691,82561,422137,4351,6.57,95.1,5.995737548424336,16.234168433438043,54015,97.87809832498974,46.85777397906514,0.48441652143990943
12033,"Escambia County, Florida",309574,153860,155714,25666,204939,34088,12240,2872,1795,292994,20598,16902,37500,42672,19894,22778,139093,997,8.44,91.9,5.461375955345087,13.784103316169963,16907,94.64425307034828,44.93045281580495,0.49700556248263744
12035,"Flagler County, Florida",102917,49410,53507,25741,77355,11626,4854,1052,509,102553,7530,7360,14890,13453,6199,7254,37318,265,6.01,94.4,6.23317819213541,13.071698553203067,6415,99.64631693500588,36.26028741607315,0.48009561102636106
12037,"Franklin County, Florida",11705,6675,5030,23524,8952,929,410,84,75,9961,998,903,1901,2060,849,1211,4189,113,8.32,92.5,4.861170439982914,17.599316531396838,569,85.10038445108928,35.78812473302008,0.5702691157624946
12039,"Gadsden County, Florida",46153,21862,24291,19252,31799,3505,1510,194,350,43298,3910,2921,6831,11042,5225,5817,16179,349,8.02,94.1,4.450414924273612,23.924771954152494,2054,93.81405325764305,35.055142677615756,0.4736853508980998
12041,"Gilchrist County, Florida",17033,8961,8072,21145,11397,927,392,56,32,15784,1531,1478,3009,3730,1769,1961,6159,43,12.11,94.7,2.8180590618211707,21.898667292902015,480,92.66717548288617,36.159220336992895,0.5260964011037398
12043,"Glades County, Florida",13420,7269,6151,20476,9954,614,240,4,26,12094,1516,1320,2836,2500,1243,1257,3561,49,9.87,94.4,2.0119225037257826,18.628912071535023,270,90.11922503725782,26.535022354694487,0.5416542473919523
12045,"Gulf County, Florida",15851,9220,6631,21085,12106,1437,367,139,80,13506,1214,867,2081,2068,938,1130,5526,121,9.44,91.7,3.6969276386347865,13.046495489243581,586,85.20598069522427,34.86215380733077,0.5816667718125039
12047,"Hamilton County, Florida",14362,8377,5985,16109,9842,728,203,63,10,10989,767,671,1438,2963,1231,1732,3819,59,9.03,95,1.9217379195098176,20.630831360534746,276,76.51441303439633,26.591004038434757,0.5832753098454254
12049,"Hardee County, Florida",27302,14728,12574,18643,17163,1192,370,56,35,25551,2887,2428,5315,6716,3047,3669,9372,210,9.14,94,1.6885209874734453,24.59893048128342,461,93.5865504358655,34.32715551974214,0.5394476595121237
12051,"Hendry County, Florida",38376,20347,18029,18426,23888,1413,595,92,83,37310,6443,4659,11102,9776,4949,4827,15075,727,11.68,94.3,2.006462372316031,25.474254742547426,770,97.22222222222223,39.28236397748593,0.5302011673962893
12053,"Hernando County, Florida",176797,85023,91774,23495,131317,14414,5500,862,765,174905,13222,11062,24284,27175,12527,14648,59343,624,12.34,93.5,4.0311769996097215,15.370735928777073,7127,98.92984609467355,33.56561480115613,0.4809074814617895
12055,"Highlands County, Florida",98862,48031,50831,23020,74900,7959,3043,735,598,97787,7913,6908,14821,18889,9099,9790,31002,224,10.04,94.1,4.426372114664886,19.106431186907002,4376,98.91262568024115,31.358863870850275,0.4858388460682568
12057,"Hillsborough County, Florida",1323059,644746,678313,29806,888930,178230,70305,19070,11815,1311145,107014,90419,197433,213566,97274,116292,623337,5500,11.8,93.3,7.648185001575894,16.14183494462454,101190,99.09951105733002,47.1133184536744,0.48731462466904346
12059,"Holmes County, Florida",19569,10463,9106,18402,13910,1154,414,119,29,17697,1712,1429,3141,4571,2102,2469,6337,73,10.79,93.3,2.871889212530022,23.358372936787777,562,90.43384945577188,32.382850426695285,0.534672185599673
12061,"Indian River County, Florida",145342,69798,75544,33122,110018,18195,8145,2293,1256,144013,11509,11029,22538,20302,9032,11270,52662,486,14.21,92,8.045850476806429,13.968433075091852,11694,99.08560498685858,36.23316040786558,0.48023283015233037
12063,"Jackson County, Florida",48721,27001,21720,18126,35443,2751,1514,338,249,41061,2687,2461,5148,9325,4500,4825,15778,208,9.06,93.6,4.31230886065557,19.139590730896327,2101,84.27782680979455,32.38439276697933,0.5541963424396051
12065,"Jefferson County, Florida",14082,7483,6599,22452,10797,1231,581,116,125,11586,580,576,1156,1825,734,1091,4718,0,8.93,93.8,5.837239028547081,12.95980684561852,822,82.27524499360887,33.50376366993325,0.5313875869904843
12067,"Lafayette County, Florida",8742,5015,3727,21955,6120,459,228,139,7,7075,1007,605,1612,1272,475,797,2440,10,12.35,94.5,4.278197208876687,14.55044612216884,374,80.93113703957904,27.911233127430794,0.5736673530084648
12069,"Lake County, Florida",317586,153595,163991,25991,232300,32771,13543,2773,1249,314138,22166,19493,41659,42342,19508,22834,122735,1002,8,95,5.530785362075155,13.332451682378947,17565,98.91430982474039,38.64622495953852,0.4836327797824841
12071,"Lee County, Florida",680970,333403,347567,30233,504918,85031,34434,9823,5613,675352,61210,52824,114034,104219,47107,57112,269491,5054,12.75,93.3,7.323376947589468,15.304492121532519,49870,99.17500036712337,39.57457744100328,0.4896001292274256
12073,"Leon County, Florida",284788,135482,149306,28548,165868,42196,20972,6262,5613,281370,15676,12985,28661,58148,27252,30896,139426,1000,8.25,94.4,11.533842718092055,20.417995140244674,32847,98.79980898071548,48.95782125651362,0.47572931443740607
12075,"Levy County, Florida",39707,19555,20152,21043,28729,2060,791,162,194,39329,3882,3287,7169,8652,4186,4466,13825,107,10.56,94.7,2.8886594303271464,21.789608885083236,1147,99.04802679628277,34.817538469287534,0.49248243382778856
12077,"Liberty County, Florida",8285,5224,3061,16937,5633,427,175,32,68,6816,933,475,1408,1147,685,462,2721,85,7.69,93.2,3.31925165962583,13.84429692214846,275,82.26916113458057,32.84248642124321,0.6305371152685576
12079,"Madison County, Florida",18560,9750,8810,17192,13207,968,539,45,78,16532,1494,1314,2808,4703,2119,2584,5816,153,8.63,94.4,3.5668103448275863,25.339439655172413,662,89.07327586206897,31.336206896551722,0.525323275862069
12081,"Manatee County, Florida",353411,170779,182632,30477,259773,44564,19621,4926,3298,350571,27940,24603,52543,50094,22134,27960,143025,1149,12.56,93.6,7.878928499678844,14.174431469309106,27845,99.19640305480021,40.4698778476052,0.4832305729023715
12083,"Marion County, Florida",340341,163611,176730,23598,252140,30446,11293,3255,1357,332116,27141,23394,50535,60266,27572,32694,115659,1155,8.82,95,4.673254177427933,17.707534502161067,15905,97.58330615470955,33.98326972066251,0.48072668294445864
12085,"Martin County, Florida",153592,75837,77755,38021,117748,23015,9231,3281,1606,150637,11981,8592,20573,17758,8369,9389,60938,800,9.17,93.1,9.191884994010104,11.561800093754883,14118,98.0760716703995,39.675243502265744,0.4937561852179801
12086,"Miami-Dade County, Florida",2664418,1292784,1371634,25481,1869613,325566,113739,49501,21255,2637220,314628,293876,608504,522143,231132,291011,1214352,10549,9.26,92.4,6.924401501566195,19.596887575447997,184495,98.97921422239304,45.5766324953517,0.48520314755417504
12087,"Monroe County, Florida",77150,40911,36239,39176,59901,11559,4574,1498,981,75302,8750,7029,15779,9815,4908,4907,39920,898,8.25,92.5,9.141931302657161,12.72197018794556,7053,97.6046662346079,51.743357096565134,0.5302786779001945
12089,"Nassau County, Florida",77187,38139,39048,33337,55772,8847,3545,789,498,76329,5699,4470,10169,9702,4517,5185,32698,435,6.25,95.5,6.2601215230544005,12.569474134245404,4832,98.88841385207354,42.36205578659619,0.49411170274787203
12091,"Okaloosa County, Florida",195798,99177,96621,30775,133072,23974,11759,1812,1633,183652,13024,11667,24691,22821,10137,12684,92694,1793,9.36,92.7,7.765145711396439,11.655379523794931,15204,93.79666799456582,47.34164802500536,0.5065271351086323
12093,"Okeechobee County, Florida",39420,21306,18114,18611,26976,1985,661,182,65,36352,4176,3246,7422,9105,4243,4862,13250,87,10.73,93.5,2.3033992897006597,23.097412480974125,908,92.21714865550481,33.61237950279046,0.5404870624048707
12095,"Orange County, Florida",1256055,617633,638422,27394,825249,175902,62862,16732,7947,1244462,118252,104775,223027,212105,95644,116461,611025,6238,7.59,94.8,6.969519646830752,16.886601303286877,87541,99.07703086250204,48.64635704646692,0.4917244865869727
12097,"Osceola County, Florida",311962,153499,158463,20165,203314,27036,8109,1638,1189,310093,32755,28337,61092,60243,27494,32749,135412,1061,8.57,94.2,3.5055551637699462,19.311005827632854,10936,99.4008885697617,43.40656874875786,0.4920439027830313
12099,"Palm Beach County, Florida",1398757,676486,722271,36303,1013381,217583,83531,31005,14344,1386355,118884,102426,221310,191207,84888,106319,626367,6917,8,93.3,9.213894908121997,13.669779668662963,128880,99.11335564361787,44.78025847234366,0.48363368333456064
12101,"Pasco County, Florida",488310,237641,250669,26624,353206,52150,21306,3662,2297,482447,34478,30375,64853,65101,29029,36072,191024,2493,10.27,93.2,5.583543240973971,13.331899817738732,27265,98.79932829554996,39.11941184903033,0.4866601134525199
12103,"Pinellas County, Florida",939548,450712,488836,32120,712289,137065,50013,14909,8216,928648,68422,59895,128317,130727,58630,72097,424109,5379,13.39,93.2,7.7843814259622715,13.913818133826053,73138,98.83986768105514,45.139684188567266,0.47971152085896623
12105,"Polk County, Florida",637691,312427,325264,22579,437227,57131,21028,3789,3140,628714,52437,46263,98700,110225,49693,60532,248619,2828,8.97,94.4,4.384098254483755,17.28501735166405,27957,98.5922649057302,38.98737789932742,0.48993478032464
12107,"Putnam County, Florida",72304,35711,36593,18950,50941,4228,1547,429,255,71140,7303,6375,13678,19120,8545,10575,24539,191,6.21,94.7,3.0855830936047797,26.44390351847754,2231,98.39013055985838,33.938647930958176,0.4939007523788449
12109,"St. Johns County, Florida",218362,106007,112355,39563,153706,41875,16449,4271,2691,216749,10289,10246,20535,19372,8380,10992,98195,1045,8.12,94,10.72118775244777,8.871506947179455,23411,99.26131836125333,44.96890484608128,0.48546450389719825
12111,"St. Lucie County, Florida",293136,142999,150137,24940,209615,26727,11378,2382,1084,290892,26144,23962,50106,51945,23897,28048,114204,2006,12.75,92.5,5.063861142950712,17.720443753070246,14844,99.23448501719338,38.95939086294416,0.4878247639320998
12113,"Santa Rosa County, Florida",163903,83912,79991,28908,112777,20301,7665,1295,1063,154231,9455,8586,18041,19331,8580,10751,70778,573,7.99,91.8,6.115202284277896,11.794170942569691,10023,94.09894876847892,43.18285815390811,0.5119613429894511
12115,"Sarasota County, Florida",398011,189970,208041,37054,314565,62376,28451,8173,4989,394213,27269,23963,51232,43281,19526,23755,154510,1068,12.66,93.3,10.455238674307996,10.874322568974224,41613,99.04575501682115,38.82053511083865,0.47729836612555937
12117,"Seminole County, Florida",442905,213833,229072,31363,307232,73902,26018,6438,3771,440221,31265,28440,59705,53025,24153,28872,213323,2349,7.22,95.1,8.179406418983755,11.972093338300539,36227,99.39400097086282,48.16450480351317,0.48279653650331333
12119,"Sumter County, Florida",113589,57426,56163,33168,101207,17417,9827,1525,1408,104298,4201,4266,8467,10343,4293,6050,22115,1550,10.33,94.6,11.233482115345677,9.105635228763349,12760,91.82051078889681,19.469314810412982,0.5055595172067718
12121,"Suwannee County, Florida",43653,21469,22184,21565,30818,2701,836,66,107,42163,3854,2859,6713,9536,4321,5215,15692,243,10.61,95,2.311410441435869,21.8450049252056,1009,96.58671798043663,35.94712849059629,0.4918104139463496
12123,"Taylor County, Florida",22582,12572,10010,16979,16320,991,518,63,32,18655,1388,1209,2597,2746,1208,1538,6928,76,11.53,93.6,2.714551412629528,12.16012753520503,613,82.61004339739615,30.679302099016915,0.5567265964042157
12125,"Union County, Florida",15159,9842,5317,13485,11038,607,180,26,26,9990,598,656,1254,2232,942,1290,3887,61,8.27,95.4,1.5304439606834224,14.723926380368098,232,65.90144468632495,25.64153308265717,0.6492512698726829
12127,"Volusia County, Florida",510806,248681,262125,25871,374690,55056,19826,5157,3951,505366,43379,34399,77778,83660,38111,45549,202379,2497,6.84,94.7,5.664381389412028,16.37803784607072,28934,98.93501642502241,39.61954244860084,0.48684040516360416
12129,"Wakulla County, Florida",31314,17476,13838,22846,22313,2590,976,112,35,27721,1860,1444,3304,3970,1575,2395,13248,74,8.28,94.1,3.5862553490451554,12.678035383534521,1123,88.5258989589321,42.30695535543207,0.5580890336590663
12131,"Walton County, Florida",61528,31164,30364,30853,44776,8009,2581,765,425,59380,5864,4547,10411,10357,5220,5137,25891,607,9.82,92.9,6.128916915875699,16.832986607723313,3771,96.5089065141074,42.080028604862825,0.5065011051878819
12133,"Washington County, Florida",24627,13426,11201,18718,17617,1190,578,60,107,22100,1597,1387,2984,4532,2407,2125,8599,266,10.07,92.8,3.025135014415073,18.402566289032364,745,89.73890445446055,34.916961059000286,0.5451739960206278
13001,"Appling County, Georgia",18410,8971,9439,19936,12326,794,382,218,75,17935,1703,1616,3319,3694,1503,2191,6862,68,6.06,96.2,3.6664856056491035,20.06518196632265,675,97.41988049972841,37.27322107550244,0.4872895165670831
13003,"Atkinson County, Georgia",8268,4244,4024,19904,5211,206,112,23,7,8239,1134,987,2121,2270,1012,1258,3350,29,6.3,95.4,1.7174649250120948,27.45524915336236,142,99.64925012094824,40.51765844218674,0.5133043057571359
13005,"Bacon County, Georgia",11251,5597,5654,18856,7312,612,276,61,16,10651,917,826,1743,1949,872,1077,4352,0,5.8,96.1,3.1374988889876456,17.322904630699494,353,94.66714069860457,38.6810061327882,0.4974668918318372
13007,"Baker County, Georgia",3250,1577,1673,22270,2391,139,109,12,3,3250,368,247,615,509,240,269,1308,16,11.36,93.1,3.8153846153846156,15.661538461538461,124,100,40.246153846153845,0.48523076923076924
13009,"Baldwin County, Georgia",45808,22995,22813,20114,27875,2715,1674,370,376,43707,3083,2618,5701,12503,5566,6937,16485,225,5.52,95.7,5.282920013971359,27.294359063918964,2420,95.41346489696123,35.98716381418093,0.5019865525672371
13011,"Banks County, Georgia",18336,9276,9060,19451,12525,891,361,106,18,18322,1606,1544,3150,2837,1364,1473,7594,40,4.97,93.1,2.645069808027923,15.472294938917976,485,99.92364746945898,41.41579406631762,0.5058900523560209
13013,"Barrow County, Georgia",73340,36165,37175,22978,47542,5567,1729,438,246,73194,6407,5919,12326,10548,4510,6038,31979,159,6.21,93.1,3.290155440414508,14.382328879192801,2413,99.80092718843741,43.60376329424598,0.4931142623397873
13015,"Bartow County, Georgia",101942,50533,51409,24931,67331,8260,3185,781,240,101031,8027,7692,15719,14899,6461,8438,44727,682,5,92.8,4.125875497832101,14.615173333856507,4206,99.10635459378862,43.87494850012752,0.4957034392105315
13017,"Ben Hill County, Georgia",17405,8396,9009,16635,11400,779,317,87,20,17082,1700,1627,3327,5948,2539,3409,5601,59,8.52,94.6,2.436081585751221,34.1740879057742,424,98.14421143349612,32.180407928756104,0.4823901177822465
13019,"Berrien County, Georgia",18986,9394,9592,18064,12799,986,420,121,43,18696,2207,2048,4255,4811,2140,2671,6871,88,7.17,94.4,3.0759507005161697,25.339724007163174,584,98.4725587274834,36.189824080901715,0.4947856315179606
13021,"Bibb County, Georgia",154194,72823,81371,23426,99419,14679,6343,2062,1363,150680,11911,11385,23296,41075,17002,24073,59054,1128,7.07,95.9,6.334876843456944,26.63852030558906,9768,97.72105269984564,38.298507075502286,0.47228167114154895
13023,"Bleckley County, Georgia",12835,5911,6924,20667,7938,779,405,92,131,12474,799,648,1447,2593,1152,1441,4089,15,7.11,96.1,4.892871055707051,20.202571094663032,628,97.1873782625633,31.85820023373588,0.4605375925204519
13025,"Brantley County, Georgia",18403,9119,9284,18220,12177,656,321,128,53,18344,2250,2219,4469,3846,1562,2284,6451,36,5.91,96.3,2.727816116937456,20.898766505461065,502,99.67940009781015,35.05406727164049,0.4955170352659892
13027,"Brooks County, Georgia",15645,7540,8105,20964,10790,1011,259,60,12,15595,1632,1367,2999,3819,1431,2388,5533,59,8.11,94.1,2.1156919143496324,24.410354745925215,331,99.68040907638223,35.36593160754234,0.48194311281559604
13029,"Bryan County, Georgia",34104,17013,17091,29880,21502,4605,2038,306,219,33255,2212,2188,4400,4509,1972,2537,15480,187,8.35,95.9,7.515247478301665,13.221323011963406,2563,97.51055594651653,45.39057002111189,0.4988564391273751
13031,"Bulloch County, Georgia",73141,36097,37044,20526,39691,6282,3001,770,1159,72293,5171,5446,10617,20922,9770,11152,31383,255,7.15,95,6.740405518108858,28.605023174416537,4930,98.8405955619967,42.90753476162481,0.4935262028137433
13033,"Burke County, Georgia",22838,10941,11897,19720,14706,818,444,180,88,22590,1867,1681,3548,6862,2885,3977,8552,76,5.49,95.6,3.11761099921184,30.046413871617478,712,98.91409055083632,37.446361327611875,0.4790699711007969
13035,"Butts County, Georgia",23479,12469,11010,21236,16306,1169,262,219,14,20915,1696,1604,3300,4255,1848,2407,8562,91,5.06,94.8,2.108266961966012,18.122577622556328,495,89.07960304953363,36.46662975424848,0.5310703181566506
13037,"Calhoun County, Georgia",6443,3882,2561,13865,4751,311,144,15,19,4606,416,490,906,1489,694,795,1645,1,10.81,93.5,2.762688188731957,23.110352320347666,178,71.48843706347975,25.53158466552848,0.6025143566661493
13039,"Camden County, Georgia",52092,26946,25146,26854,31946,4568,2112,295,251,48375,3528,2834,6362,7029,3110,3919,23783,300,6.84,95.2,5.102510942179221,13.493434692467174,2658,92.86454733932274,45.65576288105659,0.5172771250863857
13043,"Candler County, Georgia",10962,5410,5552,18233,7238,671,168,109,82,10682,1202,1077,2279,3155,1414,1741,4215,79,6.88,95.4,3.2749498266739647,28.781244298485678,359,97.44572158365261,38.45101258894363,0.4935230797299763
13045,"Carroll County, Georgia",113756,55651,58105,23139,70887,7749,3232,1051,859,112668,9232,8219,17451,21157,8637,12520,47754,470,6.71,93.1,4.520201132247969,18.598579415591267,5142,99.04356693273321,41.97932416751644,0.489213755757938
13047,"Catoosa County, Georgia",65645,31839,33806,25643,44671,5890,2093,616,179,65161,4875,4273,9148,7700,3235,4465,30445,105,7.09,93,4.399421128798842,11.729758549775307,2888,99.26270089115698,46.3782466295986,0.4850178993068779
13049,"Charlton County, Georgia",12968,6695,6273,19102,9123,427,265,66,62,11838,1171,1269,2440,2420,1306,1114,4601,86,5.73,96.2,3.0305367057371995,18.661320172732882,393,91.2862430598396,35.4796421961752,0.5162708204811844
13051,"Chatham County, Georgia",282613,136383,146230,28765,186212,37771,16368,3985,3130,274555,22632,21577,44209,48550,19873,28677,130262,1183,10.2,95.9,8.309242674611571,17.178969120316474,23483,97.14875111902141,46.09200567560586,0.48257864995594685
13053,"Chattahoochee County, Georgia",11882,8023,3859,22774,5090,1182,260,44,47,7137,501,219,720,1174,700,474,6670,51,6.24,93.9,2.9540481400437635,9.880491499747517,351,60.06564551422319,56.13533075239859,0.6752230264265275
13055,"Chattooga County, Georgia",25046,13032,12014,17716,17270,991,405,111,23,23285,1927,2005,3932,5182,2186,2996,8910,32,7.06,92.2,2.1520402459474566,20.689930527828796,539,92.96893715563364,35.574542841172246,0.5203226064042162
13057,"Cherokee County, Georgia",230629,113565,117064,33466,152050,37080,12095,3032,1766,229621,16949,13660,30609,22891,10651,12240,111944,1629,4.77,91.2,7.324751007028604,9.925464707387189,16893,99.5629344098097,48.538561932801166,0.4924142237099411
13059,"Clarke County, Georgia",122037,58029,64008,21203,66272,13591,7880,1862,3675,121095,9604,9040,18644,39327,18748,20579,54501,621,9.05,94,10.994206675024788,32.22547260257135,13417,99.2281029523833,44.659406573416256,0.47550333095700487
13061,"Clay County, Georgia",3068,1471,1597,14559,2084,35,102,16,2,3012,432,340,772,1199,483,716,820,0,8.82,94.1,3.911342894393742,39.08083441981747,120,98.17470664928292,26.727509778357238,0.47946544980443284
13063,"Clayton County, Georgia",270269,127718,142551,19498,165413,21427,7488,1368,1193,266769,30274,30154,60428,64326,27861,36465,113377,1545,6.87,93.3,3.718147475293134,23.800731863439758,10049,98.7049939134714,41.94968716352967,0.4725588210264588
13065,"Clinch County, Georgia",6814,3418,3396,17145,4422,357,223,46,10,6701,665,725,1390,2368,1039,1329,2185,79,5.75,96.2,4.094511300264162,34.75198121514529,279,98.3416495450543,32.06633401819783,0.5016143234517171
13067,"Cobb County, Georgia",728388,352083,376305,36587,481463,142039,55252,11995,7304,723395,57857,53580,111437,83479,37326,46153,368545,4951,5.68,92.4,10.235067024717596,11.460787382548862,74551,99.3145136932514,50.597346469189496,0.48337287269971496
13069,"Coffee County, Georgia",43042,22025,21017,18945,27606,2196,919,337,160,39652,4487,4320,8807,9618,4017,5601,15625,289,7.42,95,3.289809953069095,22.345615910041356,1416,92.12397193438967,36.30175177733377,0.5117094930532968
13071,"Colquitt County, Georgia",46002,22919,23083,18121,29348,2277,1104,297,115,45356,6809,5307,12116,11305,5275,6030,18083,249,8.97,93,3.295508890917786,24.5750184774575,1516,98.59571322985957,39.30916047128386,0.4982174688057041
13073,"Columbia County, Georgia",139904,68243,71661,31720,91502,19636,8159,2527,1795,136346,5980,6004,11984,13225,5897,7328,63008,398,4.58,95.8,8.921117337602928,9.452910567246112,12481,97.4568275388838,45.03659652333028,0.48778448078682524
13075,"Cook County, Georgia",17103,8313,8790,17587,11114,959,396,125,58,16969,1834,1985,3819,4429,1957,2472,6969,33,7.2,94,3.3853709875460445,25.89604163012337,579,99.21651172308951,40.74723732678478,0.4860550780564813
13077,"Coweta County, Georgia",135625,66160,69465,31548,89400,16644,6450,1328,686,135011,7490,6937,14427,16138,6377,9761,63327,870,6.6,93.1,6.24073732718894,11.898986175115207,8464,99.54728110599078,46.69271889400922,0.48781566820276495
13079,"Crawford County, Georgia",12483,6398,6085,22212,8944,636,379,111,47,12322,1000,747,1747,2343,1123,1220,4782,34,6.86,94.7,4.301850516702716,18.76952655611632,537,98.71024593447088,38.30809901465994,0.5125370503885284
13081,"Crisp County, Georgia",23061,10784,12277,21225,15182,1537,499,149,104,22633,1998,2101,4099,7439,3097,4342,8385,83,9.13,95.1,3.260916699189107,32.25792463466458,752,98.14405272971683,36.36008846103812,0.4676293309049911
13083,"Dade County, Georgia",16356,7990,8366,23184,11161,1039,358,85,58,16156,1322,1258,2580,2502,1033,1469,7423,36,7.39,89.8,3.0630961115187088,15.297138664710198,501,98.7772071411103,45.38395695769137,0.4885057471264368
13085,"Dawson County, Georgia",22939,11329,11610,31954,16263,3129,1313,313,98,22691,1557,1486,3043,3028,1389,1639,10239,90,5.23,89.7,7.515584811892411,13.20022668817298,1724,98.91887179040063,44.6357731374515,0.4938750599415842
13087,"Decatur County, Georgia",27237,13219,14018,19650,17982,1810,810,218,199,25946,2620,2379,4999,6885,2883,4002,9817,414,8.09,93.6,4.504901420861328,25.278114329772002,1227,95.26012409589896,36.04288284319125,0.4853324521790212
13089,"DeKalb County, Georgia",723902,344188,379714,32110,485606,117894,56677,15973,12170,717481,64035,59000,123035,134830,60830,74000,345582,2778,6.18,93.2,11.717055623551254,18.6254493011485,84820,99.11300148362623,47.73878232136394,0.47546214819132976
13091,"Dodge County, Georgia",20995,11107,9888,18563,14510,1096,702,77,89,19154,1729,1106,2835,4219,1989,2230,7737,452,7.91,95.6,4.134317694689211,20.095260776375326,868,91.23124553465111,36.85163134079543,0.529030721600381
13093,"Dooly County, Georgia",14089,7691,6398,16867,9953,773,245,75,28,12459,1146,1043,2189,3013,1246,1767,4970,176,8.31,95.4,2.4700120661508977,21.38547803250763,348,88.4306906096955,35.27574703669529,0.545886862090993
13095,"Dougherty County, Georgia",92326,42785,49541,20292,58156,6898,2945,1080,572,90428,8967,8705,17672,26982,11375,15607,33985,226,11.12,93.4,4.979095812663822,29.224703767086194,4597,97.94424105885666,36.80978272642592,0.4634122565691138
13097,"Douglas County, Georgia",138283,66287,71996,25449,88440,14633,6537,1420,535,137173,10692,10754,21446,20805,9029,11776,63154,800,6.51,92.9,6.14102962764765,15.045233325860735,8492,99.19729829407808,45.67011129350679,0.4793575493733865
13099,"Early County, Georgia",10480,4822,5658,17972,6993,551,352,67,14,10329,994,904,1898,3216,1224,1992,3742,92,10.33,93.7,4.1316793893129775,30.68702290076336,433,98.55916030534351,35.70610687022901,0.4601145038167939
13101,"Echols County, Georgia",4025,1911,2114,20589,2555,141,39,10,11,4025,645,674,1319,1214,439,775,1721,30,7.03,95.4,1.4906832298136645,30.161490683229815,60,100,42.75776397515528,0.4747826086956522
13103,"Effingham County, Georgia",55852,27755,28097,26765,35904,4422,1611,472,58,55252,3117,3361,6478,5985,2394,3591,25611,333,8.88,95.7,3.8333452696411947,10.715820382439304,2141,98.92573229248728,45.85511709518012,0.49693833703358875
13105,"Elbert County, Georgia",19394,9234,10160,21138,13464,824,489,227,34,19165,1361,1400,2761,3768,1600,2168,7246,0,4.22,95.5,3.867175415076828,19.428689285345982,750,98.81922243992987,37.362070743528925,0.47612663710425907
13107,"Emanuel County, Georgia",22723,11166,11557,17944,14837,936,482,200,120,22047,2792,2129,4921,6465,3108,3357,7839,204,5.94,95.5,3.5294635391453593,28.451348853584474,802,97.02504070765303,34.49808564010034,0.49139638251991374
13109,"Evans County, Georgia",10733,5037,5696,20736,7134,739,218,40,80,10212,774,962,1736,2673,1090,1583,4161,287,6.88,96,3.149166123171527,24.904500139755893,338,95.14581198173856,38.76828472933942,0.4693002888288456
13111,"Fannin County, Georgia",24017,11646,12371,24845,18198,2009,730,362,124,23860,1762,1891,3653,4262,1531,2731,8760,172,7.07,87.6,5.063080318108007,17.745763417579216,1216,99.34629637340217,36.474164133738604,0.4849065245451139
13113,"Fayette County, Georgia",109495,52974,56521,39936,73601,21500,8742,2366,1084,108737,4284,4135,8419,7774,3125,4649,50098,706,6.77,93.2,11.134755011644367,7.09986757386182,12192,99.30773094661856,45.753687382985525,0.48380291337503994
13115,"Floyd County, Georgia",96199,46869,49330,23929,63533,7424,3185,1413,558,94051,7770,6992,14762,18192,8626,9566,39726,349,5.92,93.5,5.359723074044429,18.910799488560173,5156,97.7671285564299,41.29564756390399,0.48720880674435285
13117,"Forsyth County, Georgia",203841,101074,102767,39896,131143,42712,16471,2536,1584,203195,10248,9856,20104,13024,5697,7327,96413,758,4.2,91.1,10.10150067945114,6.389293616102747,20591,99.68308632708828,47.29813923597314,0.49584725349659786
13119,"Franklin County, Georgia",22188,10857,11331,19663,15156,1212,449,186,68,21987,2117,1930,4047,5426,2413,3013,7801,88,4.98,93.9,3.168379304128358,24.454660176672075,703,99.09410492157923,35.15864431224085,0.48931855056787454
13121,"Fulton County, Georgia",996757,483429,513328,41041,663465,198321,94178,25083,12864,987648,69532,65812,135344,163674,70953,92721,476794,4488,6.11,92.8,13.255487546112041,16.420652175003536,132125,99.08613634015111,47.83452737226827,0.4850018610353376
13123,"Gilmer County, Georgia",28956,14535,14421,23688,20808,2329,931,330,122,28736,3587,2819,6406,5556,2776,2780,11573,331,6.17,88.1,4.776212184003315,19.18773311230833,1383,99.24022655062853,39.96753695261776,0.5019685039370079
13125,"Glascock County, Georgia",3053,1491,1562,19815,2068,130,32,1,7,2962,237,243,480,450,226,224,1278,16,5.16,95.2,1.3101867016049786,14.73960039305601,40,97.01932525384868,41.86046511627907,0.4883720930232558
13127,"Glynn County, Georgia",82623,38982,43641,29209,56717,9697,4449,1313,515,81610,6553,6743,13296,15177,6288,8889,35704,459,7.6,95.4,7.5971581762947364,18.36897716132312,6277,98.7739491424906,43.213148881062175,0.47180567154424313
13129,"Gordon County, Georgia",56079,27736,28343,21208,37178,2857,1326,352,267,55548,5159,4883,10042,11388,5249,6139,23718,496,5.41,92.9,3.468321475061966,20.307066816455357,1945,99.05312148932755,42.29390681003584,0.49458799193994185
13131,"Grady County, Georgia",25145,12447,12698,20864,16758,1296,663,134,47,24957,2684,2568,5252,7337,3541,3796,9272,63,7.99,93.2,3.356532113740306,29.17876317359316,844,99.25233644859813,36.87413004573474,0.49500894810101415
13133,"Greene County, Georgia",16535,8036,8499,32890,12252,1599,963,371,99,16363,1516,1279,2795,3983,1889,2094,6106,225,6.1,94.3,8.666465074085274,24.088297550650136,1433,98.95978228001209,36.92772905957061,0.4859993952222558
13135,"Gwinnett County, Georgia",874242,427930,446312,27945,551242,128282,48139,8864,7262,869082,81425,77722,159147,112999,51833,61166,416125,3391,4.92,92.3,7.350939442396957,12.925368490646754,64265,99.40977441028915,47.59837665085869,0.48948689264528583
13137,"Habersham County, Georgia",43724,20741,22983,20656,29334,2824,1643,408,262,41434,3727,3625,7352,7471,3552,3919,16240,188,5.73,90.5,5.290000914829385,17.08672582563352,2313,94.76260177476901,37.142073003384866,0.47436190650443694
13139,"Hall County, Georgia",190482,94865,95617,26283,122335,17222,6819,2354,1098,189282,19343,17305,36648,33350,15809,17541,84673,1210,5.08,91.5,5.392110540628511,17.50821599941202,10271,99.37001921441396,44.45196921493894,0.49802606020516377
13141,"Hancock County, Georgia",8747,4939,3808,15454,6529,362,227,113,9,6746,392,553,945,2111,907,1204,2166,3,5,95.1,3.989939407796959,24.133988796158683,349,77.12358522922145,24.762775808848748,0.5646507373956785
13143,"Haralson County, Georgia",28667,13977,14690,23141,19290,1468,721,308,158,28327,2326,2106,4432,5721,2556,3165,11116,91,6.54,92.6,4.140649527331077,19.956744689015245,1187,98.81396727945024,38.77629329891513,0.48756409809188267
13145,"Harris County, Georgia",32992,16487,16505,32373,22924,3667,1582,654,195,32534,2124,1548,3672,2722,1180,1542,14885,248,8.31,92.8,7.368452958292919,8.250484966052376,2431,98.61178467507274,45.11699806013579,0.4997272065955383
13147,"Hart County, Georgia",25518,12561,12957,21668,17939,1539,555,227,128,24666,2496,1864,4360,5228,2348,2880,9751,45,5.2,94.7,3.5661101967238813,20.487499020299396,910,96.66118034328709,38.212242338741284,0.49224077122031507
13149,"Heard County, Georgia",11571,5739,5832,20946,7846,452,251,83,38,11425,781,854,1635,1930,830,1100,4555,37,6.67,93.3,3.2149338864402384,16.679630109757152,372,98.73822487252615,39.36565551810561,0.4959813326419497
13151,"Henry County, Georgia",214171,102486,111685,26924,136110,24060,9810,2231,1300,212951,13389,14424,27813,25657,11450,14207,92536,796,6.4,93.9,6.229134663423152,11.979679788580153,13341,99.4303617203076,43.206596598045486,0.478524169938974
13153,"Houston County, Georgia",149137,72545,76592,26305,96336,13933,7431,1281,508,145953,10009,9371,19380,26411,11142,15269,65160,453,7.2,95.9,6.182235126092117,17.709220381260184,9220,97.86505025580506,43.69137102127574,0.48643193841903754
13155,"Irwin County, Georgia",9365,4797,4568,19429,6386,373,165,101,73,8926,969,673,1642,2217,1063,1154,3102,30,8.32,94.2,3.619861185264282,23.67325146823278,339,95.31233315536572,33.12333155365724,0.5122263747997864
13157,"Jackson County, Georgia",62131,30638,31493,25598,41310,5270,1723,664,220,61604,4284,4400,8684,8330,3734,4596,26596,159,5.23,93.1,4.195973024738054,13.407155848127344,2607,99.15179218103684,42.806328563840914,0.49311937680063095
13159,"Jasper County, Georgia",13571,6604,6967,19784,9206,541,296,61,56,13475,1122,972,2094,2685,1057,1628,5493,74,4.82,95.2,3.0432539974946575,19.784835310588754,413,99.2926092402918,40.476015032053645,0.4866258934492668
13161,"Jeff Davis County, Georgia",14953,7192,7761,18550,9527,528,288,158,50,14859,1275,1427,2702,3079,1109,1970,5450,21,6.98,95.4,3.317060121714706,20.59118571524109,496,99.37136360596536,36.44753561158296,0.4809737176486324
13163,"Jefferson County, Georgia",16201,7835,8366,17485,10734,766,310,38,4,15707,1713,1531,3244,4535,1959,2576,5289,18,5.69,95.4,2.172705388556262,27.992099253132523,352,96.95080550583297,32.64613295475588,0.4836121227084748
13165,"Jenkins County, Georgia",9055,4456,4599,15149,6157,455,297,50,0,8976,813,593,1406,2539,1159,1380,3115,0,5.95,95,3.832136940916621,28.039757040309222,347,99.12755383765875,34.40088348978465,0.4921038100496963
13167,"Johnson County, Georgia",9694,5141,4553,19706,6444,327,161,0,72,9446,1033,714,1747,2363,1187,1176,3798,123,5.97,96.2,2.4035485867546935,24.375902620177428,233,97.44171652568599,39.17887353001857,0.5303280379616258
13169,"Jones County, Georgia",28701,13910,14791,26098,19454,2308,1203,311,114,28373,2147,1704,3851,3888,1685,2203,12277,21,5.75,95.5,5.672276227309153,13.54656632173095,1628,98.85718267656179,42.77551304832584,0.4846521027141911
13171,"Lamar County, Georgia",18195,8767,9428,20458,11639,1422,365,54,156,17941,1544,1699,3243,3746,1864,1882,6685,100,5.79,93.7,3.160208848584776,20.58807364660621,575,98.60401209123386,36.740862874416045,0.4818356691398736
13173,"Lanier County, Georgia",10382,5247,5135,17739,6876,698,287,57,17,9840,1083,1044,2127,2827,1255,1572,3698,42,5.62,95.1,3.4771720285108842,27.22982084376806,361,94.77942592949336,35.619341167405125,0.5053939510691582
13175,"Laurens County, Georgia",47802,22691,25111,20687,31817,2541,1617,502,188,46786,3180,3266,6446,12972,5778,7194,16626,119,6.97,96.3,4.8261579013430405,27.136939876992596,2307,97.87456591774402,34.78097150746831,0.4746872515794318
13177,"Lee County, Georgia",29134,14605,14529,28061,18946,2603,1547,298,130,27959,1641,1504,3145,3334,1476,1858,13154,13,9.39,94,6.779021075032608,11.44367405780188,1975,95.96691151232237,45.14999656758427,0.5013043179789937
13179,"Liberty County, Georgia",63949,32636,31313,20966,35858,4583,1706,251,237,57948,4263,3756,8019,10443,4540,5903,27878,316,7.45,96.1,3.430858965738323,16.330200628625935,2194,90.61595959280051,43.59411405964128,0.510344180518851
13181,"Lincoln County, Georgia",7712,3606,4106,24529,5626,477,201,40,22,7620,557,580,1137,1939,775,1164,3046,31,4.17,95.4,3.4102697095435683,25.142634854771785,263,98.80705394190872,39.49688796680498,0.4675829875518672
13183,"Long County, Georgia",17243,8627,8616,20321,10290,1136,392,17,23,16281,1657,1143,2800,2765,1383,1382,6403,256,7.37,96.5,2.5053644957374006,16.035492663689613,432,94.4209244331033,37.13390941251522,0.5003189700168185
13185,"Lowndes County, Georgia",113898,55878,58020,21199,65985,9519,4296,1070,856,108760,9960,9010,18970,27436,12180,15256,48555,317,7,94.8,5.462782489595955,24.0882192839207,6222,95.48894625015365,42.63024811673603,0.49059684981299057
13187,"Lumpkin County, Georgia",31094,15371,15723,23364,19281,3133,1397,354,319,30787,2447,2024,4471,6426,3145,3281,14168,24,6.21,89.1,6.657232906670097,20.666366501575865,2070,99.01267125490449,45.56506078343089,0.49433974400205827
13189,"McDuffie County, Georgia",21558,10084,11474,20436,14220,1355,405,180,77,21193,1635,1889,3524,5537,2349,3188,8306,192,4.45,95,3.0707857871787736,25.684200760738474,662,98.30689303274886,38.52862046572038,0.46776138788384825
13191,"McIntosh County, Georgia",13941,6865,7076,25226,10293,793,472,61,91,13827,1236,988,2224,2788,1223,1565,5252,0,7.72,96,4.476006025392726,19.99856538268417,624,99.18226812997632,37.67305071372211,0.49243239365899144
13193,"Macon County, Georgia",13846,7702,6144,15919,9578,525,224,14,54,11966,1340,1100,2440,3897,1695,2202,4226,157,7.35,94.6,2.108912321248014,28.145312725696954,292,86.4220713563484,30.52145023833598,0.5562617362415138
13195,"Madison County, Georgia",28362,14038,14324,22885,19410,1754,883,235,131,28169,2309,2201,4510,4520,2105,2415,11380,93,6.64,93.6,4.403779705239405,15.9368168676398,1249,99.31951202312953,40.124109724278966,0.49495804245116704
13197,"Marion County, Georgia",8646,4246,4400,20154,6040,380,217,63,9,8549,841,552,1393,2151,846,1305,2954,121,7.07,93,3.342586167013648,24.87855655794587,289,98.87809391626186,34.166088364561645,0.4910941475826972
13199,"Meriwether County, Georgia",21195,10224,10971,19679,14705,937,407,109,39,21069,1748,1781,3529,4943,2116,2827,7657,62,6.66,92.6,2.618542108987969,23.321538098608162,555,99.40552016985139,36.12644491625383,0.4823779193205945
13201,"Miller County, Georgia",5911,2839,3072,21002,4078,330,90,21,24,5751,475,464,939,1441,564,877,2300,45,10.47,93.4,2.283877516494671,24.37827778717645,135,97.29318220267298,38.91050583657587,0.48029098291321265
13205,"Mitchell County, Georgia",22778,11847,10931,16088,15341,1225,545,2,68,20550,2002,2395,4397,6085,2464,3621,7474,71,10.54,92.7,2.6999736587935725,26.714373518307138,615,90.21863201334621,32.81236280621653,0.5201071209061375
13207,"Monroe County, Georgia",27044,13551,13493,30359,18968,2271,1364,342,231,25875,1655,1667,3322,3419,1468,1951,10712,90,6.02,94.9,7.162402011536755,12.642360597544743,1937,95.67741458364148,39.60952521816299,0.5010723265789084
13209,"Montgomery County, Georgia",9005,4610,4395,20114,5999,557,277,51,48,8603,666,711,1377,1879,856,1023,3469,90,6.69,95.9,4.175458078845086,20.866185452526373,376,95.53581343697945,38.52304275402554,0.5119378123264853
13211,"Morgan County, Georgia",17943,8612,9331,28830,12277,1598,638,259,55,17768,1162,1212,2374,2354,906,1448,7632,46,5.46,94.7,5.305690241319735,13.119322298389344,952,99.02468929387504,42.534693195117875,0.479964331494176
13213,"Murray County, Georgia",39358,19520,19838,19084,25808,1701,679,274,150,39150,4065,3609,7674,7315,3479,3836,16202,99,6.05,92,2.802479800802886,18.58580212409167,1103,99.47151786167997,41.16570963971746,0.4959601605772651
13215,"Muscogee County, Georgia",200303,98284,102019,24604,128278,19564,8557,2461,1490,187954,14610,12816,27426,40006,17264,22742,86877,1093,7.28,94,6.244539522623226,19.972741296935144,12508,93.83484021707113,43.37279022281244,0.4906766249132564
13217,"Newton County, Georgia",103901,49424,54477,23611,65767,8429,3453,646,503,102985,6612,7279,13891,17415,7451,9964,43464,465,5.16,94.4,4.429216273183126,16.761147630917893,4602,99.1183915457984,41.83212866093685,0.47568358341113176
13219,"Oconee County, Georgia",35071,17207,17864,38639,22922,5046,3440,1019,1167,34874,1578,1480,3058,2485,1164,1321,16666,66,9.47,94.3,16.041743890964046,7.085626300932394,5626,99.43828234153574,47.52074363434176,0.4906332867611417
13221,"Oglethorpe County, Georgia",14743,7397,7346,21858,10448,1011,566,83,76,14602,1095,973,2068,2612,1073,1539,6245,97,6.81,94.5,4.917588007868141,17.716882588347012,725,99.04361391846979,42.359085667774536,0.5017296344027674
13223,"Paulding County, Georgia",149830,72973,76857,26636,94847,15320,5956,1585,503,149128,9494,9162,18656,15974,6389,9585,69921,278,5.73,92.6,5.368751251418274,10.661416271774678,8044,99.53146899819795,46.666889141026495,0.48703864379630246
13225,"Peach County, Georgia",26907,13007,13900,22388,16724,2006,1059,151,154,26774,2390,2394,4784,5206,2156,3050,10966,54,6.74,95.3,5.0693128182257405,19.348125023228157,1364,99.505704835173,40.75519381573568,0.48340580518080795
13227,"Pickens County, Georgia",29992,14904,15088,29460,21707,3425,1441,387,121,29760,2048,1731,3779,3058,1375,1683,12530,199,5.54,89.4,6.498399573219525,10.196052280608162,1949,99.22646038943718,41.77780741531075,0.49693251533742333
13229,"Pierce County, Georgia",19030,9564,9466,23754,12828,892,444,174,145,18883,1932,1621,3553,3764,1964,1800,7266,122,5.83,96.6,4.009458749343143,19.77929584866001,763,99.22753547031003,38.18181818181818,0.5025748817656333
13231,"Pike County, Georgia",17843,8753,9090,25176,11962,1181,345,191,114,17580,1441,1482,2923,2120,1033,1087,7344,11,6.05,93,3.6428851650507204,11.88141007678081,650,98.52603261783332,41.15899792635768,0.49055652076444545
13233,"Polk County, Georgia",41263,20107,21156,22314,27025,2043,1041,347,78,40989,3991,2753,6744,8229,3540,4689,16374,193,5.97,93.4,3.552819717422388,19.942805903594017,1466,99.33596684681191,39.68203959964133,0.48728885442163683
13235,"Pulaski County, Georgia",11460,4756,6704,18623,8381,451,416,53,70,9874,787,835,1622,2342,901,1441,3743,0,7.51,95.9,4.703315881326352,20.43630017452007,539,86.16055846422339,32.661431064572426,0.4150087260034904
13237,"Putnam County, Georgia",21259,10526,10733,27498,15427,1898,681,158,85,21092,2132,1290,3422,3727,1984,1743,9063,203,4.89,95.2,4.346394468225222,17.531398466531822,924,99.21445035043982,42.63135613152077,0.4951314737287737
13239,"Quitman County, Georgia",2095,1045,1050,18921,1577,97,27,11,0,2095,217,156,373,538,215,323,646,6,7.87,94.5,1.8138424821002386,25.68019093078759,38,100,30.83532219570406,0.4988066825775656
13241,"Rabun County, Georgia",16312,8066,8246,26942,12185,1896,764,254,295,16109,2011,1592,3603,3491,1648,1843,6108,23,6.71,87.8,8.049288867091711,21.401422265816578,1313,98.75551741049534,37.44482589504659,0.4944825895046591
13243,"Randolph County, Georgia",7224,3734,3490,19781,4800,390,193,20,38,7105,860,554,1414,2018,1049,969,2542,40,9.36,93.8,3.47452934662237,27.93466223698782,251,98.35271317829458,35.18826135105205,0.5168881506090809
13245,"Richmond County, Georgia",201418,97454,103964,21464,129729,16896,6207,2501,1696,191611,14700,14480,29180,48495,21318,27177,81125,529,4.94,96.4,5.165377473711386,24.076795519764868,10404,95.13102106067979,40.27693652007269,0.4838395773962605
13247,"Rockdale County, Georgia",87569,41424,46145,24254,56812,10093,3420,662,574,86809,7140,7978,15118,14863,6665,8198,37121,151,6.06,93.9,5.316950062236637,16.972901369205996,4656,99.1321129623497,42.39057200607521,0.47304411378455846
13249,"Schley County, Georgia",5089,2513,2576,19761,3310,300,153,12,27,5089,510,481,991,1113,414,699,1961,3,7.48,93.3,3.7728433876989587,21.8707015130674,192,100,38.534093142071136,0.4938101788170564
13251,"Screven County, Georgia",14114,6910,7204,20255,9604,940,300,94,47,13708,1337,1243,2580,3425,1526,1899,5390,65,7.4,95.1,3.1245571772707947,24.266685560436446,441,97.12342355108403,38.18903216664305,0.4895848094090974
13253,"Seminole County, Georgia",8696,4140,4556,21257,6067,561,225,71,48,8594,781,808,1589,1639,678,961,2870,43,9.29,93.9,3.955841766329347,18.847746090156395,344,98.82704691812327,33.00367985280589,0.4760809567617295
13255,"Spalding County, Georgia",64006,31064,32942,21675,42819,4211,1479,482,418,62927,5910,4698,10608,14798,6122,8676,23516,144,5.82,93.6,3.716839046339406,23.119707527419305,2379,98.3142205418242,36.74030559635034,0.4853295003593413
13257,"Stephens County, Georgia",25584,12114,13470,21657,17097,1552,994,392,75,25577,2131,1940,4071,4995,2443,2552,9955,35,5.15,93.6,5.710600375234522,19.52392120075047,1461,99.97263914946842,38.911038148843026,0.47349906191369606
13259,"Stewart County, Georgia",5791,3528,2263,14954,4204,359,50,27,2,4039,525,371,896,1666,664,1002,1319,0,7.31,94,1.3641858055603522,28.7687791400449,79,69.74615783111724,22.776722500431703,0.6092212053185978
13261,"Sumter County, Georgia",31070,14699,16371,18785,19329,1860,1178,479,339,30177,2385,2096,4481,9749,4144,5605,11224,21,7.96,93.9,6.42420341165111,31.37753459929192,1996,97.12584486643064,36.12487930479562,0.47309301577084006
13263,"Talbot County, Georgia",6373,3043,3330,21351,4665,400,123,25,42,6354,379,509,888,1307,625,682,2539,126,7.15,92.5,2.9813274752863643,20.508394790522516,190,99.70186725247136,39.83994978816884,0.47748313196296877
13265,"Taliaferro County, Georgia",1904,970,934,17939,1437,82,31,6,7,1904,232,130,362,593,246,347,637,17,4.42,94.2,2.310924369747899,31.144957983193276,44,100,33.455882352941174,0.509453781512605
13267,"Tattnall County, Georgia",25260,14743,10517,16279,17578,1271,492,191,44,19083,1477,1493,2970,5290,1939,3351,7196,286,6.87,96.3,2.878068091844814,20.94220110847189,727,75.54631828978623,28.487727632620743,0.5836500395882819
13269,"Taylor County, Georgia",8354,4028,4326,18482,5724,473,147,17,11,8137,898,726,1624,2310,1019,1291,2809,58,6.16,93.4,2.094804883887958,27.651424467321043,175,97.40244194397893,33.624610964807275,0.4821642327028968
13271,"Telfair County, Georgia",16405,9452,6953,13594,12296,647,355,71,49,12591,1097,996,2093,3611,1298,2313,4383,81,8.23,95.3,2.895458701615361,22.01158183480646,475,76.75099055166108,26.717464187747638,0.5761658031088083
13273,"Terrell County, Georgia",9132,4313,4819,17562,6128,412,197,74,57,8801,825,798,1623,3053,1236,1817,3132,0,9.37,93.5,3.591765221200175,33.431887866841876,328,96.37538326763031,34.2969776609724,0.4722952255803767
13275,"Thomas County, Georgia",44977,21310,23667,24047,30456,3305,1638,499,506,44305,3802,3706,7508,9377,4323,5054,16945,201,8.21,93.2,5.8763367943615625,20.848433643862418,2643,98.50590301709762,37.67481157035818,0.47379771883407074
13277,"Tift County, Georgia",40691,19224,21467,20800,25633,2284,1417,420,370,40277,4233,4024,8257,10638,4572,6066,16276,275,8.19,93.7,5.42380378953577,26.143373227495022,2207,98.9825759996068,39.999016981642136,0.4724386227912806
13279,"Toombs County, Georgia",27160,12685,14475,21309,17410,1877,790,204,92,26893,3123,2905,6028,7117,3152,3965,10196,258,6.57,96.1,3.9985272459499264,26.2039764359352,1086,99.01693667157585,37.54050073637703,0.46704712812960236
13281,"Towns County, Georgia",10976,5211,5765,22301,8085,1244,527,152,109,10807,726,706,1432,1528,642,886,3885,90,7.48,86.5,7.179300291545189,13.921282798833818,788,98.46027696793003,35.39540816326531,0.4747631195335277
13283,"Treutlen County, Georgia",6711,3296,3415,20775,4602,526,149,46,38,6341,543,531,1074,1184,482,702,2716,37,6.26,96.1,3.4719117866189837,17.6426762032484,233,94.48666368648487,40.4708687229921,0.4911339591715095
13285,"Troup County, Georgia",69314,33253,36061,22091,44457,5002,2297,666,374,67874,4623,4783,9406,14388,5497,8891,28546,367,7.81,93.2,4.814323224745362,20.757711284877512,3337,97.92249761952853,41.18359927287417,0.4797443517904031
13287,"Turner County, Georgia",8151,4040,4111,20302,5498,437,113,111,14,7802,1013,693,1706,2157,985,1172,2951,32,8.71,94.2,2.9198871304134464,26.46301067353699,238,95.71831677094835,36.20414673046252,0.49564470617102196
13289,"Twiggs County, Georgia",8363,4159,4204,17485,5884,379,248,58,0,8277,689,547,1236,2504,1149,1355,2443,9,6.56,96,3.65897405237355,29.94140858543585,306,98.97166088724143,29.21200526126988,0.4973095779026665
13291,"Union County, Georgia",22033,10784,11249,26755,17105,2089,1336,240,161,21553,1487,1184,2671,2822,1427,1395,7428,71,7.68,86.8,7.8836291018018425,12.80806063631825,1737,97.82144964371625,33.71306676349113,0.48944764671175056
13293,"Upson County, Georgia",26394,12595,13799,19624,17921,1375,728,203,87,25839,1844,2332,4176,5910,2764,3146,9463,120,7.06,93.1,3.856937182693036,22.391452602864288,1018,97.89724937485792,35.852845343638705,0.47719178601197243
13295,"Walker County, Georgia",68143,33874,34269,22564,47314,4816,1585,438,267,66802,4665,5571,10236,12273,5753,6520,27716,123,7.27,91.3,3.360579956855436,18.010654065714746,2290,98.0320795973174,40.67328999310274,0.49710168322498277
13297,"Walton County, Georgia",87436,42594,44842,25184,57494,7341,2263,780,300,86665,5248,5870,11118,11365,4408,6957,37545,286,6.81,93.9,3.8233679491285053,12.998078594629215,3343,99.11821217805023,42.93997895603641,0.4871448831145066
13299,"Ware County, Georgia",35671,17684,17987,19246,23805,1784,776,343,150,33339,2885,3141,6026,9310,3599,5711,12982,101,5.91,96.5,3.557511704185473,26.099632754898938,1269,93.4624765215441,36.39370917552073,0.4957528524571781
13301,"Warren County, Georgia",5504,2563,2941,20712,3896,304,126,36,5,5428,406,524,930,1432,627,805,2028,21,4.57,94.6,3.034156976744186,26.017441860465116,167,98.61918604651163,36.84593023255814,0.4656613372093023
13303,"Washington County, Georgia",20680,10436,10244,19238,14146,1217,430,80,13,18992,1298,1415,2713,4996,1905,3091,7490,124,5.71,96,2.5290135396518374,24.158607350096712,523,91.8375241779497,36.21856866537718,0.504642166344294
13305,"Wayne County, Georgia",30006,15334,14672,19188,20107,1560,776,226,117,27799,2639,2936,5575,5684,2308,3376,9882,235,5.99,96.5,3.729254149170166,18.942878091048456,1119,92.64480437245884,32.93341331733653,0.5110311271079118
13307,"Webster County, Georgia",2672,1364,1308,22206,1804,85,71,12,2,2667,107,230,337,596,218,378,1096,23,7.86,93.4,3.181137724550898,22.305389221556887,85,99.812874251497007,41.01796407185629,0.5104790419161677
13309,"Wheeler County, Georgia",7932,5145,2787,11192,5691,213,59,9,0,5092,397,647,1044,1383,493,890,1541,21,7.54,95.8,0.8572869389813415,17.4357034795764,68,64.19566313666162,19.42763489662128,0.6486384266263238
13311,"White County, Georgia",28140,13642,14498,23630,19738,2417,1254,275,158,27956,2074,1835,3909,5345,2411,2934,10990,6,5.84,89.3,5.9950248756218905,18.994314143567873,1687,99.34612651030561,39.0547263681592,0.4847903340440654
13313,"Whitfield County, Georgia",103653,51439,52214,22262,65576,5767,1910,1001,208,102871,11076,10555,21631,20126,9359,10767,44990,380,6.35,93.2,3.0090783672445562,19.416707668856667,3119,99.24555970401242,43.40443595457922,0.49626156502947333
13315,"Wilcox County, Georgia",8884,5240,3644,15119,6359,356,179,46,25,6818,494,525,1019,1422,618,804,2460,22,8.41,95.2,2.814047726249437,16.0063034669068,250,76.74470959027465,27.69022962629446,0.589824403421882
13317,"Wilkes County, Georgia",9924,4723,5201,21957,6884,511,228,109,101,9821,916,666,1582,2620,1106,1514,3629,14,4.26,94.5,4.41354292623942,26.400644901249496,438,98.9621120515921,36.56791616283756,0.4759169689641274
13319,"Wilkinson County, Georgia",9312,4454,4858,19823,6423,316,192,34,13,9218,538,446,984,1915,795,1120,3297,25,6.03,96.2,2.566580756013746,20.564862542955325,239,98.9905498281787,35.40592783505155,0.47830756013745707
13321,"Worth County, Georgia",20988,10226,10762,20783,14295,981,393,43,43,20826,2039,1982,4021,3837,1806,2031,8580,34,9.43,93.5,2.2822565275395466,18.281875357347054,479,99.22813036020584,40.880503144654085,0.48723079855155327
16001,"Ada County, Idaho",425798,213344,212454,31642,281818,69905,23725,6548,4010,419643,23887,20828,44715,51101,23989,27112,205169,1089,1.95,90.1,8.051470415549158,12.001230630486756,34283,98.55447888435361,48.184585178887644,0.5010450965011578
16003,"Adams County, Idaho",3865,2034,1831,24315,2945,417,202,41,8,3835,321,381,702,561,302,259,1499,33,5.28,80.9,6.494178525226391,14.514877102199224,251,99.22380336351875,38.783958602846056,0.526261319534282
16005,"Bannock County, Idaho",83815,41777,42038,23872,52263,9505,2868,1054,962,82662,4664,4565,9229,14875,6978,7897,36058,214,3.75,84.5,5.827119250730776,17.747419912903418,4884,98.6243512497763,43.020938972737575,0.4984429994631033
16007,"Bear Lake County, Idaho",5928,2943,2985,24411,3923,624,101,16,25,5889,310,277,587,847,420,427,2457,4,4.67,80.6,2.395411605937922,14.288124156545209,142,99.34210526315789,41.44736842105263,0.4964574898785425
16009,"Benewah County, Idaho",9068,4621,4447,23120,6379,562,233,43,30,8982,917,643,1560,1510,710,800,3459,60,8.68,81.6,3.3745037494486105,16.651962946625495,306,99.0516100573445,38.145125716806355,0.5095941773268637
16011,"Bingham County, Idaho",45261,22611,22650,20720,27068,3501,1034,267,84,44950,2967,2976,5943,6008,2957,3051,18586,145,3.53,85.2,3.0600296060626144,13.274121208104107,1385,99.31287421842204,41.06405072799982,0.49956916550672764
16013,"Blaine County, Idaho",21427,10824,10603,32736,15049,4486,1246,288,278,21401,2128,1409,3537,2707,1297,1410,11501,120,3.77,81,8.45662015214449,12.633593130162879,1812,99.87865776823634,53.67526951976478,0.5051570448499557
16015,"Boise County, Idaho",6891,3616,3275,29648,5247,948,315,80,72,6864,545,305,850,938,507,431,2641,19,5.67,80.6,6.776955449136555,13.61195762588884,467,99.60818458859382,38.32535190828617,0.5247424176462052
16017,"Bonner County, Idaho",41389,20754,20635,25909,30431,4512,1436,446,318,41054,3042,3015,6057,6092,2750,3342,16008,186,10.74,78.5,5.315421972021552,14.718886660706952,2200,99.1906061997149,38.676943149145906,0.5014375800333422
16019,"Bonneville County, Idaho",108989,54256,54733,25706,65861,12670,3978,836,850,107706,6789,6070,12859,13711,5862,7849,46927,471,5.07,80.8,5.196854728458836,12.580168640872015,5664,98.82281698153025,43.05663874335942,0.49781170576847206
16021,"Boundary County, Idaho",11141,5646,5495,24606,7716,879,319,115,35,11062,1121,1260,2381,1813,858,955,3794,27,11.98,74.3,4.209675971636298,16.2732250246836,469,99.29090745893546,34.05439368099812,0.5067767704873889
16023,"Butte County, Idaho",2592,1374,1218,26227,1826,195,69,3,5,2553,164,184,348,396,214,182,959,5,3.25,83.1,2.970679012345679,15.277777777777779,77,98.49537037037037,36.998456790123456,0.5300925925925926
16025,"Camas County, Idaho",968,500,468,29193,643,113,10,2,7,968,112,100,212,192,88,104,458,12,4.94,78.2,1.962809917355372,19.834710743801654,19,100,47.31404958677686,0.5165289256198347
16027,"Canyon County, Idaho",202782,100584,102198,19765,122815,15985,5173,556,828,201184,17285,15760,33045,37366,17379,19987,84136,917,1.62,91,3.2335217129725518,18.426684814234005,6557,99.21196161394995,41.490862108076655,0.4960203568364056
16029,"Caribou County, Idaho",6813,3467,3346,25669,4411,590,102,31,74,6734,311,247,558,680,308,372,3035,6,4.97,81.1,3.038309114927345,9.980918831645385,207,98.84045207691179,44.547189197123146,0.5088800821958022
16031,"Cassia County, Idaho",23441,11954,11487,20007,13705,1776,534,185,49,23090,2199,2037,4236,3563,1619,1944,9617,12,3.57,84.3,3.276310737596519,15.1998634870526,768,98.50262360820784,41.02640672326266,0.5099611791305831
16033,"Clark County, Idaho",960,488,472,15283,545,60,23,0,0,960,204,117,321,260,162,98,411,0,4.48,80.2,2.3958333333333335,27.083333333333332,23,100,42.8125,0.5083333333333333
16035,"Clearwater County, Idaho",8528,4772,3756,22169,6721,776,234,93,28,7444,448,550,998,972,435,537,2784,53,7.69,78.4,4.162757973733584,11.397748592870544,355,87.28893058161351,32.645403377110696,0.5595684803001876
16037,"Custer County, Idaho",4185,2122,2063,23290,3236,556,221,60,10,4152,176,398,574,852,416,436,1668,79,5.13,75.9,6.953405017921147,20.3584229390681,291,99.21146953405018,39.85663082437276,0.5070489844683393
16039,"Elmore County, Idaho",26103,13525,12578,23029,15788,1823,621,100,71,23889,1536,1597,3133,4587,2165,2422,11659,65,3.65,85,3.034134007585335,17.572692793931733,792,91.51821629697736,44.665364134390686,0.5181396774317129
16041,"Franklin County, Idaho",13013,6632,6381,20454,7555,1057,304,69,49,12971,815,866,1681,1606,731,875,5350,50,4.3,85,3.2429109352186276,12.341504649196956,422,99.67724583109198,41.11273342042573,0.5096442019518943
16043,"Fremont County, Idaho",12896,6664,6232,21611,8169,1251,344,55,55,12323,828,936,1764,1475,658,817,5124,66,4.68,79.8,3.520471464019851,11.437655086848634,454,95.55676178660049,39.73325062034739,0.5167493796526055
16045,"Gem County, Idaho",16853,8260,8593,20041,11858,1279,422,93,17,16713,1483,1596,3079,3705,1828,1877,5875,121,3.69,87.7,3.156708004509583,21.984216459977453,532,99.16928736723432,34.860262267845485,0.490120453331751
16047,"Gooding County, Idaho",15157,7870,7287,20821,9560,1006,254,87,18,15075,1652,1484,3136,2348,1210,1138,6782,98,2.37,87.9,2.368542587583295,15.491192188427789,359,99.45899584350465,44.745002309164086,0.5192320380022432
16049,"Idaho County, Idaho",16251,8435,7816,20741,11886,1480,353,94,81,15708,1014,1058,2072,2536,1292,1244,5991,22,5.29,78.5,3.2490308288720695,15.605193526552211,528,96.65866715894407,36.86542366623593,0.519044981847271
16051,"Jefferson County, Idaho",27096,13741,13355,21519,15446,2460,520,175,55,27065,2087,1478,3565,3023,1222,1801,11192,153,2.4,87,2.7679362267493355,11.156628284617655,750,99.88559196929437,41.30498966637142,0.5071228225568349
16053,"Jerome County, Idaho",22694,11491,11203,19329,13618,1454,336,103,49,22567,2861,2383,5244,3786,1633,2153,9363,43,2.74,87.9,2.150348109632502,16.682823653829207,488,99.44038071737023,41.25760112805147,0.5063452895038336
16055,"Kootenai County, Idaho",147716,73116,74600,28275,100600,16066,5565,1615,881,146447,9868,9667,19535,18412,8119,10293,65013,657,9.21,80.3,5.4570933412765035,12.4644588263966,8061,99.14091906090064,44.01215846624604,0.4949768474640526
16057,"Latah County, Idaho",38593,19614,18979,24166,21318,5896,2411,507,979,38422,1472,1678,3150,7929,3999,3930,18301,104,7.05,82.8,10.097686108879849,20.54517658642759,3897,99.556914466354,47.42051667400824,0.5082268805223745
16059,"Lemhi County, Idaho",7743,3942,3801,22489,5972,906,238,73,40,7656,623,545,1168,1284,663,621,3005,60,3.22,76.7,4.533126695079426,16.582719876017048,351,98.87640449438203,38.80924706186233,0.5091049980627663
16061,"Lewis County, Idaho",3826,1906,1920,23285,2710,321,104,4,5,3772,297,364,661,598,249,349,1530,19,4.43,80.8,2.9534762153685312,15.6299006795609,113,98.58860428646106,39.98954521693675,0.498170412963931
16063,"Lincoln County, Idaho",5292,2692,2600,19095,3205,255,106,8,10,5245,690,594,1284,630,302,328,2334,79,2.57,86.8,2.3431594860166287,11.904761904761905,124,99.11186696900982,44.10430839002267,0.5086923658352229
16065,"Madison County, Idaho",38114,19220,18894,15257,15798,3778,1334,259,445,37906,1723,1431,3154,12226,6062,6164,16240,129,3.61,82,5.347116545101538,32.07745185496143,2038,99.45426877262948,42.60901506008291,0.5042766437529517
16067,"Minidoka County, Idaho",20331,10251,10080,21887,12667,1334,412,117,22,20253,2491,2224,4715,3584,1499,2085,9117,56,2.24,87.4,2.7101470660567606,17.62825242240913,551,99.61634941714622,44.84285081894644,0.5042054006197433
16069,"Nez Perce County, Idaho",39995,19821,20174,26799,27701,4399,1237,347,166,39335,2568,2288,4856,5266,2569,2697,18105,83,4.49,85.7,4.375546943367921,13.166645830728841,1750,98.34979372421553,45.268158519814975,0.49558694836854605
16071,"Oneida County, Idaho",4269,2153,2116,21360,2667,327,94,5,10,4238,297,255,552,582,299,283,1623,0,4.18,85.9,2.553291168892012,13.633169360505974,109,99.27383462169126,38.01827125790583,0.5043335675802295
16073,"Owyhee County, Idaho",11356,5826,5530,19909,7353,595,87,15,14,11208,1643,1284,2927,2643,1360,1283,4396,88,1.86,86.6,1.021486438886932,23.27404015498415,116,98.6967241986615,38.71081366678408,0.513032758013385
16075,"Payette County, Idaho",22773,11394,11379,23361,14810,1692,324,193,138,22628,1962,1837,3799,4199,1998,2201,9338,135,2.87,90.2,2.876213059324639,18.438501734510165,655,99.36328107847012,41.004698546524395,0.5003293373732051
16077,"Power County, Idaho",7696,3932,3764,21513,4582,436,125,112,29,7627,441,666,1107,937,397,540,3019,0,3.56,85.5,3.456340956340956,12.175155925155925,266,99.10343035343035,39.228170478170476,0.510914760914761
16079,"Shoshone County, Idaho",12551,6287,6264,23834,9156,848,199,62,65,12365,894,998,1892,2208,1022,1186,5018,113,11.33,76.4,2.5974025974025974,17.59222372719305,326,98.51804637080711,39.980878017687836,0.500916261652458
16081,"Teton County, Idaho",10437,5375,5062,28004,6796,2046,501,99,70,10437,679,784,1463,1283,519,764,5428,2,5.87,78.6,6.419469196129156,12.29280444572195,670,100,52.007281785953815,0.5149947302864808
16083,"Twin Falls County, Idaho",80955,39915,41040,22723,51370,6333,1942,746,300,80017,6348,5643,11991,12417,5671,6746,36831,350,2.63,86.3,3.690939410783769,15.338150824532148,2988,98.84133160397752,45.495645729108766,0.49305169538632576
16085,"Valley County, Idaho",9897,5121,4776,28515,7445,1580,618,45,63,9816,988,660,1648,1369,728,641,4382,37,6.13,77.4,7.3355562291603515,13.832474487218349,726,99.18157017277963,44.27604324542791,0.5174295240982115
16087,"Washington County, Idaho",10035,4975,5060,20435,6974,717,322,37,0,9898,888,918,1806,1508,749,759,3670,55,3.43,86,3.5774788241155955,15.02740408570005,359,98.63477827603388,36.57199800697558,0.4957648231190832
17001,"Adams County, Illinois",66949,32663,34286,27256,46128,6879,2763,436,347,65675,2551,1907,4458,8457,3778,4679,31989,340,6.86,87.9,5.296569030157284,12.63200346532435,3546,98.0970589553242,47.78114684311939,0.48787883314164515
17003,"Alexander County, Illinois",7051,3462,3589,18564,4808,323,98,4,7,6865,466,379,845,2284,1028,1256,2247,31,7.86,89.2,1.5458800170188625,32.39256843000993,109,97.36207630123387,31.86782016735215,0.4909941852219543
17005,"Bond County, Illinois",17137,8736,8401,24473,11958,1378,640,58,108,15985,533,353,886,2553,1076,1477,7331,10,6.83,88.7,4.703273618486316,14.897590009920057,806,93.27770321526522,42.77878275077318,0.5097741728423878
17007,"Boone County, Illinois",53656,26951,26705,29029,34640,4542,2092,526,291,53332,2347,1983,4330,5908,2468,3440,24426,32,6.12,83.4,5.4215744744297005,11.010884150887133,2909,99.39615327270016,45.52333383032652,0.502292381094379
17009,"Brown County, Illinois",6836,4420,2416,21906,4979,543,134,31,4,5047,87,162,249,591,287,304,2617,11,6.5,87.6,2.472205968402575,8.645406670567583,169,73.82972498537156,38.28262141603277,0.6465769455822118
17011,"Bureau County, Illinois",33822,16657,17165,28332,23786,2921,1130,277,145,33446,1444,1107,2551,4340,1757,2583,15983,210,7.95,83.8,4.588729229495595,12.831884572171958,1552,98.88829755780262,47.256223759683046,0.49249009520430487
17013,"Calhoun County, Illinois",4962,2496,2466,25660,3570,329,187,9,12,4884,115,80,195,595,300,295,2113,38,7.35,89.2,4.191858121725111,11.991132607819427,208,98.42805320435308,42.583635630794035,0.5030229746070133
17015,"Carroll County, Illinois",14793,7366,7427,27605,10832,1167,458,93,54,14638,637,478,1115,1663,760,903,6765,47,6.92,83.6,4.0897721895491115,11.241803555735821,605,98.95220712499155,45.7310890285946,0.49793821402014465
17017,"Cass County, Illinois",13068,6638,6430,25451,8835,874,266,67,15,12918,764,532,1296,1787,792,995,6057,51,6.7,87.8,2.6629935720844813,13.674625038261402,348,98.85215794306703,46.349862258953166,0.5079583715947352
17019,"Champaign County, Illinois",206420,103115,103305,28463,118545,26688,15958,3262,6165,204456,8095,5624,13719,41161,19770,21391,102204,518,5.98,85.6,12.297742466815231,19.94041275070245,25385,99.04854180796434,49.51264412363143,0.49953977327778315
17021,"Christian County, Illinois",33888,17274,16614,25614,23974,2533,823,143,116,32123,1318,819,2137,4356,1724,2632,14900,69,7.68,87.4,3.1928706326723324,12.854107648725213,1082,94.79166666666667,43.96836638338055,0.5097379603399433
17023,"Clark County, Illinois",16089,7840,8249,28495,11175,1223,532,39,47,15855,607,661,1268,2576,1041,1535,7212,53,6.86,87.2,3.8411336938280813,16.010939150972714,618,98.54559015476413,44.825657281372365,0.4872894524209087
17025,"Clay County, Illinois",13466,6642,6824,25700,9366,1021,260,71,34,13298,577,483,1060,1854,794,1060,6199,25,7.43,87.5,2.710530224268528,13.768008317243428,365,98.75241348581613,46.03445715134413,0.4932422397148374
17027,"Clinton County, Illinois",37858,19639,18219,30382,26690,4041,1341,188,77,35862,1021,847,1868,3406,1449,1957,18495,140,7,89.4,4.242168101854298,8.996777431454381,1606,94.72766654339901,48.85361086164087,0.5187542923556447
17029,"Coles County, Illinois",52802,25466,27336,26060,32608,4674,2552,304,728,52114,2818,2022,4840,10711,4783,5928,24584,70,5.54,86.8,6.787621680996932,20.28521646907314,3584,98.69701905230862,46.55884246808833,0.4822923374114617
17031,"Cook County, Illinois",5227575,2535190,2692385,33722,3546688,775888,367264,99785,50581,5182720,363517,288591,652108,856682,380715,475967,2442256,20239,6.09,84.2,9.901914367560485,16.387751490892047,517630,99.1419539652707,46.718717569810096,0.48496482594702134
17033,"Crawford County, Illinois",19441,10046,9395,25955,13957,1569,623,153,53,17909,909,659,1568,2192,1109,1083,8104,52,7.63,87.7,4.264183941155291,11.275140167686848,829,92.11974692659842,41.68509850316342,0.516742965896816
17035,"Cumberland County, Illinois",10890,5473,5417,24956,7576,815,239,35,30,10761,382,287,669,1747,796,951,4741,28,6.67,86.8,2.7915518824609733,16.042240587695133,304,98.81542699724518,43.535353535353536,0.5025711662075298
17037,"DeKalb County, Illinois",104458,51767,52691,26511,60786,11394,5697,567,1080,103643,4359,4282,8641,18001,7713,10288,50416,350,5.73,82.9,7.030576882574815,17.232763407302457,7344,99.21978211338528,48.26437419824236,0.49557716977158284
17039,"De Witt County, Illinois",16322,8188,8134,27866,11591,1699,536,93,37,16081,811,303,1114,1926,832,1094,8007,38,7.34,86.1,4.08038230608994,11.800024506800638,666,98.5234652616101,49.056488175468694,0.5016542090430094
17041,"Douglas County, Illinois",19770,9743,10027,26284,13135,1927,469,62,52,19607,1485,1449,2934,2223,943,1280,9163,111,5.23,86.1,2.948912493677289,11.244309559939301,583,99.17551846231665,46.348002023267576,0.49281740010116337
17043,"DuPage County, Illinois",930514,456361,474153,42050,629381,180458,86866,19447,11002,924733,38364,31175,69539,64677,28159,36518,474127,2771,6.42,84.2,12.607548086326481,6.950674573407816,117315,99.37873046509779,50.953236598267196,0.4904396924710429
17045,"Edgar County, Illinois",17828,8730,9098,26344,12713,1553,677,48,14,17554,651,654,1305,2845,1269,1576,7504,15,6.17,85.9,4.145164909131703,15.958043527036123,739,98.46309176576172,42.091092663226384,0.4896791563832174
17047,"Edwards County, Illinois",6612,3270,3342,26549,4603,370,146,26,11,6580,340,135,475,760,349,411,3009,12,6.8,88.7,2.767695099818512,11.494252873563218,183,99.51603145795524,45.508166969147005,0.4945553539019964
17049,"Effingham County, Illinois",34356,17210,17146,29300,23212,3793,1120,220,85,33951,1236,1020,2256,3634,1755,1879,16966,119,7.28,86.8,4.147747118407265,10.57748282687158,1425,98.82116660845267,49.38293165677029,0.500931423914309
17051,"Fayette County, Illinois",22025,11670,10355,21844,15228,1442,519,88,17,20311,1422,948,2370,3240,1518,1722,8838,64,7.46,88.4,2.833144154370034,14.7105561861521,624,92.21793416572078,40.12712826333712,0.5298524404086266
17053,"Ford County, Illinois",13758,6783,6975,26611,9602,1203,422,21,23,13349,590,393,983,1871,798,1073,6128,28,8.46,85.6,3.387120220962349,13.599360372147114,466,97.02718418374764,44.54135775548772,0.49302224160488445
17055,"Franklin County, Illinois",39503,19434,20069,22346,27710,2805,1195,134,98,39035,2089,1769,3858,7440,3401,4039,15203,132,9.44,87.1,3.6123838695795256,18.834012606637472,1427,98.81527985216313,38.485684631546974,0.4919626357491836
17057,"Fulton County, Illinois",36047,18804,17243,24269,25866,2964,1012,182,93,33641,1668,1014,2682,5232,2296,2936,15067,73,7.51,86.6,3.570338724443088,14.514383998668405,1287,93.32538075290593,41.79820789524787,0.5216522872915915
17059,"Gallatin County, Illinois",5325,2512,2813,24538,3813,316,100,5,18,5325,204,161,365,860,364,496,2046,27,10.13,88.6,2.3098591549295775,16.150234741784036,123,100,38.42253521126761,0.47173708920187796
17061,"Greene County, Illinois",13390,6774,6616,22836,9435,787,190,51,25,13112,561,535,1096,2250,967,1283,5700,87,9.71,88.8,1.9865571321882,16.803584764749814,266,97.92382374906647,42.56908140403286,0.505899925317401
17063,"Grundy County, Illinois",50338,25173,25165,31914,33114,4774,2124,234,78,50076,1312,1436,2748,4899,2037,2862,23789,81,7.68,84.4,4.839286423775279,9.732210258651516,2436,99.47951845524256,47.258532321506614,0.5000794628312607
17065,"Hamilton County, Illinois",8251,4046,4205,25945,5798,567,289,28,28,8165,410,428,838,1219,583,636,3476,13,8.08,88.5,4.181311356199249,14.773966791904012,345,98.95770209671555,42.12822688159011,0.49036480426614953
17067,"Hancock County, Illinois",18633,9267,9366,26118,13424,1843,570,69,149,18471,613,522,1135,2124,920,1204,8330,65,6.45,86.9,4.229055975956636,11.39913057478667,788,99.13057478666882,44.705629796597435,0.4973434229592658
17069,"Hardin County, Illinois",4173,2126,2047,20025,3118,238,81,34,0,4117,294,121,415,774,326,448,1428,23,11.32,88.3,2.7558111670261205,18.547807332854063,115,98.6580397795351,34.21998562185478,0.5094656122693506
17071,"Henderson County, Illinois",6966,3417,3549,27949,5132,544,110,22,5,6901,264,240,504,731,289,442,3243,20,7.74,86.7,1.9666953775480907,10.493827160493828,137,99.06689635371806,46.55469422911283,0.4905254091300603
17073,"Henry County, Illinois",49681,24692,24989,28443,34409,5184,1637,394,104,48935,1713,1194,2907,6019,2642,3377,22935,178,8.65,84.7,4.2974175238018555,12.115295585837645,2135,98.49841991908376,46.1645296994827,0.49701092973168814
17075,"Iroquois County, Illinois",28814,14042,14772,26480,20276,1984,751,147,82,28362,1368,960,2328,4556,1990,2566,13195,185,7.95,85,3.401124453390713,15.811758173110293,980,98.43131810925244,45.79371139029638,0.48733254667869785
17077,"Jackson County, Illinois",59188,29683,29505,23455,35084,6172,4302,774,1349,58543,2847,1894,4741,15533,7665,7868,25296,196,8.52,87.9,10.855240927214975,26.24349530310198,6425,98.91025207812395,42.738392917483274,0.5015036831790228
17079,"Jasper County, Illinois",9592,4776,4816,25806,6696,866,289,40,28,9532,362,277,639,775,298,477,4591,6,8.22,86.3,3.7218515429524603,8.079649708090075,357,99.3744787322769,47.8628023352794,0.49791492910758967
17081,"Jefferson County, Illinois",38523,19712,18811,24617,26805,2718,1160,349,177,36240,1594,1430,3024,6392,2827,3565,15715,76,9.66,87.6,4.376606183319056,16.592684889546504,1686,94.0736702749007,40.79381148924019,0.5116943124886432
17083,"Jersey County, Illinois",22441,11007,11434,27528,15435,1824,826,101,86,22091,876,870,1746,1954,738,1216,9860,55,10.34,88.8,4.514059088275924,8.707276859319995,1013,98.44035470790072,43.93743594313979,0.49048616371819437
17085,"Jo Daviess County, Illinois",22186,11165,11021,32401,16281,2515,1168,163,78,22034,795,648,1443,2051,876,1175,10708,36,6.54,82.8,6.350851888578383,9.244568646894438,1409,99.31488325971333,48.264671414405484,0.5032452898224106
17087,"Johnson County, Illinois",12866,7322,5544,20726,9347,1056,392,62,48,10855,418,409,827,1363,607,756,4282,32,10.63,87.6,3.901756567697808,10.593813150940463,502,84.36965645888388,33.281517177055804,0.5690968443960827
17089,"Kane County, Illinois",526615,261893,264722,33486,336969,69910,30759,4628,2884,523379,32872,25810,58682,57312,25715,31597,253070,1555,6.58,83.7,7.2673585066889475,10.8830929616513,38271,99.38550933794139,48.055980175270356,0.4973139770040732
17091,"Kankakee County, Illinois",111493,54748,56745,26150,72888,8681,4183,612,342,109212,5696,3595,9291,16800,7826,8974,49015,865,10.06,84.1,4.6074641457311225,15.068210560304234,5137,97.9541316495206,43.96240122698286,0.4910442808068668
17093,"Kendall County, Illinois",121452,60053,61399,33369,76080,16580,8132,896,466,121167,3572,2341,5913,6578,2638,3940,61488,227,6.45,84.2,7.817079998682607,5.416131475809373,9494,99.76533939334058,50.62740835885782,0.4944587162006389
17095,"Knox County, Illinois",51752,26180,25572,23676,36060,4148,1777,358,233,49182,2509,1788,4297,8418,3906,4512,21138,163,7.57,85.5,4.575668573195239,16.266038027515844,2368,95.03400834750347,40.84479826866595,0.5058741691142371
17097,"Lake County, Illinois",702890,350890,352000,42388,452827,117263,58275,14766,7564,687451,34285,27919,62204,60664,28051,32613,348748,3069,4.37,83.6,11.467654967349088,8.630653445062528,80605,97.80349699099432,49.61629842507362,0.49921040276572437
17099,"LaSalle County, Illinois",111935,56200,55735,27959,77885,8744,3141,871,456,108968,4935,3724,8659,15069,6487,8582,49487,401,7.34,83.8,3.9916022691740745,13.462277214454817,4468,97.3493545361147,44.21047929602001,0.5020770983159869
17101,"Lawrence County, Illinois",16582,9285,7297,21072,12081,896,276,45,9,12092,393,657,1050,1929,671,1258,4710,33,7.78,87.8,1.9901097575684477,11.633096128331927,330,72.92244602581113,28.404293812567843,0.5599445181522132
17103,"Lee County, Illinois",34718,18344,16374,28179,24854,2724,1347,209,122,31873,1247,1022,2269,3783,1785,1998,15063,136,9.1,83.3,4.833227720490812,10.896364997983754,1678,91.8054035370701,43.38671582464428,0.5283714499683162
17105,"Livingston County, Illinois",37278,18946,18332,27318,26071,2519,1021,247,179,34252,1214,1028,2242,4364,1933,2431,15739,124,7.86,85.6,3.881646011052095,11.706636622136381,1447,91.882611728097,42.22061269381405,0.5082354203551692
17107,"Logan County, Illinois",29820,15158,14662,26479,20958,2757,848,142,104,24787,896,601,1497,2996,1316,1680,11563,33,7.16,86.6,3.6686787391012743,10.046948356807512,1094,83.12206572769954,38.775989268947015,0.508316566063045
17109,"McDonough County, Illinois",31727,15668,16059,22527,18326,3356,1849,154,788,31356,1195,1030,2225,6513,2853,3660,13630,66,6.49,86.6,8.796923755791598,20.528256689885588,2791,98.83064897405995,42.96025467267627,0.49383805591452073
17111,"McHenry County, Illinois",307083,152971,154112,36208,203847,45268,18090,2846,1568,305899,11312,9968,21280,23653,11290,12363,156611,904,4.99,84.2,7.328311889619419,7.702477831726276,22504,99.61443648785507,50.99956689233856,0.49814219608379495
17113,"McLean County, Illinois",173254,84335,88919,32943,104229,30959,11172,2018,2264,172070,5192,4095,9287,23485,10444,13041,90470,514,7.49,86.3,8.919851778313921,13.555242591801631,15454,99.31661029471181,52.21813060593118,0.4867708682050631
17115,"Macon County, Illinois",108404,51954,56450,28280,74063,10916,4426,970,579,105887,4633,3144,7777,19626,8420,11206,47649,300,5.8,86.4,5.511789232869636,18.104497989004095,5975,97.67812995830413,43.955020109959044,0.4792627578318143
17117,"Macoupin County, Illinois",46482,22939,23543,27255,32705,3933,1570,346,119,45959,2041,1322,3363,5875,2297,3578,20624,136,10.21,87.9,4.378038810722431,12.639301234886624,2035,98.87483326879222,44.369863603115185,0.4935028613226625
17119,"Madison County, Illinois",266759,130430,136329,30278,183772,30186,12865,2277,1836,264272,10409,7148,17557,34400,15291,19109,123390,704,8.53,89.4,6.364546275851986,12.895534921033592,16978,99.06769780963342,46.25523412518415,0.48894320341581726
17121,"Marion County, Illinois",38503,18824,19679,24112,26548,2604,1171,168,47,37798,1969,1401,3370,6867,3073,3794,16354,62,7.86,87.8,3.599719502376438,17.834973898137807,1386,98.16897384619381,42.47461236786744,0.4888969690673454
17123,"Marshall County, Illinois",12060,6008,6052,29025,8659,1080,246,35,36,11795,378,246,624,1163,434,729,5516,18,9.63,85.2,2.628524046434494,9.643449419568823,317,97.80265339966833,45.7379767827529,0.4981757877280265
17125,"Mason County, Illinois",13931,6921,7010,25952,9982,998,319,55,56,13737,501,450,951,2115,975,1140,5959,41,7.15,87.2,3.0866413035675833,15.181968272198693,430,98.60742229559975,42.77510587897495,0.49680568516258705
17127,"Massac County, Illinois",14883,7055,7828,23434,10547,1045,299,45,17,14658,594,536,1130,2750,1081,1669,5599,80,9.12,89.1,2.4255862393334677,18.477457501847745,361,98.48820802257609,37.62010347376201,0.4740307733655849
17129,"Menard County, Illinois",12576,6142,6434,32839,8816,1556,362,109,82,12415,311,245,556,1564,662,902,6038,15,7.92,87.3,4.397264631043257,12.436386768447838,553,98.71978371501272,48.01208651399491,0.4883905852417303
17131,"Mercer County, Illinois",15971,7917,8054,27844,11325,1391,496,61,37,15711,341,281,622,1618,657,961,7432,36,7.51,86.2,3.7192411245382258,10.130862187715234,594,98.37204933942772,46.53434349758938,0.49571097614426146
17133,"Monroe County, Illinois",33703,16535,17168,37043,23552,4636,1897,296,185,33422,888,529,1417,1480,537,943,17074,40,8.48,89.8,7.0557517134973144,4.3913004777022815,2378,99.16624632822004,50.66017861911403,0.4906091445865353
17135,"Montgomery County, Illinois",29301,15308,13993,23172,20959,1792,883,87,145,24357,622,810,1432,3725,1357,2368,9841,30,7.73,87.5,3.8053308760793145,12.712876693628203,1115,83.126855738712,33.585884440804065,0.5224395071840552
17137,"Morgan County, Illinois",34801,17511,17290,26253,24005,3124,1301,338,191,32924,1375,901,2276,4684,2185,2499,15578,57,9.05,88,5.258469584207351,13.45938335105313,1830,94.60647682537858,44.76308152064596,0.5031751961150541
17139,"Moultrie County, Illinois",14915,7246,7669,26166,10154,1185,421,86,40,14607,1018,874,1892,1769,939,830,6817,141,5.69,86.3,3.6674488769694937,11.86054307743882,547,97.93496480053638,45.70566543747905,0.48581964465303384
17141,"Ogle County, Illinois",52034,25934,26100,29239,35891,4736,1947,308,129,51553,1862,1684,3546,5617,2387,3230,24513,145,7.34,83.3,4.581619710189491,10.79486489602952,2384,99.07560441249952,47.10958219625629,0.4984048891109659
17143,"Peoria County, Illinois",186818,90575,96243,29683,124198,23140,10276,2346,1246,184557,7929,5883,13812,29991,13074,16917,84169,543,7.49,85.8,7.423267565223908,16.053592266269845,13868,98.78973118222012,45.05400978492437,0.48483015555246284
17145,"Perry County, Illinois",21595,11698,9897,23929,15253,1502,466,32,41,19287,711,450,1161,3102,1164,1938,8149,27,8.92,87.9,2.4959481361426255,14.364436212086131,539,89.31234081963417,37.73558694142162,0.5416994674693216
17147,"Piatt County, Illinois",16469,8145,8324,33672,11576,2223,1014,108,112,16418,360,345,705,927,379,548,8380,30,5.57,85.8,7.49286538344769,5.628757058716376,1234,99.69032728155929,50.88347804966907,0.4945655473920699
17149,"Pike County, Illinois",16054,7999,8055,23218,11188,1286,360,29,42,15528,810,639,1449,2233,1047,1186,6963,78,7.2,88.8,2.684689174037623,13.909306091939703,431,96.72355799177775,43.37236825713218,0.49825588638345586
17151,"Pope County, Illinois",4255,2247,2008,22191,3260,273,158,12,5,4071,150,108,258,604,233,371,1264,13,11.11,88,4.112808460634548,14.195064629847238,175,95.67567567567568,29.706227967097533,0.5280846063454759
17153,"Pulaski County, Illinois",5792,2839,2953,20195,4052,331,111,5,0,5784,253,182,435,1051,464,587,1886,5,9.18,89,2.0027624309392267,18.1457182320442,116,99.86187845303867,32.562154696132595,0.49015883977900554
17155,"Putnam County, Illinois",5746,2912,2834,33697,4188,403,148,41,11,5740,225,177,402,595,251,344,2903,19,8.62,84.4,3.4806822137138878,10.355029585798816,200,99.89557953358859,50.52210233205708,0.5067873303167421
17157,"Randolph County, Illinois",32934,18105,14829,24716,23979,2241,590,197,88,29283,997,957,1954,3219,1350,1869,13234,47,7.73,89.3,2.6568288091334185,9.774093641829113,875,88.91419202040444,40.183397097224756,0.5497358353069776
17159,"Richland County, Illinois",16072,7913,8159,25262,11168,1675,521,81,22,15864,561,508,1069,2311,998,1313,7142,49,7.85,87.5,3.8825286212045795,14.379044300647088,624,98.70582379293181,44.437531110004976,0.4923469387755102
17161,"Rock Island County, Illinois",146536,72130,74406,27822,100539,14642,5780,1025,713,144039,6443,5283,11726,21375,9195,12180,67155,1340,8.79,85.4,5.130479882076759,14.586859201834361,7518,98.29598187476115,45.828328874815746,0.49223399028225145
17163,"St. Clair County, Illinois",265569,128153,137416,28643,177512,28251,14818,2233,1108,259664,13985,9794,23779,46059,19546,26513,117738,1159,6.82,90,6.837770974774918,17.343515244625692,18159,97.77647240453517,44.33424081877026,0.4825600879620739
17165,"Saline County, Illinois",24659,12054,12605,22725,17189,1786,786,100,75,24132,1100,951,2051,5334,2348,2986,9427,41,10.27,87.7,3.8971572245427635,21.631047487732673,961,97.86284926396041,38.22944969382375,0.48882760858104546
17167,"Sangamon County, Illinois",198639,95430,103209,33277,136182,29382,12535,3414,1406,196527,6946,4793,11739,29600,13621,15979,94643,798,7.95,87.6,8.736954978629575,14.901404054591495,17355,98.9367646836724,47.64572918711834,0.4804192530167792
17169,"Schuyler County, Illinois",7205,3893,3312,23670,5383,672,227,44,74,7124,976,222,1198,1411,993,418,2955,15,7.05,87,4.788341429562804,19.58362248438584,345,98.87578070784177,41.013185287994446,0.5403192227619709
17171,"Scott County, Illinois",5169,2523,2646,26918,3638,314,93,26,7,5120,270,122,392,747,351,396,2291,3,8.42,88.6,2.4376088218224026,14.451538015089959,126,99.05204101373573,44.32191913329464,0.4881021474172954
17173,"Shelby County, Illinois",22011,10930,11081,24808,15620,1682,618,53,20,21820,907,543,1450,2810,1355,1455,10189,36,7.39,87,3.1393394211984917,12.766344100676934,691,99.13225205579029,46.29049111807733,0.49656989686974695
17175,"Stark County, Illinois",5840,2888,2952,30009,4180,494,165,28,12,5738,275,177,452,768,286,482,2503,6,7.42,84.6,3.51027397260274,13.150684931506849,205,98.25342465753425,42.85958904109589,0.4945205479452055
17177,"Stephenson County, Illinois",46283,22383,23900,25792,32576,3752,1557,357,153,45533,1812,1340,3152,7203,3195,4008,21204,152,5.84,83.2,4.466002635957047,15.56294967914785,2067,98.37953460233778,45.813797722705964,0.48361169327830955
17179,"Tazewell County, Illinois",135400,66832,68568,32082,94070,16650,5466,935,477,132943,3918,3320,7238,10485,4532,5953,64123,213,7.7,86.2,5.079763663220088,7.7437223042836045,6878,98.18537666174298,47.35819793205317,0.493589364844904
17181,"Union County, Illinois",17458,8803,8655,24646,12524,1603,823,155,86,17308,817,655,1472,2667,1340,1327,7311,31,9.7,88.1,6.094627105052125,15.276663993584602,1064,99.14079505097949,41.87764921525948,0.5042387444151678
17183,"Vermilion County, Illinois",79613,39531,40082,23416,53999,5297,1854,295,92,77191,4088,2514,6602,15093,6760,8333,31700,193,6.36,85.4,2.8148669187193045,18.957959127278208,2241,96.95778327660055,39.817617725748306,0.49653950987903983
17185,"Wabash County, Illinois",11587,5649,5938,25105,8034,1009,321,25,25,11509,444,431,875,1376,593,783,5184,35,6.34,88,3.2018641581082248,11.875377578320531,371,99.32683179425219,44.73979459739363,0.487529127470441
17187,"Warren County, Illinois",17611,8488,9123,24840,11556,1811,432,112,180,17419,554,514,1068,2533,992,1541,8026,37,7.39,85.9,4.111066946794617,14.38305604451763,724,98.90977230140253,45.573789109079556,0.48197149508829706
17189,"Washington County, Illinois",14369,7253,7116,29687,10257,1463,540,90,48,14162,450,367,817,1580,681,899,7045,42,9.31,88.6,4.718491196325423,10.995893938339481,678,98.55939870554667,49.029159997216226,0.5047672071821282
17191,"Wayne County, Illinois",16517,8183,8334,25046,11569,1178,350,62,27,16471,780,565,1345,2552,1157,1395,7339,45,7.56,88.9,2.657867651510565,15.450747714475995,439,99.72149906157293,44.433008415571834,0.49542895198885994
17193,"White County, Illinois",14410,7025,7385,26522,10266,929,392,50,38,14076,680,505,1185,1960,801,1159,5770,13,8.89,89.1,3.3310201249132545,13.601665510062457,480,97.6821651630812,40.04163775156142,0.4875086745315753
17195,"Whiteside County, Illinois",57155,28128,29027,28188,39744,4431,1953,374,105,56269,2344,1696,4040,6388,2930,3458,26207,403,9.48,84,4.25509579214417,11.17662496719447,2432,98.449829411250107,45.852506342402236,0.4921354212229901
17197,"Will County, Illinois",685378,340422,344956,33731,440254,94754,41877,6168,4486,678484,27827,21318,49145,51976,22124,29852,331755,3153,8,84.1,7.6645296464140955,7.5835524338394285,52531,98.99413170542387,48.4046759598353,0.496692336199878
17199,"Williamson County, Illinois",67336,33555,33781,26023,47275,6269,3142,584,441,65456,3175,2161,5336,9724,4249,5475,28467,194,10.05,86.8,6.188368777474159,14.441012237139123,4167,97.20803136509446,42.27604847332779,0.49832184863965784
17201,"Winnebago County, Illinois",288896,141203,147693,27297,194929,27796,12255,2433,1198,285739,14016,9965,23981,44086,19561,24525,129506,856,6.48,83,5.498864643331856,15.260162826761187,15886,98.90721920691183,44.82789654408507,0.4887675841825432
17203,"Woodford County, Illinois",39123,19428,19695,34198,25964,5630,1765,208,301,38567,955,759,1714,2942,1352,1590,18494,50,8.1,86.1,5.812437696495667,7.519873220356312,2274,98.57884109091839,47.27142601538737,0.4965876849934821
18001,"Adams County, Indiana",34813,17271,17542,21534,20942,2311,768,126,64,34366,3674,3695,7369,6140,2705,3435,14798,187,5.55,84.7,2.7518455749289057,17.637089592968145,958,98.71599689771062,42.50710941315026,0.4961077758308678
18003,"Allen County, Indiana",365565,178324,187241,26932,235198,42160,16367,4152,1694,361922,22629,21666,44295,54545,24399,30146,170281,923,4.75,84.7,6.0763475715673,14.920739129840111,22213,99.00346039691983,46.580225130961665,0.4878038105398493
18005,"Bartholomew County, Indiana",80203,40059,40144,29955,54155,9685,5255,499,632,79360,4357,4128,8485,9975,4523,5452,38947,457,9.01,85.9,7.962295674725384,12.437190628779472,6386,98.94891712280089,48.56052766106006,0.499470094634864
18007,"Benton County, Indiana",8709,4341,4368,23652,5832,753,188,42,12,8624,679,461,1140,1096,436,660,4042,28,6.52,84.2,2.7787346423240327,12.584682512343553,242,99.02399816282008,46.41175795154438,0.4984498794350672
18009,"Blackford County, Indiana",12364,6135,6229,22328,8700,546,315,51,42,12199,809,824,1633,1447,569,878,5180,44,6.58,84.6,3.299902944031058,11.70333225493368,408,98.66548042704626,41.89582659333549,0.4961986412164348
18011,"Boone County, Indiana",61884,30594,31290,42844,40735,10613,4608,1828,1084,61268,2444,2032,4476,3719,1779,1940,30909,232,5.99,83.7,12.151767823670092,6.009630922370888,7520,99.00458923146532,49.94667442311422,0.49437657552840797
18013,"Brown County, Indiana",14965,7470,7495,31365,11025,1238,1076,169,105,14833,996,740,1736,1882,851,1031,6853,8,9.04,85,9.021049114600736,12.576010691613766,1350,99.11794186435014,45.7935182091547,0.499164717674574
18015,"Carroll County, Indiana",20007,9959,10048,26589,13841,1595,624,146,47,19894,1267,1088,2355,2139,1017,1122,9217,81,6.72,84.6,4.083570750237417,10.691258059679113,817,99.43519768081171,46.068875893437294,0.49777577847753285
18017,"Cass County, Indiana",38324,19227,19097,23592,25871,2335,987,152,135,37636,2550,2101,4651,5640,2608,3032,17165,222,6.56,84.6,3.324287652645862,14.716626656925165,1274,98.20478029433254,44.789166057822776,0.501696065128901
18019,"Clark County, Indiana",113993,55492,58501,26875,78451,11116,3558,670,502,112420,7312,5967,13279,11153,5181,5972,54322,351,6.99,87.5,4.149377593360996,9.783934101216742,4730,98.62009070732414,47.65380330371163,0.48680182116445747
18021,"Clay County, Indiana",26568,12983,13585,24339,18248,2007,814,201,67,26194,1383,1244,2627,4358,1907,2451,11862,48,6.65,86.3,4.072568503462812,16.403191809695876,1082,98.59229147847034,44.64769647696477,0.48867058115025597
18023,"Clinton County, Indiana",32692,16148,16544,23722,21431,2170,887,94,40,32067,1893,2015,3908,4052,1707,2345,14869,139,5.88,84,3.1230882173008685,12.394469595007953,1021,98.08821730086872,45.48207512541295,0.4939434724091521
18025,"Crawford County, Indiana",10582,5358,5224,19424,7413,437,221,57,11,10518,446,428,874,2034,925,1109,4281,44,6.62,86.8,2.731052731052731,19.22131922131922,289,99.3951993951994,40.455490455490455,0.5063315063315064
18027,"Daviess County, Indiana",32583,16423,16160,21794,20085,1721,892,148,52,32117,3595,3648,7243,4329,2022,2307,14303,254,8,86.9,3.3514409354571404,13.286069422705092,1092,98.56980634072983,43.89712426725593,0.5040358469140349
18029,"Dearborn County, Indiana",49552,24770,24782,30228,34006,4561,1816,352,60,49011,2115,2011,4126,4537,2075,2462,24371,181,6.41,86.6,4.49628672909267,9.15603810138844,2228,98.90821762996448,49.1826767839845,0.4998789150791088
18031,"Decatur County, Indiana",26340,13033,13307,25548,17691,2106,858,196,56,26018,1430,1477,2907,3375,1436,1939,12691,73,7.36,84.2,4.214123006833713,12.813211845102506,1110,98.77752467729688,48.181473044798786,0.4947987851176917
18033,"DeKalb County, Indiana",42489,21142,21347,26057,28274,3272,1403,159,77,42126,2384,2403,4787,5387,2342,3045,19992,137,4.38,84,3.857468991974393,12.678575631339877,1639,99.1456612299654,47.05217821083104,0.49758761091105935
18035,"Delaware County, Indiana",116463,56004,60459,23271,71040,9560,5104,750,1128,115036,7259,5590,12849,23995,10499,13496,50781,352,8.42,84.8,5.995037050393687,20.60311000060105,6982,98.77471815082902,43.60268926611885,0.48087375389608716
18037,"Dubois County, Indiana",42345,21183,21162,28302,28562,4004,1362,163,106,41552,1486,1316,2802,3545,1560,1985,21761,28,6.84,87.1,3.8516944149250207,8.371708584248436,1631,98.12728775534302,51.389774471602315,0.5002479631597592
18039,"Elkhart County, Indiana",201640,99741,101899,23817,127176,15497,6018,1241,478,199208,18439,18225,36664,29381,12529,16852,91204,520,6.36,84.4,3.837036302320968,14.571017655227138,7737,98.7938901011704,45.231104939496134,0.49464887919063677
18041,"Fayette County, Indiana",23608,11644,11964,22428,16435,1208,409,118,20,23279,1621,1781,3402,4472,1856,2616,9377,71,6.67,85.3,2.3170111826499493,18.94273127753304,547,98.60640460860725,39.719586580820064,0.4932226363944426
18043,"Floyd County, Indiana",76290,36917,39373,30663,51839,8938,3930,670,421,75281,3616,3175,6791,9050,3987,5063,36992,147,6.33,87.3,6.581465460741906,11.862629440293617,5021,98.67741512649103,48.48866168567309,0.4839035260191375
18045,"Fountain County, Indiana",16741,8409,8332,25383,11569,1067,511,73,22,16552,981,571,1552,2081,949,1132,7264,47,6.31,84.5,3.6198554447165643,12.430559703721402,606,98.87103518308345,43.39047846604146,0.5022997431455708
18047,"Franklin County, Indiana",22887,11456,11431,26267,15517,1931,785,76,179,22801,1010,894,1904,2591,1151,1440,10766,107,6.8,85.7,4.544064315987241,11.320837156464368,1040,99.62424083540874,47.039804255691,0.5005461615764408
18049,"Fulton County, Indiana",20412,10089,10323,23557,14009,1291,583,39,9,20191,1276,1189,2465,2828,1307,1521,9094,134,5.89,84.3,3.0913188320595726,13.854595336076818,631,98.91730354693318,44.55222418185381,0.49426807760141095
18051,"Gibson County, Indiana",33684,16846,16838,27342,22845,2429,969,70,103,33102,1816,1509,3325,3610,1549,2061,15807,119,7.52,87.6,3.39033368958556,10.717254482840518,1142,98.27217670110439,46.92732454577841,0.5001187507421921
18053,"Grant County, Indiana",68269,32725,35544,21024,44699,4580,2250,298,348,67374,4020,3848,7868,12183,5179,7004,28843,154,7.15,85,4.2420425083127045,17.845581449852787,2896,98.68900965299038,42.24904422212131,0.4793537330267032
18055,"Greene County, Indiana",32633,16217,16416,24744,22771,2079,954,191,43,32346,2228,1710,3938,4810,1903,2907,13974,140,7.09,86.2,3.6404866239696014,14.739680691324732,1188,99.12052217080868,42.82168357184445,0.4969509392332915
18057,"Hamilton County, Indiana",303042,148054,154988,44443,195132,69838,26730,8368,4886,301604,9596,8589,18185,15381,6332,9049,157155,811,7.77,84,13.194210703466846,5.075534084384342,39984,99.52547831653698,51.859148236878056,0.4885593416094139
18059,"Hancock County, Indiana",71955,35160,36795,31428,48651,9387,3791,690,232,71323,3138,3022,6160,5274,2252,3022,35448,124,7.4,84.4,6.549927037731916,7.3295809881175735,4713,99.12167326801473,49.264123410464876,0.48863873254117157
18061,"Harrison County, Indiana",39370,19678,19692,25993,27457,2930,1532,144,35,39133,1864,1506,3370,5139,2275,2864,17885,93,6.76,87.2,4.345948691897384,13.053086106172213,1711,99.39801879603759,45.42799085598171,0.4998221996443993
18063,"Hendricks County, Indiana",155817,77782,78035,33031,102640,24094,9223,1387,903,153217,6130,5351,11481,7834,3015,4819,78171,441,6.34,84.2,7.388795831006886,5.027692742126982,11513,98.3313759089188,50.16846685534954,0.4991881502018393
18065,"Henry County, Indiana",48953,25487,23466,23293,34597,3645,1393,227,178,45714,3038,2543,5581,7349,3457,3892,19513,152,6.7,84.6,3.6729107511286334,15.012358793128103,1798,93.38344943108696,39.860682695646844,0.5206422486875166
18067,"Howard County, Indiana",82728,40000,42728,26294,57226,7218,3142,636,191,81791,4216,4501,8717,13665,6198,7467,35578,467,5.09,84.2,4.797650130548303,16.517986655062373,3969,98.86737259452664,43.005995551687455,0.48351223285949135
18069,"Huntington County, Indiana",36696,18039,18657,24222,24876,2867,1456,166,204,36221,2027,1765,3792,4227,1774,2453,17815,62,6.2,83.9,4.976019184652278,11.518966644865925,1826,98.70558098975366,48.54752561587094,0.49157946370176586
18071,"Jackson County, Indiana",43637,21674,21963,23260,29563,3157,1331,215,77,42995,2459,2291,4750,6317,2447,3870,20027,436,8.2,86.4,3.719320759905585,14.476247221394688,1623,98.52877145541628,45.894539037972365,0.4966885899580631
18073,"Jasper County, Indiana",33461,16556,16905,24953,22198,2339,1018,242,73,33097,1359,1527,2886,2488,1097,1391,14857,77,10.04,84,3.9837422671169422,7.435521950927946,1333,98.91216640267774,44.40094438301306,0.4947849735512985
18075,"Jay County, Indiana",21196,10402,10794,20193,13930,965,452,38,62,20985,1378,1157,2535,3317,1528,1789,9406,176,6.46,84.6,2.6042649556520097,15.649179090394414,552,99.00452915644462,44.376297414606526,0.4907529722589168
18077,"Jefferson County, Indiana",32482,15443,17039,25429,21973,2201,1237,143,164,30920,1573,1768,3341,4344,1873,2471,14101,121,6.42,86.9,4.753401884120436,13.373560741333662,1544,95.19118280894034,43.41173573055846,0.4754325472569423
18079,"Jennings County, Indiana",28023,14126,13897,22901,18740,1247,510,18,31,27779,1625,1536,3161,4217,2148,2069,12782,183,7.16,86.1,1.9947899939335545,15.04835313849338,559,99.12928665738858,45.612532562537915,0.5040859294151233
18081,"Johnson County, Indiana",147567,72527,75040,31101,97494,19304,7434,1170,854,145471,6906,6574,13480,13473,6197,7276,72131,411,7.27,84.4,6.40929205039067,9.130090060785948,9458,98.57962823666539,48.88016968563432,0.49148522366111663
18083,"Knox County, Indiana",37956,19294,18662,23441,24770,2486,1095,117,76,37168,2048,2064,4112,4980,2358,2622,18053,196,7.83,87.7,3.39340288755401,13.120455263989882,1288,97.92391189798714,47.56296764674887,0.5083254294446201
18085,"Kosciusko County, Indiana",78461,38893,39568,27884,51671,7043,3205,404,315,77740,4957,4701,9658,8423,3534,4889,37124,261,5.11,84.5,5.001210792623087,10.735269751851238,3924,99.08107212500478,47.31522667312423,0.4956984998916659
18087,"LaGrange County, Indiana",38395,19459,18936,22780,21954,1649,726,46,37,38218,7717,7678,15395,4728,2206,2522,15864,423,5.61,83.9,2.107045188175544,12.314103398880063,809,99.53900247428051,41.31787993228285,0.5068107826539914
18089,"Lake County, Indiana",489698,236906,252792,26590,325433,45298,17643,3398,1637,486138,30658,26744,57402,84905,36881,48024,209791,2322,8.17,83.8,4.631017484245392,17.338237035887424,22678,99.27302133151453,42.840893775347254,0.4837797989781457
18091,"LaPorte County, Indiana",110993,57380,53613,25004,77055,8840,3474,797,441,102325,5315,5425,10740,17621,7190,10431,46551,408,10.6,83.5,4.245312767471822,15.875775949834674,4712,92.1904984999054,41.94048273314533,0.5169695386195526
18093,"Lawrence County, Indiana",45696,22624,23072,25036,31959,2972,1291,184,137,45047,2738,2717,5455,5771,2591,3180,20383,93,7.36,85.6,3.52766106442577,12.629114145658264,1612,98.5797443977591,44.60565476190476,0.4950980392156863
18095,"Madison County, Indiana",129862,64976,64886,23680,89705,10451,3966,684,501,124899,7955,6648,14603,20618,9519,11099,54723,643,7.3,84.6,3.966518304045833,15.87685389105358,5151,96.17825075849748,42.13934792317999,0.5003465216922579
18097,"Marion County, Indiana",932142,448928,483214,26284,608059,115366,42539,12050,6510,922012,69929,57858,127787,187586,84445,103141,437920,3444,7.68,84.3,6.554688019636493,20.1241870873751,61099,98.91325570567574,46.97996657161677,0.48160902523435273
18099,"Marshall County, Indiana",46833,23262,23571,24289,30894,3677,1549,396,103,46339,3351,3636,6987,5351,2194,3157,20641,172,7.3,84.3,4.372984861102214,11.42570409753806,2048,98.94518822198023,44.07362329980996,0.49670104413554544
18101,"Martin County, Indiana",10218,5114,5104,25138,7129,459,286,31,35,10108,572,554,1126,1228,514,714,4732,58,7.26,86.4,3.444901154824819,12.018007437854767,352,98.92346838911725,46.31043256997455,0.5004893325504013
18103,"Miami County, Indiana",36093,19190,16903,22890,24750,1856,900,122,76,33875,1928,1473,3401,5416,2376,3040,14482,186,5.56,84.8,3.042141135400216,15.005679771700883,1098,93.85476408167789,40.124123791316876,0.5316820436095642
18105,"Monroe County, Indiana",143292,71286,72006,26738,80706,18497,12266,1899,3772,142313,7571,6377,13948,32044,15293,16751,69028,281,7.85,85.2,12.517795829495018,22.362727856405105,17937,99.31677972252463,48.172961505178236,0.49748764760070346
18107,"Montgomery County, Indiana",38108,19274,18834,25519,25564,2895,989,250,148,37584,2456,1948,4404,4635,1971,2664,17584,44,5.56,84,3.639655715335363,12.162800461845281,1387,98.62496063818621,46.14254224834681,0.5057730660228823
18109,"Morgan County, Indiana",69504,34395,35109,27402,47385,4957,1941,347,114,68702,3549,3319,6868,8547,3395,5152,32738,187,6.46,84.8,3.4559162062615103,12.297133977900552,2402,98.84610957642725,47.10232504604051,0.4948636049723757
18111,"Newton County, Indiana",14022,7075,6947,24315,9835,717,247,45,28,13813,908,863,1771,1833,788,1045,6212,177,8.38,84.4,2.2821280844387393,13.072314933675653,320,98.50948509485094,44.301811439167025,0.5045642561688775
18113,"Noble County, Indiana",47587,23839,23748,25260,31373,3078,1068,196,96,46783,2836,2700,5536,5320,2338,2982,21828,173,4.76,83.8,2.85792338243638,11.179523819530544,1360,98.31046294155966,45.8696702881039,0.5009561434845651
18115,"Ohio County, Indiana",6003,3003,3000,27715,4384,382,161,45,19,5950,258,245,503,397,173,224,2851,30,5.96,87.2,3.7481259370314843,6.61335998667333,225,99.11710811261037,47.49292020656338,0.5002498750624688
18117,"Orange County, Indiana",19579,9696,9883,22715,13354,946,523,92,29,19329,1116,1003,2119,3154,1342,1812,8371,131,6.2,86.3,3.2892384697890598,16.109096480923437,644,98.7231217120384,42.75499259410593,0.49522447520302365
18119,"Owen County, Indiana",21038,10665,10373,24220,14930,975,660,123,35,20879,1562,1096,2658,3074,1426,1648,9256,93,7.17,86,3.888202300598916,14.611655100294705,818,99.24422473619165,43.9965776214469,0.5069398231771081
18121,"Parke County, Indiana",17033,8089,8944,21636,12024,981,382,36,18,15542,1296,1008,2304,2312,1026,1286,6621,54,6.64,85.2,2.55973698115423,13.573651147771972,436,91.24640403921799,38.871602183995776,0.4749016614806552
18123,"Perry County, Indiana",19301,10316,8985,23003,13593,940,739,100,46,17585,807,789,1596,2561,1086,1475,8142,27,7.74,87,4.5852546500181335,13.268742552199368,885,91.10926894979535,42.18434278016683,0.5344800787523962
18125,"Pike County, Indiana",12554,6277,6277,25648,8810,737,356,14,4,12331,498,539,1037,1244,573,671,5840,36,7.34,87.4,2.9791301577186555,9.90919228931018,374,98.22367372948861,46.519037756890235,0.5
18127,"Porter County, Indiana",167016,82416,84600,31879,113063,18661,7724,1760,1394,165535,7321,7109,14430,17560,7403,10157,77010,489,9.97,83.5,6.5131484408679405,10.513962734109306,10878,99.11325860995353,46.10935479235523,0.4934617042678546
18129,"Posey County, Indiana",25527,12774,12753,30763,17683,2438,902,200,96,25289,725,667,1392,2451,1184,1267,12134,50,8,88.5,4.693070082657578,9.601598307674227,1198,99.06765385670074,47.53398362518118,0.5004113291808673
18131,"Pulaski County, Indiana",12910,6544,6366,24445,8932,650,240,51,12,12767,755,636,1391,1710,680,1030,5726,107,10.01,84.4,2.3470178156467854,13.245546088303641,303,98.89233152594888,44.353214562354765,0.5068938807126259
18133,"Putnam County, Indiana",37626,19799,17827,23842,24863,2129,971,223,415,34380,1958,1574,3532,3298,1248,2050,15739,31,6.08,84.8,4.276298304364004,8.765215542444055,1609,91.37298676447138,41.830117471960875,0.5262052835805029
18135,"Randolph County, Indiana",25403,12346,13057,23427,17429,1320,825,64,69,25042,1816,1655,3471,4319,1714,2605,11142,88,7.13,84.4,3.7712081250246032,17.00192890603472,958,98.57890800299177,43.860961303783014,0.48600558989095777
18137,"Ripley County, Indiana",28633,14138,14495,25385,19437,2300,903,118,69,28165,1304,980,2284,2834,1215,1619,13162,219,6.48,85.1,3.8067963538574374,9.897670520029337,1090,98.36552229944469,45.96793909125834,0.49376593441134353
18139,"Rush County, Indiana",16873,8272,8601,23749,11605,1050,455,93,30,16686,1368,1044,2412,2981,1255,1726,7576,10,7.06,84.7,3.4255911811770283,17.667279084928584,578,98.89172050020743,44.90013631245185,0.49025069637883006
18141,"St. Joseph County, Indiana",267696,129850,137846,25893,173405,29937,13005,2851,3186,265189,15886,13801,29687,43926,19386,24540,121364,530,10.18,83.8,7.113292690215767,16.408911601219295,19042,99.06348992887455,45.33650110573188,0.485065148526687
18143,"Scott County, Indiana",23734,11672,12062,24186,16315,1346,596,106,71,23357,1226,935,2161,3267,1547,1720,10360,120,6.65,86.9,3.2569309850846886,13.765062779135418,773,98.41156147299233,43.65045925676245,0.49178393865340864
18145,"Shelby County, Indiana",44404,21912,22492,27317,30570,3210,1470,255,150,43707,2918,2455,5373,5446,2419,3027,21112,272,7.37,84.7,4.222592559228898,12.264660841365643,1875,98.4303215926493,47.545266192234934,0.493469056841726
18147,"Spencer County, Indiana",20777,10530,10247,29114,14473,1435,619,91,73,20559,909,810,1719,2013,821,1192,9698,99,8.48,87.7,3.7685902680849015,9.688597968907928,783,98.95076286278096,46.676613563074554,0.506810415363142
18149,"Starke County, Indiana",23069,11361,11708,22153,15848,1282,430,74,54,23062,1097,1090,2187,3596,1529,2067,9395,71,10.68,84.3,2.41883046512636,15.588018553036543,558,99.96965624864536,40.72564913953791,0.4924790844856734
18151,"Steuben County, Indiana",34279,17401,16878,26902,23294,3027,1234,206,179,34016,1943,1918,3861,3407,1469,1938,16288,126,4.5,83.3,4.723008255783424,9.939029726654804,1619,99.23276641675662,47.515971877826075,0.5076285772630473
18153,"Sullivan County, Indiana",21026,11324,9702,22239,14929,1383,423,76,8,18919,1433,1170,2603,3265,1209,2056,8246,13,5.94,87.5,2.4113002948730142,15.528393417673357,507,89.97907352801293,39.21811091030153,0.5385712926852468
18155,"Switzerland County, Indiana",10484,5434,5050,21511,7070,421,131,16,17,10378,819,659,1478,2221,1098,1123,4353,58,5.79,87.4,1.5642884395268981,21.184662342617322,164,98.98893552079359,41.520412056466995,0.5183136207554369
18157,"Tippecanoe County, Indiana",183397,93774,89623,25481,100694,19941,10031,1590,3960,181721,10734,8930,19664,36513,18142,18371,86140,658,5.77,84.3,8.49577692110558,19.909267872429755,15581,99.08613554202086,46.96914344291346,0.5113169790127429
18159,"Tipton County, Indiana",15447,7611,7836,28507,10926,1462,774,46,19,15266,683,790,1473,1328,543,785,7193,74,5.24,84.2,5.431475367385253,8.597138602964977,839,98.82825144040915,46.56567618307762,0.49271703243348225
18161,"Union County, Indiana",7251,3652,3599,22527,4974,576,250,40,57,7191,451,391,842,681,298,383,3304,8,6.29,85.6,4.78554682112812,9.391808026479106,347,99.17252792718246,45.56612880981933,0.5036546683216108
18163,"Vanderburgh County, Indiana",181692,87909,93783,26917,122490,19679,8284,1474,1066,179266,10546,8567,19113,29710,12722,16988,85806,507,8.18,88,5.957334390066706,16.35184818263875,10824,98.66477335270677,47.22607489597781,0.4838352816854897
18165,"Vermillion County, Indiana",15752,7742,8010,23891,11030,1043,318,41,30,15538,786,831,1617,2077,916,1161,6376,34,6.61,85.5,2.469527679024886,13.185627221940072,389,98.64144235652616,40.47739969527679,0.4914931437277806
18167,"Vigo County, Indiana",108099,54944,53155,22932,69166,9840,4523,757,910,103879,6385,5807,12192,20053,9234,10819,46367,426,6.37,86.5,5.726232435082656,18.550587887029483,6190,96.09617110241538,42.893088742726576,0.5082748221537664
18169,"Wabash County, Indiana",32177,15775,16402,24700,21971,2433,1274,144,169,31199,1635,1462,3097,3839,1585,2254,14604,45,6.42,84.7,4.932094353109364,11.93088230723809,1587,96.96056189203469,45.38645616434099,0.4902570158809087
18171,"Warren County, Indiana",8309,4119,4190,29312,5913,801,251,47,58,8222,249,260,509,639,233,406,3921,26,5.96,84.6,4.284510771452641,7.690456131905163,356,98.95294259236972,47.18979419906126,0.4957275243711638
18173,"Warrick County, Indiana",61427,30350,31077,33528,41847,7431,3066,800,420,60683,2493,1988,4481,5757,2331,3426,29449,259,8.78,88.1,6.977387793641233,9.372100216517167,4286,98.78880622527554,47.941458967554986,0.4940824067592427
18175,"Washington County, Indiana",27792,13783,14009,23223,18966,1399,865,76,70,27523,1840,1371,3211,4100,1843,2257,11708,69,6.01,86,3.6377374784110534,14.7524467472654,1011,99.03209556706966,42.127230857800804,0.4959340817501439
18177,"Wayne County, Indiana",67423,32580,34843,23895,46204,4611,2511,387,408,66244,5036,4857,9893,12903,5509,7394,28237,343,6.31,85,4.903371253133204,19.137386351838394,3306,98.25133856399151,41.880367233733296,0.4832178930038711
18179,"Wells County, Indiana",27836,13760,14076,25850,18735,2219,804,168,68,27243,1197,1238,2435,3421,1436,1985,13392,96,5.07,84.2,3.7361689897973847,12.289840494323897,1040,97.86966518177898,48.110360684006324,0.494323897111654
18181,"White County, Indiana",24265,12061,12204,26275,16749,1730,788,84,25,24026,1192,1156,2348,2376,1050,1326,11143,91,7.92,84.4,3.6966824644549763,9.79188131052957,897,99.01504224191221,45.92211003502988,0.49705336905007214
18183,"Whitley County, Indiana",33354,16660,16694,28073,22932,2628,1258,240,68,32979,1432,1354,2786,2876,1216,1660,16291,110,5.66,83.6,4.695089044792229,8.62265395454818,1566,98.87569706781795,48.84271751514061,0.49949031600407745
19001,"Adair County, Iowa",7330,3612,3718,28861,5275,691,124,40,19,7193,262,190,452,687,255,432,3659,19,7.88,86.1,2.4965893587994543,9.37244201909959,183,98.13096862210095,49.918144611186904,0.4927694406548431
19003,"Adams County, Iowa",3822,1890,1932,27022,2748,326,108,19,6,3752,144,146,290,368,148,220,1904,14,7.95,86.2,3.47985347985348,9.628466771323914,133,98.168498168498175,49.81684981684982,0.4945054945054945
19005,"Allamakee County, Iowa",14001,7106,6895,27377,9854,1205,319,105,49,13693,578,578,1156,1388,527,861,6815,101,11.75,81,3.3783301192771944,9.913577601599886,473,97.80015713163345,48.67509463609742,0.5075351760588529
19007,"Appanoose County, Iowa",12602,6265,6337,25543,8950,1215,276,93,38,12478,614,562,1176,1998,963,1035,5565,22,7.04,86.4,3.229646087922552,15.854626249801619,407,99.01602920171402,44.15965719727028,0.49714331058562133
19009,"Audubon County, Iowa",5793,2843,2950,31523,4208,377,110,39,27,5648,225,139,364,651,220,431,2901,8,7.2,85.8,3.038149490764716,11.237700673226307,176,97.49697911272226,50.07767995857069,0.4907647160365959
19011,"Benton County, Iowa",25720,12853,12867,32356,17432,2807,794,157,34,25479,439,408,847,2324,1083,1241,12953,126,8.1,84,3.8297045101088645,9.035769828926906,985,99.06298600311042,50.36158631415241,0.49972783825816486
19013,"Black Hawk County, Iowa",132821,65049,67772,27669,83290,14843,5148,1208,1274,131568,4638,4059,8697,19605,8640,10965,66637,517,8.41,83.1,5.744573523765068,14.760467094811814,7630,99.05662508187712,50.17053026253379,0.48974936192318985
19015,"Boone County, Iowa",26411,13295,13116,30190,18380,2846,872,192,215,25794,999,610,1609,2659,1104,1555,13443,32,7.31,85.9,4.842679186702511,10.06777479080686,1279,97.66385218280261,50.89924652606869,0.503388739540343
19017,"Bremer County, Iowa",24663,12171,12492,32105,16174,3254,938,157,156,24320,530,293,823,1677,665,1012,12782,45,10.42,82.6,5.072375623403479,6.799659408831042,1251,98.60925272675668,51.82662287637351,0.49349227587884686
19019,"Buchanan County, Iowa",21031,10453,10578,30974,13951,1957,440,104,10,20773,897,751,1648,1905,852,1053,10119,191,8.42,82.3,2.6342066473301315,9.058057153725454,554,98.77323950358993,48.11468784175741,0.49702819647187485
19021,"Buena Vista County, Iowa",20445,10363,10082,26345,12846,1653,442,156,151,20177,1393,1021,2414,2575,1135,1440,10423,40,7.11,84.6,3.6634874052335533,12.594766446563952,749,98.68916605527023,50.98067987282954,0.5068720958669601
19023,"Butler County, Iowa",14933,7469,7464,28584,10504,1159,399,55,33,14675,349,378,727,1289,552,737,7352,13,9.4,82.9,3.2612335096765555,8.631889104667515,487,98.27228286345678,49.23324181343334,0.5001674144512154
19025,"Calhoun County, Iowa",9876,5101,4775,27370,7053,892,267,93,44,9214,252,214,466,1364,597,767,4341,67,6.5,85.4,4.090724989874443,13.81125961927906,404,93.29688132847306,43.955042527339,0.5165046577561766
19027,"Carroll County, Iowa",20555,10009,10546,29191,14015,2220,428,164,191,20204,319,338,657,1899,662,1237,10535,45,6.09,86.3,3.8092921430308926,9.238628071028947,783,98.29238628071029,51.25273656044758,0.4869374847968864
19029,"Cass County, Iowa",13433,6633,6800,26427,9470,1404,333,96,45,13173,458,240,698,1985,919,1066,6538,28,7.41,86.4,3.528623539045634,14.777041613935829,474,98.06446810094543,48.67118290776446,0.4937839648626517
19031,"Cedar County, Iowa",18389,9038,9351,30362,12886,2119,495,108,119,18164,350,303,653,1162,450,712,9741,79,8.38,84.2,3.9262602642884334,6.318995051389417,722,98.77644243841426,52.97188536625156,0.49148947740497034
19033,"Cerro Gordo County, Iowa",43303,21146,22157,31292,30829,4883,1299,377,180,42658,1542,1316,2858,5422,2069,3353,21882,139,10.39,82.2,4.286077177100894,12.521072443017804,1856,98.51049580860449,50.53229568390181,0.48832644389534213
19035,"Cherokee County, Iowa",11752,5865,5887,30973,8412,1247,232,87,46,11397,536,398,934,1321,594,727,5965,39,6.31,85.2,3.105854322668482,11.240639891082369,365,96.9792375765827,50.757317903335604,0.4990639891082369
19037,"Chickasaw County, Iowa",12164,6124,6040,27973,8356,884,268,41,17,12034,371,321,692,1073,513,560,6053,19,11.98,81.1,2.680039460703716,8.821111476487998,326,98.93127260769484,49.76159158171654,0.5034528115751398
19039,"Clarke County, Iowa",9273,4585,4688,25879,6210,730,182,44,0,9137,535,508,1043,1454,657,797,4607,19,6.48,86.5,2.4371832201013697,15.679930982422086,226,98.53337646931953,49.68187210180093,0.49444624177720264
19041,"Clay County, Iowa",16478,8093,8385,28514,11488,1877,370,102,48,16224,480,444,924,1907,798,1109,8351,74,7.33,83.8,3.155722781891006,11.573006432819517,520,98.4585507949994,50.679694137638066,0.49113970142007524
19043,"Clayton County, Iowa",17735,8875,8860,27719,12594,1402,396,93,37,17505,672,657,1329,1841,825,1016,8792,66,7.85,80.9,2.9658866647871442,10.380603326755004,526,98.7031294051311,49.57428813081477,0.5004228925852834
19045,"Clinton County, Iowa",47972,23508,24464,28091,33105,4476,1473,259,204,47495,1321,1103,2424,6405,2724,3681,22306,149,8.22,84,4.03568748436588,13.351538397398482,1936,99.00566997415159,46.49795714166597,0.49003585424831153
19047,"Crawford County, Iowa",17147,8720,8427,27270,11027,1014,187,77,7,16951,1030,767,1797,3681,1800,1881,8048,336,5.68,86.5,1.5804513909138624,21.467312066250656,271,98.8569429054645,46.93532396337552,0.5085437685892576
19049,"Dallas County, Iowa",78074,38507,39567,42417,50916,17176,4772,1413,783,77546,1830,1415,3245,4424,1812,2612,42116,182,6.89,86.8,8.924866152624434,5.666419038348233,6968,99.32371852345211,53.943694443732866,0.4932115685119246
19051,"Davis County, Iowa",8768,4325,4443,25747,5532,654,198,40,24,8657,1033,1084,2117,1617,696,921,3824,168,7.8,86.3,2.988138686131387,18.44206204379562,262,98.73403284671532,43.613138686131386,0.49327098540145986
19053,"Decatur County, Iowa",8210,4108,4102,21110,4978,648,266,31,56,8102,465,575,1040,1552,762,790,3598,26,5.43,86.6,4.2996345919610235,18.90377588306943,353,98.68453105968331,43.82460414129111,0.5003654080389769
19055,"Delaware County, Iowa",17445,8710,8735,30768,11915,1178,451,85,80,17279,358,319,677,1645,783,862,9173,16,8.2,81.6,3.5310977357409,9.42963599885354,616,99.04843794783605,52.58240183433649,0.4992834623101175
19057,"Des Moines County, Iowa",40114,19749,20365,27168,27782,3865,1128,274,169,39635,1624,1077,2701,6574,2610,3964,18793,194,8.25,86.2,3.916338435458942,16.388293363912847,1571,98.80590317594854,46.84898040584335,0.4923218826344917
19059,"Dickinson County, Iowa",17046,8536,8510,36588,12648,2487,742,353,89,16845,441,365,806,1153,419,734,8822,115,6.67,82.3,6.945911064179279,6.7640502170597205,1184,98.82083773319253,51.75407720286284,0.5007626422621143
19061,"Dubuque County, Iowa",96359,47634,48725,30117,64082,12414,4624,1050,625,95117,2530,2017,4547,11616,4931,6685,50226,267,7.65,81.7,6.537012629852946,12.054919623491319,6299,98.71107006091802,52.12382859930053,0.49433887856868586
19063,"Emmet County, Iowa",9820,4828,4992,29396,6711,892,224,33,24,9556,475,341,816,1223,439,784,4792,2,6.63,83.1,2.8615071283095723,12.45417515274949,281,97.31160896130346,48.79837067209776,0.4916496945010183
19065,"Fayette County, Iowa",20391,10269,10122,27020,13924,1866,583,163,114,20047,805,723,1528,2581,1201,1380,9723,64,9.24,81.4,4.217546956990829,12.657544995341082,860,98.31298121720367,47.68280123583934,0.5036045314109165
19067,"Floyd County, Iowa",16004,7866,8138,28323,11107,1649,356,91,87,15795,534,587,1121,2219,843,1376,7806,44,12.45,81.5,3.3366658335416144,13.86528367908023,534,98.69407648087979,48.775306173456634,0.4915021244688828
19069,"Franklin County, Iowa",10393,5266,5127,25248,7244,897,209,83,24,10246,320,287,607,1509,719,790,4838,28,8.6,83.1,3.0405080342538247,14.519388049648802,316,98.5855864524199,46.550562878860774,0.5066871933031848
19071,"Fremont County, Iowa",7019,3508,3511,29813,4995,758,247,36,30,6899,318,180,498,713,357,356,3334,54,9.07,88.4,4.459324690126799,10.158142185496509,313,98.29035475138909,47.49964382390654,0.49978629434392363
19073,"Greene County, Iowa",9083,4442,4641,27968,6338,831,222,83,3,8968,246,238,484,950,375,575,4329,22,6.35,86.7,3.390950126610151,10.459099416492348,308,98.73389849168777,47.66046460420566,0.4890454695585159
19075,"Grundy County, Iowa",12373,6076,6297,35662,8625,1629,432,92,15,12226,246,191,437,722,283,439,6119,17,7.24,83.8,4.356259597510709,5.835286510951265,539,98.8119292006789,49.45445728602603,0.49106926371938897
19077,"Guthrie County, Iowa",10691,5354,5337,30646,7574,1085,293,126,52,10565,417,275,692,1116,461,655,5234,48,7.01,86.8,4.40557478252736,10.438686745861004,471,98.82143859320924,48.95706669160977,0.5007950612664859
19079,"Hamilton County, Iowa",15227,7535,7692,27963,10647,1678,422,166,78,15024,553,437,990,1612,659,953,7447,33,7.49,83.8,4.373809680173376,10.586458264924149,666,98.6668417941814,48.90654757995666,0.4948446837853812
19081,"Hancock County, Iowa",11006,5555,5451,29147,7771,1121,343,67,18,10852,290,241,531,1026,457,569,5527,47,10.12,82.9,3.8887879338542612,9.32218789751045,428,98.60076322006178,50.218062874795564,0.5047246956205707
19083,"Hardin County, Iowa",17324,8648,8676,28445,12094,1748,518,148,52,16775,461,382,843,1328,525,803,8350,95,7.1,84.1,4.144539367351651,7.665666127915031,718,96.83098591549296,48.19903024705611,0.49919187254675595
19085,"Harrison County, Iowa",14335,7101,7234,29332,10029,1328,315,74,32,14090,646,458,1104,1474,609,865,7172,41,6.11,88.1,2.9368678060690616,10.282525287757238,421,98.29089640739448,50.031391698639695,0.4953610045343565
19087,"Henry County, Iowa",19941,10147,9794,26340,13629,1931,510,84,43,18781,576,459,1035,2508,1253,1255,8848,211,7.73,86,3.1944235494709394,12.57710245223409,637,94.18283937615968,44.37089413770623,0.5088511107767916
19089,"Howard County, Iowa",9430,4689,4741,27906,6415,585,205,50,8,9249,321,386,707,1063,425,638,4551,72,10.64,80.3,2.788971367974549,11.27253446447508,263,98.08059384941676,48.26086956521739,0.49724284199363733
19091,"Humboldt County, Iowa",9607,4672,4935,29587,6697,1039,235,36,20,9495,204,173,377,1286,502,784,4570,46,6.73,84.2,3.029041324034558,13.38607265535547,291,98.83418340793172,47.56948058707193,0.48631206411991257
19093,"Ida County, Iowa",7041,3522,3519,30192,4933,782,109,33,15,6913,195,202,397,760,368,392,3473,24,5.9,85.4,2.229796903848885,10.793921317994602,157,98.18207640960091,49.325379917625334,0.5002130379207499
19095,"Iowa County, Iowa",16326,8101,8225,29881,11335,1375,568,93,76,16082,546,388,934,1575,717,858,8564,40,7.8,86,4.514271713830699,9.647188533627343,737,98.50545142717138,52.456204826656865,0.49620237657723876
19097,"Jackson County, Iowa",19529,9711,9818,27672,13778,1566,552,112,39,19339,651,664,1315,2653,1139,1514,9274,83,6.87,83,3.599774694044754,13.584924983358082,703,99.02708792052844,47.4883506579958,0.4972604844078038
19099,"Jasper County, Iowa",36715,18811,17904,27214,25786,3651,756,144,67,35077,1187,972,2159,3227,1486,1741,17166,61,6.28,85.6,2.633800898815198,8.78932316491897,967,95.53860819828408,46.75473239820237,0.5123518997684869
19101,"Jefferson County, Iowa",17662,9395,8267,26630,12433,2306,1389,196,226,17511,861,470,1331,2504,1486,1018,7933,47,8.04,85.6,10.253651908051184,14.177329860717926,1811,99.14505718491677,44.91563809308119,0.5319329634243007
19103,"Johnson County, Iowa",142006,70409,71597,33039,83193,23294,11324,4480,4522,140376,5334,4070,9404,23911,11491,12420,78847,663,7.89,85,14.31347971212484,16.838020928693155,20326,98.85216117628832,55.52371026576342,0.4958170781516274
19105,"Jones County, Iowa",20481,10580,9901,29653,14593,1747,560,79,56,19241,516,454,970,2034,861,1173,9323,49,6.9,83.8,3.393388994677994,9.931155705287829,695,93.9456081246033,45.52023826961574,0.516576339045945
19107,"Keokuk County, Iowa",10234,5166,5068,26638,7152,888,253,74,2,10114,343,208,551,1296,585,711,4791,42,7.26,86.1,3.2147742818057456,12.663670119210474,329,98.82743795192495,46.81453976939613,0.5047879616963065
19109,"Kossuth County, Iowa",15226,7610,7616,29949,10730,1681,298,96,20,14975,394,279,673,1454,619,835,7595,59,8.46,83.7,2.719033232628399,9.54945487981085,414,98.351504006305,49.88178116379876,0.4998029686063313
19111,"Lee County, Iowa",35172,17813,17359,24408,24733,2693,641,226,46,34365,1316,1006,2322,5615,2526,3089,16084,256,6.79,86.4,2.5958148527237577,15.964403502786308,913,97.70556124189696,45.729557602638465,0.5064539974980098
19113,"Linn County, Iowa",218076,107727,110349,32786,145121,31995,10922,2367,1489,216100,6138,4877,11015,19912,8866,11046,114085,607,7.52,84.5,6.776536620260827,9.130761752783433,14778,99.09389387186118,52.31433078376346,0.49398833434215594
19115,"Louisa County, Iowa",11251,5752,5499,27234,7659,790,174,40,16,11119,277,352,629,1392,645,747,5399,78,7.6,86.4,2.0442627322015823,12.3722335792374,230,98.826770953693,47.986845613723226,0.5112434450271087
19117,"Lucas County, Iowa",8700,4370,4330,27234,6093,771,152,59,24,8566,304,297,601,910,444,466,4137,23,6.47,86,2.7011494252873565,10.459770114942529,235,98.45977011494253,47.55172413793103,0.5022988505747127
19119,"Lyon County, Iowa",11730,6010,5720,28356,7598,1208,268,67,73,11561,438,436,874,675,316,359,5863,9,8.22,83.8,3.4782608695652173,5.754475703324808,408,98.55924978687128,49.98294970161978,0.5123614663256607
19121,"Madison County, Iowa",15661,7830,7831,31449,10603,1875,432,60,14,15475,447,412,859,1054,499,555,7802,15,6.53,86.4,3.2309558776578764,6.730093863737948,506,98.81233637698742,49.818019283570656,0.4999680735585212
19123,"Mahaska County, Iowa",22324,11323,11001,26575,15056,2546,815,155,83,22097,774,394,1168,3010,1393,1617,10805,91,7.5,86.2,4.716896613510124,13.483246729976706,1053,98.98315714029744,48.40082422504928,0.5072119691811503
19125,"Marion County, Iowa",33197,16457,16740,27815,21618,3809,1271,134,285,32954,662,429,1091,3108,1348,1760,16820,97,7.76,86.5,5.090821459770461,9.362291773353014,1690,99.2680061451336,50.66722896647288,0.4957375666475886
19127,"Marshall County, Iowa",40735,20641,20094,25693,27001,3786,1079,193,215,39882,1745,1332,3077,4267,2213,2054,19016,135,7.66,85,3.6504234687615074,10.475021480299496,1487,97.90597766048852,46.68221431201669,0.5067141278998404
19129,"Mills County, Iowa",14841,7534,7307,31309,10174,1775,539,61,58,14625,517,315,832,1203,612,591,7203,63,7.24,88.2,4.433663499764167,8.105922781483727,658,98.54457246816253,48.53446533252476,0.5076477326325719
19131,"Mitchell County, Iowa",10757,5351,5406,27407,7316,853,260,26,6,10541,540,455,995,970,485,485,5110,53,10.43,80.6,2.7145114808961606,9.017384029004369,292,97.99200520591243,47.503950915682815,0.49744352514641627
19133,"Monona County, Iowa",9013,4451,4562,26829,6572,740,271,36,45,8796,316,293,609,1273,561,712,4189,35,5.73,87.4,3.905469876844558,14.124043048929325,352,97.59236658160435,46.47731055142572,0.4938422278930434
19135,"Monroe County, Iowa",7964,4030,3934,25929,5421,633,143,21,36,7833,396,256,652,1032,419,613,3604,19,5.69,86.1,2.5113008538422905,12.958312405826218,200,98.3550979407333,45.25364138623807,0.5060271220492215
19137,"Montgomery County, Iowa",10380,4965,5415,25005,7350,848,243,32,18,10194,494,333,827,1529,624,905,4620,54,9.99,86.9,2.8227360308285165,14.730250481695569,293,98.20809248554913,44.50867052023121,0.47832369942196534
19139,"Muscatine County, Iowa",42949,21329,21620,28028,28370,4069,1328,288,127,42465,1465,1348,2813,4802,2188,2614,20995,110,7.79,85.2,4.058301706675359,11.180702693892757,1743,98.87308202752101,48.88355957065357,0.496612261053808
19141,"O'Brien County, Iowa",14055,7044,7011,32051,9768,1482,285,147,39,13848,372,388,760,1278,511,767,7117,36,8.2,84,3.351120597652081,9.092849519743863,471,98.52721451440769,50.63678406261117,0.5011739594450374
19143,"Osceola County, Iowa",6154,3105,3049,26776,4317,544,142,26,5,6055,246,233,479,631,264,367,3231,31,8.06,82.8,2.8111797205069875,10.253493662658434,173,98.39129021774455,52.502437439064025,0.5045498862528437
19145,"Page County, Iowa",15552,8036,7516,25739,11096,1708,537,129,54,14648,737,476,1213,2193,1089,1104,7065,82,8.66,87.2,4.62962962962963,14.10108024691358,720,94.1872427983539,45.42824074074074,0.5167181069958847
19147,"Palo Alto County, Iowa",9155,4567,4588,27902,6288,1070,263,31,24,8956,284,159,443,797,343,454,4641,38,8.69,84.7,3.4735117422173674,8.705625341343529,318,97.82632441288914,50.69361004915347,0.49885308574549425
19149,"Plymouth County, Iowa",24972,12302,12670,30686,16859,2604,528,111,49,24684,709,664,1373,2111,939,1172,12677,102,6.42,85.6,2.755085695979497,8.453467884030113,688,98.84670831331091,50.76485663943617,0.49263174755726413
19151,"Pocahontas County, Iowa",7061,3504,3557,27553,4993,697,85,40,22,6905,282,175,457,885,376,509,3399,55,7.31,85.1,2.0818580937544255,12.533635462399094,147,97.79068120662795,48.137657555587026,0.49624699051125903
19153,"Polk County, Iowa",459159,225935,233224,33524,302061,74656,22645,6891,3247,454372,16131,12526,28657,55972,24580,31392,240248,1158,7.04,85.7,7.139792533741035,12.190112793171863,32783,98.95744175764823,52.3234870709275,0.49206266238928126
19155,"Pottawattamie County, Iowa",93198,46015,47183,29085,62717,9167,2886,601,302,92073,4244,3262,7506,10668,4626,6042,46098,315,6.87,88,4.065537887079122,11.446597566471384,3789,98.7928925513423,49.46243481619777,0.49373377111096806
19157,"Poweshiek County, Iowa",18622,8900,9722,27679,12034,1618,653,202,279,18326,650,658,1308,1687,688,999,9446,59,6.67,85.1,6.089571474599936,9.059177317151756,1134,98.41048222532488,50.72494898507142,0.47792933089893674
19159,"Ringgold County, Iowa",5054,2463,2591,27621,3525,479,142,39,22,4864,229,251,480,533,208,325,2072,34,7.42,86,4.016620498614959,10.546102097348635,203,96.2406015037594,40.99722991689751,0.48733676296003164
19161,"Sac County, Iowa",10034,4925,5109,29502,7114,1017,270,56,33,9840,344,287,631,997,418,579,4907,30,6.32,85.2,3.577835359776759,9.936216862666932,359,98.06657364959139,48.9037273270879,0.49083117400837156
19163,"Scott County, Iowa",171116,84119,86997,30798,115182,23147,10309,2175,1130,169362,6186,4634,10820,20413,9073,11340,82187,392,9.85,84.4,7.956006451763716,11.929334486547138,13614,98.97496435166788,48.029991350896466,0.49159050001168797
19165,"Shelby County, Iowa",11944,5852,6092,30799,8436,1357,332,65,25,11727,466,369,835,1174,534,640,6004,42,6.53,86.7,3.5331547220361688,9.829202947086403,422,98.18318821165438,50.26791694574682,0.4899531145344943
19167,"Sioux County, Iowa",34621,17444,17177,27339,20516,3881,1158,241,234,34213,1236,962,2198,2444,1022,1422,18552,55,7.07,84.6,4.7167903873371655,7.059299269229658,1633,98.82152450824644,53.585973830911875,0.5038560411311054
19169,"Story County, Iowa",94834,49349,45485,27392,48629,13631,6650,998,3158,94134,2412,1645,4057,19039,10153,8886,49847,117,8.71,85.3,11.394647489297087,20.076133032456713,10806,99.26186810637535,52.56237214501128,0.5203724402640403
19171,"Tama County, Iowa",17423,8610,8813,27074,11868,1397,399,86,54,17048,683,613,1296,2195,1039,1156,8128,125,7.06,84.4,3.0936118923262352,12.598289617172703,539,97.84767261665614,46.65097859151696,0.4941743672157493
19173,"Taylor County, Iowa",6209,3129,3080,27344,4361,431,132,26,5,6110,394,284,678,802,349,453,2995,40,8.8,86.2,2.625221452729908,12.916733773554517,163,98.40554034466098,48.236430987276535,0.503945885005637
19175,"Union County, Iowa",12539,6042,6497,25098,8538,1044,280,71,5,12401,445,572,1017,1585,568,1017,6275,21,7.17,85.8,2.8391418773426906,12.640561448281362,356,98.89943376664806,50.043863146981415,0.48185660738495895
19177,"Van Buren County, Iowa",7380,3779,3601,24952,5170,483,167,4,4,7319,638,478,1116,1060,512,548,3301,58,7.59,86.1,2.3712737127371275,14.363143631436314,175,99.17344173441734,44.7289972899729,0.5120596205962059
19179,"Wapello County, Iowa",35242,17353,17889,23413,24126,2764,1118,263,106,34879,1501,1199,2700,6033,2709,3324,15891,401,6.34,85.8,4.219397310027808,17.11877872992452,1487,98.96997900232677,45.091084501447135,0.4923954372623574
19181,"Warren County, Iowa",48170,23532,24638,33013,31423,6565,1676,553,271,47582,1046,851,1897,3402,1418,1984,24730,34,7.56,86.8,5.189952252439277,7.062487025119369,2500,98.77932323022628,51.33900768112933,0.4885198256176043
19183,"Washington County, Iowa",22115,10972,11143,28397,14978,2169,632,199,130,21796,957,921,1878,1947,801,1146,11011,182,7.16,85.9,4.345466877684829,8.803979199638254,961,98.55754013113271,49.789735473660414,0.496133845806014
19185,"Wayne County, Iowa",6403,3109,3294,23367,4382,396,134,38,4,6300,349,455,804,924,406,518,2726,47,5.77,86,2.7487115414649383,14.430735592690926,176,98.3913790410745,42.5737935342808,0.4855536467280962
19187,"Webster County, Iowa",37050,19089,17961,24629,24837,3760,992,234,133,35335,1389,1090,2479,5362,2111,3251,16366,98,6.76,84.3,3.668016194331984,14.472334682860998,1359,95.37112010796221,44.172739541160595,0.5152226720647773
19189,"Winnebago County, Iowa",10580,5157,5423,26558,7372,1248,273,52,16,10359,255,191,446,1023,472,551,5079,26,9.6,81.6,3.223062381852552,9.669187145557656,341,97.91115311909263,48.00567107750473,0.48742911153119095
19191,"Winneshiek County, Iowa",20789,10393,10396,29052,13571,2335,919,134,355,20514,475,328,803,1472,641,831,11918,87,11.15,80.6,6.772812545095964,7.080667660782145,1408,98.67718504978595,57.32839482418587,0.49992784645726107
19193,"Woodbury County, Iowa",102426,50605,51821,25699,65067,9676,3059,985,387,101475,5187,4076,9263,14084,6280,7804,51199,800,5.49,86.6,4.326050026360495,13.750414933708239,4431,99.07152480815418,49.98633159549333,0.4940640071856755
19195,"Worth County, Iowa",7562,3751,3811,26781,5316,611,175,11,15,7460,270,172,442,775,361,414,3702,9,9.66,81.3,2.658026976990214,10.248611478444856,201,98.65115048928855,48.95530282993917,0.496032795556731
19197,"Wright County, Iowa",12891,6428,6463,28200,8968,1091,309,83,41,12713,566,429,995,1625,719,906,5705,30,7.87,83.3,3.3589325886277246,12.60569389496548,433,98.61919168412071,44.25568225894035,0.4986424637343883
20001,"Allen County, Kansas",12951,6420,6531,23011,8782,1043,473,78,15,12745,685,627,1312,1916,809,1107,5769,43,9.28,89.1,4.370318894293877,14.794224384217435,566,98.40938923635241,44.54482279360667,0.4957146166319203
20003,"Anderson County, Kansas",7858,3899,3959,21887,5357,547,310,156,14,7754,488,466,954,1171,568,603,3606,62,7.13,89,6.108424535505217,14.902010689742937,480,98.6765080173072,45.88953932298295,0.49618223466530925
20005,"Atchison County, Kansas",16557,8046,8511,25494,10273,1336,497,41,171,16381,769,856,1625,2941,1325,1616,7493,53,7.94,89.8,4.282176722836263,17.762879748746755,709,98.93700549616476,45.255783052485356,0.48595760101467655
20007,"Barber County, Kansas",4831,2472,2359,28840,3391,365,219,31,19,4790,233,277,510,674,323,351,2280,34,5.79,94.9,5.568205340509212,13.951562823432,269,99.15131442765473,47.195197681639414,0.5116953011798799
20009,"Barton County, Kansas",27214,13553,13661,26264,18177,2125,635,156,120,26797,2043,1626,3669,4137,1837,2300,13309,59,5.44,91.3,3.3475417064746087,15.201734401411038,911,98.46770044829867,48.90497538031895,0.4980157271992357
20011,"Bourbon County, Kansas",14751,7276,7475,20707,9562,1352,543,154,29,14470,681,625,1306,2489,1131,1358,6553,69,6.23,89.5,4.921700223713646,16.87343230967392,726,98.09504440376924,44.42410684021422,0.49325469459697646
20013,"Brown County, Kansas",9810,4729,5081,24319,6675,792,415,82,51,9737,460,573,1033,1408,584,824,4549,16,9.05,89.6,5.586136595310907,14.352701325178389,548,99.25586136595311,46.3710499490316,0.482059123343527
20015,"Butler County, Kansas",66264,33269,32995,28478,43118,8244,3428,385,277,64032,2840,3022,5862,6171,2542,3629,30929,287,8.63,90.5,6.172280574671013,9.312749003984063,4090,96.63165519739225,46.67541953398527,0.5020674876252565
20017,"Chase County, Kansas",2694,1357,1337,24469,1908,304,101,8,50,2591,94,71,165,324,167,157,1165,25,8,89.9,5.902004454342984,12.026726057906458,159,96.17668893838159,43.244246473645134,0.5037119524870082
20019,"Chautauqua County, Kansas",3470,1755,1715,23621,2527,359,83,9,11,3399,232,192,424,504,233,271,1482,16,6.61,90.9,2.968299711815562,14.52449567723343,103,97.95389048991355,42.70893371757925,0.5057636887608069
20021,"Cherokee County, Kansas",20737,10184,10553,21006,14226,1663,797,136,32,20512,1512,1411,2923,3315,1593,1722,8906,30,6.54,90.7,4.653517866615229,15.98591888894247,965,98.91498288084101,42.94738872546656,0.4911028596228963
20023,"Cheyenne County, Kansas",2679,1341,1338,27934,1889,376,57,22,9,2641,117,88,205,234,105,129,1233,7,5.26,90.9,3.2848077640910787,8.734602463605823,88,98.58156028368795,46.02463605823068,0.5005599104143337
20025,"Clark County, Kansas",2131,1078,1053,27087,1485,335,70,11,11,2069,109,116,225,281,121,160,982,9,6.04,94.5,4.317221961520413,13.186297512904739,92,97.0905678085406,46.08165180666354,0.5058657907085875
20027,"Clay County, Kansas",8346,4090,4256,28115,5792,972,398,48,31,8038,285,236,521,797,304,493,4176,51,7.69,91.5,5.715312724658519,9.549484783129643,477,96.30960939372154,50.035945363048164,0.4900551162233405
20029,"Cloud County, Kansas",9302,4633,4669,25579,6213,757,369,68,64,9067,564,436,1000,1154,582,572,4447,66,8.89,91.6,5.385938507847775,12.40593420769727,501,97.47366157815523,47.80692324231348,0.49806493227262955
20031,"Coffey County, Kansas",8433,4215,4218,31679,5946,930,263,44,20,8323,458,345,803,892,415,477,4014,8,8.43,90.2,3.8776236214870154,10.577493181548677,327,98.69560061662516,47.59871931696905,0.49982212735681253
20033,"Comanche County, Kansas",1898,912,986,28388,1339,191,66,12,0,1822,97,146,243,156,48,108,965,6,6.78,94.7,4.109589041095891,8.219178082191782,78,95.99578503688093,50.84299262381454,0.48050579557428874
20035,"Cowley County, Kansas",35977,18085,17892,23130,23421,3136,1129,215,56,34785,2101,1860,3961,5546,2583,2963,15426,150,7.28,90.8,3.891375045167746,15.415404286071658,1400,96.68677210440003,42.87739389054118,0.5026822692275621
20037,"Crawford County, Kansas",39281,19575,19706,21207,23503,4143,1932,363,226,38648,2626,2373,4999,8176,4149,4027,18422,114,6.63,90.4,6.417861052417199,20.814134059723532,2521,98.38853389679488,46.897991395331076,0.4983325271759884
20039,"Decatur County, Kansas",2886,1431,1455,30890,2167,424,115,19,9,2801,173,140,313,373,92,281,1342,0,6.36,91.2,4.954954954954955,12.924462924462924,143,97.05474705474705,46.5003465003465,0.49584199584199584
20041,"Dickinson County, Kansas",19384,9705,9679,24434,13339,1839,546,84,129,18956,849,553,1402,2131,794,1337,8969,93,6.67,91.9,3.9156004952538175,10.993602971522906,759,97.79199339661577,46.27011968633925,0.5006706562113082
20043,"Doniphan County, Kansas",7793,3938,3855,24520,5160,619,197,28,27,7674,533,443,976,873,420,453,3782,35,10.21,89.5,3.2336712434235855,11.202361093288848,252,98.47298857949441,48.53073270884127,0.5053252919286539
20045,"Douglas County, Kansas",116352,57945,58407,29438,65863,17497,9719,2307,3211,115688,6158,5859,12017,20668,10948,9720,62117,368,8.14,89.4,13.095606435643564,17.763338833883388,15237,99.42931793179318,53.387135588558856,0.49801464521452143
20047,"Edwards County, Kansas",2975,1539,1436,27966,2085,301,68,6,5,2880,160,202,362,318,140,178,1413,46,6.92,92.3,2.6554621848739495,10.6890756302521,79,96.80672268907563,47.49579831932773,0.5173109243697479
20049,"Elk County, Kansas",2635,1315,1320,21156,2038,223,103,12,4,2586,126,175,301,449,219,230,1011,23,7.65,89.6,4.516129032258065,17.039848197343453,119,98.1404174573055,38.368121442125236,0.4990512333965844
20051,"Ellis County, Kansas",29032,14529,14503,29339,17516,4197,1289,265,228,28776,1202,1183,2385,4008,2017,1991,15841,21,6.22,92.2,6.138054560484982,13.80545604849821,1782,99.11821438412785,54.56392945715073,0.50044778175806
20053,"Ellsworth County, Kansas",6375,3624,2751,24102,4631,676,152,62,22,5481,171,156,327,460,179,281,2686,49,6.67,92.8,3.7019607843137257,7.215686274509804,236,85.97647058823529,42.13333333333333,0.5684705882352942
20055,"Finney County, Kansas",36983,18835,18148,23074,21545,2689,1019,170,117,36742,2594,2437,5031,5790,2472,3318,17986,137,5.86,92.8,3.531352242922424,15.655841873293134,1306,99.34834924154342,48.63315577427467,0.5092880512667982
20057,"Ford County, Kansas",34492,17844,16648,22053,20281,2469,883,152,107,33995,2923,2717,5640,5871,2925,2946,16147,346,6.68,92.6,3.310912675402992,17.0213382813406,1142,98.55908616490781,46.81375391395106,0.517337353589238
20059,"Franklin County, Kansas",25663,12513,13150,25701,16959,2237,881,138,122,25495,1026,1056,2082,3357,1492,1865,12312,166,7.4,89,4.446089701126135,13.081089506293107,1141,99.34536102560106,47.975684838093756,0.4875891361103534
20061,"Geary County, Kansas",36818,19465,17353,21583,19630,2730,1018,109,155,31396,1840,1519,3359,4482,1902,2580,17360,375,6.65,90.6,3.481992503666685,12.173393448856537,1282,85.27350752349395,47.15085012765495,0.5286816231191265
20063,"Gove County, Kansas",2682,1354,1328,29352,1943,352,65,17,2,2631,163,136,299,241,127,114,1307,7,4.58,92.5,3.131991051454139,8.985831469052945,84,98.09843400447427,48.732289336316185,0.5048471290082028
20065,"Graham County, Kansas",2577,1278,1299,27165,1941,385,68,18,23,2549,129,79,208,262,88,174,1210,35,6.19,92,4.229724485836243,10.16686069072565,109,98.91346526969345,46.95382227396197,0.4959254947613504
20067,"Grant County, Kansas",7748,4026,3722,26138,4669,505,93,51,60,7670,856,722,1578,870,336,534,3592,20,5.35,93.9,2.6329375322663915,11.228704181724316,204,98.99328859060402,46.360351058337635,0.5196179659266907
20069,"Gray County, Kansas",6037,3002,3035,27031,3768,539,156,4,24,5952,323,354,677,495,194,301,3041,34,6.59,92.7,3.0478714593341065,8.199436806360776,184,98.59201590193805,50.3727016730164,0.49726685439787977
20071,"Greeley County, Kansas",1235,602,633,25775,872,208,34,13,3,1205,54,38,92,85,38,47,574,2,5.12,92.1,4.048582995951417,6.882591093117409,50,97.57085020242916,46.477732793522264,0.4874493927125506
20073,"Greenwood County, Kansas",6304,3101,3203,24837,4546,556,214,21,12,6221,365,394,759,890,368,522,2772,21,9.21,89.6,3.9181472081218276,14.118020304568528,247,98.68337563451777,43.97208121827411,0.4919098984771574
20075,"Hamilton County, Kansas",2567,1368,1199,21694,1566,197,39,4,15,2567,393,254,647,282,130,152,1275,0,5.06,93.7,2.259446825087651,10.985586287495131,58,100,49.66887417218543,0.5329178028827425
20077,"Harper County, Kansas",5798,2939,2859,25698,4049,559,195,24,19,5650,393,302,695,771,372,399,2644,23,6.38,94.6,4.104863746119351,13.297688858226975,238,97.44739565367368,45.60193170058641,0.5068989306657468
20079,"Harvey County, Kansas",34814,17027,17787,26587,22978,3985,1860,282,233,34174,1596,1419,3015,4180,1746,2434,16445,51,8.13,92.3,6.8219681737232145,12.006663985752859,2375,98.16165910265985,47.236743838685584,0.48908485092204285
20081,"Haskell County, Kansas",4087,2066,2021,24141,2480,288,131,15,4,4028,349,394,743,521,247,274,1905,16,6.59,93.4,3.6701737215561536,12.74773672620504,150,98.55639833618791,46.61120626376315,0.5055052605823342
20083,"Hodgeman County, Kansas",1919,967,952,28857,1384,251,84,13,8,1880,89,74,163,108,58,50,999,5,6.71,92.4,5.471599791558103,5.627931214174049,105,97.9676915059927,52.05836373110996,0.5039082855653987
20085,"Jackson County, Kansas",13365,6670,6695,25920,8976,1189,565,53,27,13231,365,412,777,1075,412,663,6249,20,7.65,90.3,4.8260381593714925,8.043396932285821,645,98.99738121960344,46.75645342312009,0.4990647212869435
20087,"Jefferson County, Kansas",18880,9593,9287,27783,13165,1914,589,87,118,18614,1141,689,1830,1690,697,993,8906,45,8.02,89.6,4.205508474576271,8.951271186440678,794,98.59110169491525,47.17161016949152,0.508103813559322
20089,"Jewell County, Kansas",3003,1501,1502,24361,2241,244,57,3,39,2975,117,116,233,454,193,261,1315,13,6.64,91,3.2967032967032965,15.118215118215119,99,99.06759906759906,43.78954378954379,0.49983349983349984
20091,"Johnson County, Kansas",572428,279962,292466,43061,383300,129276,55069,14601,6429,568331,19703,18140,37843,34189,14600,19589,300970,1388,8.08,88.9,13.294073665159635,5.9726288721026926,76099,99.28427679987702,52.5777914427666,0.4890781023989043
20093,"Kearny County, Kansas",3943,2061,1882,24232,2483,200,108,46,0,3873,171,267,438,483,198,285,1751,0,5.11,93.5,3.9056555921886886,12.249556175500887,154,98.22470200355059,44.407811311184375,0.522698452954603
20095,"Kingman County, Kansas",7697,3904,3793,30927,5457,956,276,24,25,7558,382,235,617,662,212,450,3596,66,7.66,93.3,4.22242432116409,8.600753540340392,325,98.1941015980252,46.71950110432636,0.5072106015330649
20097,"Kiowa County, Kansas",2520,1236,1284,24961,1643,302,114,17,16,2449,124,94,218,254,132,122,1251,6,7.19,92.9,5.833333333333333,10.079365079365079,147,97.18253968253968,49.642857142857146,0.49047619047619045
20099,"Labette County, Kansas",20833,10291,10542,22841,14106,1609,639,198,93,20513,1207,1265,2472,3699,1702,1997,9338,100,7.76,90.3,4.464071425142802,17.755484087745405,930,98.46397542360678,44.82311716987472,0.4939759036144578
20101,"Lane County, Kansas",1687,829,858,29768,1171,193,54,0,2,1678,95,55,150,148,63,85,852,0,4.35,92.7,3.319502074688797,8.772969768820392,56,99.4665085951393,50.50385299347955,0.4914048606994665
20103,"Leavenworth County, Kansas",78785,42238,36547,30170,53079,8849,6107,636,361,71725,2400,2249,4649,7238,3214,4024,34739,291,8.62,89.7,9.016944849907977,9.187027987561084,7104,91.03890334454528,44.093418797994545,0.5361172812083519
20105,"Lincoln County, Kansas",3134,1573,1561,25667,2181,301,90,22,6,3069,167,186,353,325,134,191,1448,5,6.53,92.4,3.765156349712827,10.370134014039566,118,97.92597319719209,46.20293554562859,0.501914486279515
20107,"Linn County, Kansas",9524,4695,4829,25796,6687,771,233,26,39,9459,387,442,829,1413,585,828,3961,27,6.07,88.9,3.128937421251575,14.836203275934482,298,99.317513649727,41.58966820663587,0.49296514069718605
20109,"Logan County, Kansas",2800,1384,1416,28549,1914,237,87,24,3,2760,96,71,167,264,120,144,1338,1,4.25,92.3,4.071428571428571,9.428571428571429,114,98.57142857142857,47.785714285714285,0.4942857142857143
20111,"Lyon County, Kansas",33401,16250,17151,24307,19999,3445,1386,248,255,33003,2370,2155,4525,6671,3084,3587,16597,74,7.79,89.7,5.655519295829466,19.97245591449358,1889,98.80841890961348,49.69012903805275,0.4865123798688662
20113,"McPherson County, Kansas",29164,14453,14711,29508,19836,3918,1329,239,133,28489,815,888,1703,1833,716,1117,15483,110,6.68,93.2,5.832533260183788,6.285146070497874,1701,97.68550267453024,53.0894253188863,0.49557673844465777
20115,"Marion County, Kansas",12213,6086,6127,25620,8413,1279,483,95,57,11857,402,512,914,1243,610,633,5569,19,7.55,90.8,5.199377712273806,10.17767952182101,635,97.08507328256776,45.59895193646115,0.49832146073855726
20117,"Marshall County, Kansas",9963,4971,4992,27908,7046,864,273,91,32,9776,452,306,758,923,363,560,4893,60,7.36,90.5,3.974706413730804,9.264277827963465,396,98.12305530462712,49.11171333935562,0.49894610057211686
20119,"Meade County, Kansas",4310,2177,2133,25173,2801,462,134,14,6,4184,254,205,459,591,222,369,2081,29,5.83,94,3.5730858468677495,13.712296983758701,154,97.07656612529003,48.283062645011604,0.5051044083526682
20121,"Miami County, Kansas",32787,16153,16634,31611,21936,3747,1381,197,94,32194,1146,1073,2219,3079,1332,1747,15867,114,7.71,88.5,5.09958215146247,9.390917131790038,1672,98.19135633025284,48.39418062036783,0.49266477567328515
20123,"Mitchell County, Kansas",6299,3229,3070,26108,4274,775,262,54,8,6144,279,128,407,697,242,455,2944,4,7.02,91.6,5.143673598983966,11.06524845213526,324,97.53929195110335,46.737577393237025,0.51262105096047
20125,"Montgomery County, Kansas",33765,16677,17088,22823,22644,2641,1077,171,94,33227,2064,2031,4095,6225,2955,3270,14247,135,7.71,91.1,3.9745298385902563,18.436250555308753,1342,98.40663408855323,42.19458018658374,0.49391381608174145
20127,"Morris County, Kansas",5694,2835,2859,26569,4145,438,213,46,0,5611,256,267,523,492,209,283,2751,19,6.55,90.1,4.548647699332631,8.640674394099051,259,98.54232525465402,48.314014752370916,0.49789251844046367
20129,"Morton County, Kansas",3033,1596,1437,23038,1949,208,64,7,0,2944,159,161,320,297,123,174,1342,4,3.72,95,2.3409165842400266,9.792284866468842,71,97.06561160567095,44.246620507748105,0.5262116716122651
20131,"Nemaha County, Kansas",10177,5092,5085,27438,6749,1105,281,48,36,9904,264,289,553,1078,452,626,5173,31,6.55,89.6,3.586518620418591,10.592512528249975,365,97.31748059349513,50.830303625822935,0.5003439127444237
20133,"Neosho County, Kansas",16358,7966,8392,23589,10801,1174,659,141,65,16142,672,954,1626,3113,1342,1771,7692,38,6.83,89.6,5.287932510086808,19.03044381953784,865,98.67954517667197,47.02286343073725,0.48697884826995963
20135,"Ness County, Kansas",3047,1563,1484,30761,2204,358,72,14,0,2995,102,105,207,338,204,134,1470,8,6.6,92.2,2.822448309812931,11.09287824089268,86,98.29340334755497,48.24417459796521,0.5129635707253036
20137,"Norton County, Kansas",5558,3204,2354,22935,4045,466,61,26,5,4749,128,143,271,419,166,253,2608,22,5.48,91.4,1.6552716804605974,7.538682979489025,92,85.4444044620367,46.923353724361284,0.5764663548038863
20139,"Osage County, Kansas",16001,8018,7983,27209,11016,1486,555,61,95,15795,696,824,1520,1826,808,1018,7037,32,7.41,90,4.443472282982314,11.411786763327292,711,98.71258046372101,43.97850134366602,0.5010936816448972
20141,"Osborne County, Kansas",3746,1868,1878,26559,2697,396,115,36,19,3642,201,199,400,631,300,331,1765,28,6.85,91.1,4.538174052322478,16.844634276561667,170,97.22370528563802,47.11692471970102,0.4986652429257875
20143,"Ottawa County, Kansas",6004,3154,2850,28839,4129,672,172,17,26,5915,248,213,461,501,230,271,2950,28,7.25,92.6,3.580946035976016,8.344437041972018,215,98.51765489673551,49.13391072618254,0.5253164556962026
20145,"Pawnee County, Kansas",6840,3895,2945,24404,5052,677,360,78,15,5758,201,253,454,423,120,303,2920,9,6.54,91.7,6.62280701754386,6.184210526315789,453,84.18128654970761,42.69005847953216,0.5694444444444444
20147,"Phillips County, Kansas",5484,2672,2812,24795,3801,596,192,46,15,5369,192,126,318,503,159,344,2767,9,6.06,90.7,4.613420860685631,9.172137126185266,253,97.90299051787017,50.455871626549964,0.48723559445660103
20149,"Pottawatomie County, Kansas",22920,11326,11594,27978,14399,2993,1068,166,380,22416,866,765,1631,2045,937,1108,10865,146,7.37,90.3,7.041884816753926,8.922338568935428,1614,97.80104712041884,47.404013961605585,0.4941535776614311
20151,"Pratt County, Kansas",9729,4858,4871,27063,6328,1153,368,56,34,9511,480,490,970,1226,530,696,4451,78,5.73,93.1,4.707575290369,12.601500668105663,458,97.75927639017371,45.749820125398294,0.4993318943365197
20153,"Rawlins County, Kansas",2557,1293,1264,27615,1902,340,91,21,2,2518,70,80,150,204,82,122,1177,12,6.74,90.6,4.458349628470864,7.978099335158388,114,98.47477512710208,46.03050449745796,0.5056707078607744
20155,"Reno County, Kansas",63803,32151,31652,25267,43380,5567,2246,344,167,61280,3102,3532,6634,8727,3968,4759,28801,317,7.4,93,4.32111342726831,13.678040217544629,2757,96.04564048712443,45.14051063429619,0.5039104744291021
20157,"Republic County, Kansas",4768,2337,2431,27121,3547,457,237,19,31,4672,191,135,326,530,214,316,2414,45,7.75,91,6.019295302013423,11.115771812080537,287,97.98657718120805,50.62919463087248,0.4901426174496644
20159,"Rice County, Kansas",9949,5020,4929,23355,6380,962,343,31,92,9744,662,537,1199,1404,690,714,4735,28,7.46,92.5,4.683887827922404,14.111971052367073,466,97.93949140617147,47.592722886722285,0.504573323952156
20161,"Riley County, Kansas",75026,39816,35210,26619,37238,9155,4780,1083,2120,68566,2481,1852,4333,14347,6684,7663,40443,256,6.76,91,10.640311358728974,19.1227041292352,7983,91.38965158744968,53.905312824887375,0.530696025377869
20163,"Rooks County, Kansas",5160,2500,2660,25415,3627,563,254,39,24,4976,241,216,457,673,318,355,2526,15,6.24,91.9,6.1434108527131785,13.042635658914728,317,96.43410852713178,48.95348837209303,0.4844961240310077
20165,"Rush County, Kansas",3144,1557,1587,25983,2309,317,171,30,30,3078,118,132,250,230,100,130,1477,3,5.63,92,7.347328244274809,7.315521628498728,231,97.90076335877863,46.978371501272264,0.4952290076335878
20167,"Russell County, Kansas",6988,3511,3477,25686,4996,618,406,101,86,6868,299,303,602,893,461,432,3416,5,6.08,92.5,8.485975958786492,12.779049799656555,593,98.28277046365197,48.88380080137378,0.5024327418431597
20169,"Saline County, Kansas",55547,27433,28114,27951,36669,5864,1929,602,321,54707,3242,3342,6584,7986,3320,4666,27916,496,7.15,93.4,5.13439069616721,14.377014060165266,2852,98.48776711613588,50.25653950708409,0.49387005598862227
20171,"Scott County, Kansas",4958,2385,2573,31825,3323,685,128,62,0,4859,148,53,201,250,52,198,2472,15,3.89,92.7,3.8321903993545785,5.0423557886244454,190,98.00322710770472,49.85881403791851,0.4810407422347721
20173,"Sedgwick County, Kansas",508221,251174,257047,27583,325515,64944,25073,4869,2903,502146,33961,29040,63001,75476,34618,40858,240607,2285,9.43,93.2,6.4627396349226025,14.851019536776324,32845,98.8046538808904,47.34298661409112,0.49422200184565374
20175,"Seward County, Kansas",23185,11823,11362,21158,13194,1134,297,92,4,22994,2353,2051,4404,4285,1736,2549,10678,102,5.72,94.4,1.6950614621522535,18.481777010998492,393,99.17619150312701,46.05563942204011,0.509941772697865
20177,"Shawnee County, Kansas",178567,86494,92073,28584,119829,22302,8946,2446,1357,175276,9486,7810,17296,25190,12173,13017,83343,743,8.22,90.4,7.13961706250315,14.106749847396216,12749,98.15699429345848,46.67323749628991,0.4843784125846321
20179,"Sheridan County, Kansas",2522,1303,1219,30165,1858,326,77,22,0,2494,114,140,254,152,45,107,1255,11,5.34,91.9,3.9254559873116572,6.026962727993656,99,98.88977002379065,49.76209357652657,0.5166534496431404
20181,"Sherman County, Kansas",6038,3048,2990,25653,4132,573,173,26,14,5966,247,165,412,1010,566,444,2826,40,4.45,91.5,3.5276581649552834,16.727393176548524,213,98.80755216959258,46.80357734349122,0.5048029148724743
20183,"Smith County, Kansas",3701,1820,1881,28122,2759,445,102,27,32,3643,96,148,244,505,195,310,1757,8,5.1,90.4,4.350175628208592,13.644960821399621,161,98.43285598486895,47.47365576871116,0.4917589840583626
20185,"Stafford County, Kansas",4284,2170,2114,25941,2976,490,131,10,15,4171,230,235,465,654,365,289,2010,62,5.04,91.9,3.641456582633053,15.266106442577032,156,97.36227824463118,46.9187675070028,0.5065359477124183
20187,"Stanton County, Kansas",2115,994,1121,21062,1415,267,69,0,15,2085,141,150,291,153,60,93,1098,20,4.52,94.7,3.971631205673759,7.23404255319149,84,98.58156028368795,51.91489361702128,0.4699763593380615
20189,"Stevens County, Kansas",5738,2903,2835,24691,3549,468,107,10,0,5632,400,519,919,1014,377,637,2583,8,5.15,94.3,2.039037992331823,17.67166260020913,117,98.15266643429767,45.01568490763332,0.505925409550366
20191,"Sumner County, Kansas",23509,11647,11862,25393,15758,2233,630,133,66,23014,1271,992,2263,2872,1205,1667,10576,53,8.4,93.6,3.5263090731209323,12.216597898677103,829,97.89442341231018,44.98702624526777,0.4954272831681484
20193,"Thomas County, Kansas",7909,3901,4008,26718,5046,953,370,92,17,7792,248,294,542,756,371,385,4323,41,5.14,91.1,6.056391452775319,9.558730560121381,479,98.52067265140978,54.65924895688456,0.4932355544316601
20195,"Trego County, Kansas",2927,1431,1496,33233,2163,415,120,13,11,2852,120,90,210,123,52,71,1652,14,6.04,92.1,4.91971301674069,4.202254868466006,144,97.43764947044755,56.44004099760847,0.48889648103860606
20197,"Wabaunsee County, Kansas",6960,3510,3450,25790,4766,769,277,44,41,6858,304,247,551,459,160,299,3329,48,7.51,90,5.2011494252873565,6.594827586206897,362,98.53448275862068,47.83045977011494,0.5043103448275862
20199,"Wallace County, Kansas",1584,799,785,29931,1061,205,47,2,10,1565,81,38,119,158,71,87,733,1,4.31,92.2,3.724747474747475,9.974747474747474,59,98.80050505050505,46.275252525252526,0.5044191919191919
20201,"Washington County, Kansas",5613,2863,2750,26927,3951,560,148,17,3,5478,205,181,386,574,243,331,2793,31,7.05,91.1,2.9930518439337255,10.226260466773562,168,97.59486905398182,49.759486905398184,0.5100659184037056
20203,"Wichita County, Kansas",2168,1063,1105,27111,1423,191,62,7,0,2141,67,101,168,127,57,70,1011,0,4.08,92.4,3.1826568265682655,5.857933579335794,69,98.75461254612546,46.632841328413285,0.49031365313653136
20205,"Wilson County, Kansas",8956,4371,4585,25107,6218,632,206,70,42,8826,681,628,1309,1456,695,761,4129,36,7.47,90.5,3.5506922733363107,16.25725770433229,318,98.54845913354175,46.10317105850826,0.4880527020991514
20207,"Woodson County, Kansas",3186,1601,1585,21419,2331,240,66,9,5,3168,226,260,486,726,338,388,1501,23,9.32,90,2.5109855618330195,22.78719397363465,80,99.43502824858757,47.11236660389203,0.502510985561833
20209,"Wyandotte County, Kansas",161777,79712,82065,20192,101519,11126,3997,850,548,160525,17720,16047,33767,36409,16340,20069,71474,310,9.19,89.7,3.3348374614438394,22.505671387156394,5395,99.22609518040265,44.180569549441515,0.49272764360817667
21001,"Adair County, Kentucky",19156,9484,9672,18408,12753,1118,779,142,64,18870,1296,996,2292,4146,1862,2284,7895,56,10.04,88.3,5.1419920651493,21.64334934224264,985,98.50699519732721,41.21424096888703,0.4950929212779286
21003,"Allen County, Kentucky",20421,10146,10275,21652,13827,1122,584,114,65,20236,1630,1373,3003,3420,1570,1850,8219,241,10.48,88.9,3.7363498359531855,16.747465843984134,763,99.09406983007688,40.247784143773565,0.49684148670486267
21005,"Anderson County, Kentucky",21867,10625,11242,24991,14970,1879,726,184,46,21759,900,647,1547,2453,1059,1394,10344,9,8.69,87.7,4.37188457493026,11.217816801573147,956,99.50610508986144,47.304156948827,0.4858919833539123
21007,"Ballard County, Kentucky",8216,4081,4135,25063,5766,524,281,57,18,8091,442,384,826,1298,530,768,3373,58,8.87,89.6,4.33300876338851,15.798442064264849,356,98.47857838364168,41.054040895813046,0.49671372930866603
21009,"Barren County, Kentucky",43287,21084,22203,20493,29416,2725,1368,356,119,42548,2401,2028,4429,9066,4045,5021,18335,186,10.01,89.3,4.257629311340588,20.943932358444798,1843,98.29278998313582,42.35682768498626,0.48707464134728673
21011,"Bath County, Kentucky",12113,6015,6098,20059,8115,689,196,73,24,12016,766,642,1408,2931,1265,1666,4432,48,7.12,86.8,2.418888797160076,24.197143564765128,293,99.19920746305623,36.58878890448279,0.4965739288367869
21013,"Bell County, Kentucky",27676,13503,14173,14754,19428,929,665,197,64,26845,1405,1562,2967,9776,4173,5603,7436,108,9.61,86.7,3.3458592282121695,35.32302355831768,926,96.9973984679867,26.86804451510334,0.48789564966035553
21015,"Boone County, Kentucky",125656,62107,63549,33553,81533,16373,6902,1304,746,124674,4079,4251,8330,9856,3863,5993,62598,402,5.87,87.1,7.1242121347170055,7.84363659514866,8952,99.21850130515057,49.81696059081938,0.49426211243394663
21017,"Bourbon County, Kentucky",20004,9772,10232,25994,13879,1588,585,183,112,19773,1324,1021,2345,3347,1278,2069,8933,113,6.18,87.5,4.399120175964807,16.731653669266148,880,98.84523095380924,44.65606878624275,0.488502299540092
21019,"Boyd County, Kentucky",48716,24164,24552,26420,34732,3985,1873,530,260,46608,2229,2401,4630,8795,3827,4968,18205,194,5.82,88.3,5.466376549798834,18.053616881517367,2663,95.67287954676081,37.36965268084408,0.49601773544625993
21021,"Boyle County, Kentucky",29650,14774,14876,23822,19857,2346,1615,331,276,28338,1463,1109,2572,4381,2046,2335,12093,113,9.54,87.5,7.494097807757167,14.775716694772344,2222,95.57504215851603,40.785834738617204,0.49827993254637437
21023,"Bracken County, Kentucky",8404,4188,4216,22433,5698,534,247,34,19,8369,338,310,648,1718,770,948,3419,14,5.65,87.4,3.569728700618753,20.442646358876726,300,99.58353165159448,40.683008091385055,0.49833412660637794
21025,"Breathitt County, Kentucky",13476,6742,6734,16875,9401,565,455,116,11,13331,828,568,1396,4411,2051,2360,4001,182,7.31,87.8,4.3187889581478185,32.732264766993175,582,98.92401306025526,29.689818937370138,0.5002968239833778
21027,"Breckinridge County, Kentucky",20000,10026,9974,20735,13867,790,614,53,0,19722,1307,940,2247,3350,1580,1770,7478,117,7.32,88,3.335,16.75,667,98.61,37.39,0.5013
21029,"Bullitt County, Kentucky",77727,38657,39070,26643,53090,4864,2103,421,144,77351,2882,1939,4821,7904,3769,4135,37453,216,7.31,87.4,3.4325266638362475,10.168924569325974,2668,99.51625561259279,48.185315270112056,0.4973432655319258
21031,"Butler County, Kentucky",12828,6440,6388,21787,8995,484,352,51,48,12614,725,615,1340,3080,1375,1705,5111,92,11.8,89.8,3.515746803866542,24.009978172747115,451,98.3317742438416,39.84253196133458,0.5020268163392578
21033,"Caldwell County, Kentucky",12758,6123,6635,25272,8938,628,653,43,37,12636,788,433,1221,2647,1124,1523,5186,236,13.09,88.2,5.745414641793385,20.747766107540368,733,99.04373726289387,40.64900454616711,0.4799341589590845
21035,"Calloway County, Kentucky",38302,18356,19946,21757,23270,3899,1884,339,531,37877,1995,1836,3831,8615,4116,4499,16599,102,8.91,90.2,7.190225053522009,22.49229805232103,2754,98.89039736828364,43.33716255025847,0.47924390371259984
21037,"Campbell County, Kentucky",91456,44729,46727,31065,61794,12045,4802,1192,863,89957,4037,3760,7797,13138,5624,7514,45413,441,6.4,87.5,7.497594471658503,14.36537788663401,6857,98.36096046186144,49.65557207837649,0.4890767144856543
21039,"Carlisle County, Kentucky",4954,2408,2546,24015,3496,291,191,23,45,4885,359,268,627,798,330,468,2063,56,8.83,90.1,5.228098506257569,16.10819539765846,259,98.60718611223254,41.643116673395234,0.48607186112232537
21041,"Carroll County, Kentucky",10776,5520,5256,22296,7196,489,296,78,39,10528,692,561,1253,2698,1159,1539,4397,19,5.85,88,3.8325909428359317,25.037119524870082,413,97.69858945805494,40.80363771343727,0.512249443207127
21043,"Carter County, Kentucky",27292,13473,13819,18477,18391,1391,794,153,78,26985,1816,1594,3410,4933,2229,2704,9742,51,5.3,87.4,3.7556793199472374,18.074893741755826,1025,98.87512824270848,35.69544188773267,0.4936611461234061
21045,"Casey County, Kentucky",15928,7854,8074,18319,11088,688,501,149,35,15593,1254,1022,2276,4114,1848,2266,5719,53,10.06,86.9,4.300602712204922,25.828729281767956,685,97.89678553490708,35.90532395781015,0.4930939226519337
21047,"Christian County, Kentucky",73936,39157,34779,21393,41893,4284,2119,469,141,64581,4018,3719,7737,13719,5684,8035,30849,416,15.4,88.2,3.691030080069249,18.555236961696604,2729,87.34716511577581,41.723923393204934,0.5296066868643151
21049,"Clark County, Kentucky",35706,17464,18242,26219,24981,3463,1312,195,144,35281,1750,1440,3190,5300,2105,3195,15773,211,6.92,87.4,4.623872738475327,14.843443678933513,1651,98.80972385593458,44.17464851845628,0.48910547246961295
21051,"Clay County, Kentucky",21160,11267,9893,15388,14897,826,576,138,38,19533,1191,807,1998,7961,3907,4054,5579,58,7.75,88.1,3.553875236294896,37.62287334593573,752,92.3109640831758,26.365784499054822,0.5324669187145558
21053,"Clinton County, Kentucky",10172,5087,5085,19325,6982,437,262,68,0,10020,803,414,1217,2245,1055,1190,3561,54,9.52,88.1,3.244199764058199,22.070389303971687,330,98.50570192685804,35.007864726700745,0.5000983090837593
21055,"Crittenden County, Kentucky",9211,4652,4559,22765,6459,501,186,128,12,9012,689,654,1343,1909,875,1034,3516,46,11.17,88.7,3.5392465530344155,20.7252198458365,326,97.83953968081642,38.17175116708284,0.5050483118011073
21057,"Cumberland County, Kentucky",6780,3363,3417,18669,4786,469,181,27,3,6692,560,449,1009,1484,630,854,2409,23,9.79,89.2,3.112094395280236,21.887905604719766,211,98.70206489675516,35.530973451327434,0.49601769911504423
21059,"Daviess County, Kentucky",98724,47998,50726,26501,66401,8435,4360,794,511,96812,4306,3241,7547,15599,6831,8768,43021,180,8.86,88.5,5.738219683157085,15.800615858352579,5665,98.06328754912685,43.57704306956769,0.4861837040638548
21061,"Edmonson County, Kentucky",12086,5991,6095,21851,8595,675,246,92,10,11991,378,388,766,2606,1057,1549,4420,55,11.12,90.2,2.8793645540294555,21.56213801092173,348,99.21396657289426,36.571239450604004,0.4956975012411054
21063,"Elliott County, Kentucky",7661,4321,3340,13436,5639,301,157,20,18,6601,341,326,667,2210,1075,1135,1797,0,6.51,87.1,2.545359613627464,28.84740895444459,195,86.16368620284558,23.45646782404386,0.5640255841273986
21065,"Estill County, Kentucky",14406,7062,7344,17728,10190,558,271,75,37,14281,924,692,1616,4326,1882,2444,4683,62,7.47,87.1,2.658614466194641,30.02915451895044,383,99.13230598361794,32.50728862973761,0.49021241149521033
21067,"Fayette County, Kentucky",311529,152953,158576,31653,200906,47372,22813,7174,5899,306358,16561,13213,29774,56444,25427,31017,156659,1405,6.36,87.4,11.519312808759377,18.118377422326652,35886,98.34012242840956,50.28713217710069,0.4909751580109717
21069,"Fleming County, Kentucky",14543,7180,7363,23351,9817,678,448,66,54,14543,1336,1096,2432,3226,1414,1812,5636,14,6.57,86.6,3.905659079969745,22.182493295743658,568,100,38.754039744206835,0.49370831327786563
21071,"Floyd County, Kentucky",38144,18695,19449,18366,26544,1528,1225,260,110,37613,2691,1972,4663,11532,5629,5903,10862,27,6.71,88.4,4.181522651006712,30.23280201342282,1595,98.60790687919463,28.47630033557047,0.4901164010067114
21073,"Franklin County, Kentucky",49982,24386,25596,28001,34721,6065,2998,525,241,49183,2864,2018,4882,7054,3255,3799,22903,88,7.07,88,7.530711055980153,14.113080709055259,3764,98.40142451282462,45.822496098595494,0.48789564243127526
21075,"Fulton County, Kentucky",6323,3141,3182,18111,4437,373,176,19,28,5870,297,353,650,1566,723,843,2171,37,9.84,90.2,3.5268068954610152,24.766724656017715,223,92.83567926617113,34.334967578681,0.49675786810058514
21077,"Gallatin County, Kentucky",8543,4288,4255,22508,5618,407,116,22,15,8434,480,461,941,1131,549,582,3551,26,6.39,88,1.7909399508369426,13.238909048343674,153,98.72410160365212,41.56619454524172,0.5019314058293339
21079,"Garrard County, Kentucky",17051,8359,8692,24874,12040,1127,536,118,81,16946,912,876,1788,3259,1580,1679,7056,69,8.14,87.1,4.310597618907982,19.113248489824645,735,99.384200340156,41.38173714151662,0.49023517682247375
21081,"Grant County, Kentucky",24705,12263,12442,20892,15780,1162,573,203,11,24266,1132,1256,2388,4857,2117,2740,9431,93,6.34,87.4,3.1855899615462455,19.65998785670917,787,98.22303177494435,38.174458611617084,0.4963772515685084
21083,"Graves County, Kentucky",37379,18309,19070,22112,25331,2613,1255,254,135,36958,2077,1873,3950,6758,2999,3759,15196,181,8.85,90.2,4.39819149789989,18.079670403167555,1644,98.87369913587844,40.653843066962736,0.4898204874394714
21085,"Grayson County, Kentucky",26092,13029,13063,19520,17649,965,540,240,47,25757,1651,1521,3172,6212,2969,3243,10504,89,9.37,89.4,3.1695538862486585,23.80806377433696,827,98.71608155756553,40.25755020695999,0.4993484592978691
21087,"Green County, Kentucky",11123,5447,5676,23448,7916,439,299,48,33,11008,594,467,1061,2151,942,1209,4560,50,6.74,88.8,3.4163445113728312,19.33830801042884,380,98.96610626629507,40.99613413647397,0.4897060145644161
21089,"Greenup County, Kentucky",36255,17640,18615,25378,25679,2723,1189,272,131,35838,1795,1643,3438,6268,2814,3454,13451,73,5.12,88.1,4.391118466418425,17.288649841401185,1592,98.84981381878362,37.101089504895874,0.48655357881671496
21091,"Hancock County, Kentucky",8716,4500,4216,22438,5849,448,184,37,20,8664,295,276,571,1481,706,775,3522,30,7.78,87.6,2.765029830197338,16.991739329967874,241,99.40339605323543,40.40844424047728,0.5162918770078018
21093,"Hardin County, Kentucky",107573,53666,53907,26436,69718,9231,5929,995,312,102314,4399,4200,8599,14847,5781,9066,50052,494,6.85,87.6,6.726594963420189,13.801790412092254,7236,95.1112267948277,46.528403967538324,0.498879830440724
21095,"Harlan County, Kentucky",28031,13647,14384,15457,19405,1358,699,240,48,27553,1775,1554,3329,8857,4043,4814,7787,12,8.88,84.2,3.521101637472798,31.5971602868253,987,98.29474510363526,27.77995790374942,0.48685384039099566
21097,"Harrison County, Kentucky",18629,9133,9496,22497,12805,1321,424,224,9,18420,1375,1060,2435,3476,1464,2012,7663,84,5.26,87.7,3.5267593536958506,18.659079929142734,657,98.87809329539965,41.134789843791935,0.49025712598636534
21099,"Hart County, Kentucky",18510,9146,9364,19715,12537,812,544,71,4,18251,1415,1214,2629,4398,1988,2410,6805,109,8.4,89.3,3.344138303619665,23.760129659643436,619,98.60075634792004,36.76391139924365,0.4941112911939492
21101,"Henderson County, Kentucky",46362,22480,23882,23958,31966,3269,1887,285,132,45434,2117,1617,3734,8696,3879,4817,20515,59,8.67,88.7,4.969587161899832,18.756740433976102,2304,97.99836072645701,44.24960096630861,0.48487985850480997
21103,"Henry County, Kentucky",15528,7699,7829,23932,10635,740,353,55,50,15449,758,718,1476,2661,1212,1449,7049,63,6.8,87.5,2.949510561566203,17.13678516228748,458,99.49124162802678,45.39541473467285,0.4958140133951571
21105,"Hickman County, Kentucky",4691,2195,2496,19764,3304,135,83,32,40,4512,337,214,551,753,333,420,1697,19,9.36,90.2,3.304199531016841,16.052014495843103,155,96.18418247708378,36.17565551055212,0.4679172884246429
21107,"Hopkins County, Kentucky",46359,22520,23839,23288,32189,2712,1646,394,99,45329,2339,2525,4864,7280,2976,4304,18831,250,14.87,89,4.613990810845791,15.703531137427468,2139,97.77820919346837,40.61994434737591,0.4857740676028387
21109,"Jackson County, Kentucky",13357,6646,6711,16827,9273,572,330,100,36,13247,1102,753,1855,4381,2112,2269,4137,30,7.95,86.3,3.4888073669237105,32.79928127573557,466,99.17646178033989,30.972523770307703,0.49756681889645876
21111,"Jefferson County, Kentucky",759724,366994,392730,31039,520121,97303,48406,12877,7033,751564,35326,30007,65333,119158,52668,66490,362193,3544,6.33,87.8,8.992212961549194,15.684380116989853,68316,98.92592573092334,47.674286977902504,0.4830622699822567
21113,"Jessamine County, Kentucky",51015,24991,26024,28195,33007,5358,2775,762,572,50432,2631,2148,4779,9139,4008,5131,22840,103,7.23,87.5,8.054493776340292,17.914338919925513,4109,98.85719886307949,44.77114574144859,0.4898755268058414
21115,"Johnson County, Kentucky",23280,11432,11848,19925,16204,955,665,222,58,22846,1220,1049,2269,5964,2690,3274,6847,12,6.29,88.5,4.059278350515464,25.61855670103093,945,98.13573883161511,29.41151202749141,0.4910652920962199
21117,"Kenton County, Kentucky",163393,80736,82657,30195,110045,20665,8312,2202,837,161869,7290,6418,13708,21805,9309,12496,80104,616,6.09,87.1,6.9470540353625925,13.345124944153055,11351,99.06727950401792,49.02535604340455,0.49412153519428614
21119,"Knott County, Kentucky",15884,7887,7997,17670,10913,687,514,158,50,15703,904,807,1711,4784,2198,2586,4630,84,7.45,86.9,4.545454545454546,30.118358096197433,722,98.86048854192899,29.148829010324857,0.49653739612188363
21121,"Knox County, Kentucky",31740,15460,16280,15869,21288,1212,732,254,122,31389,2286,1718,4004,10613,4983,5630,9052,39,8.7,88.2,3.490863264020164,33.43730308758664,1108,98.89413988657844,28.51921865154379,0.4870825456836799
21123,"Larue County, Kentucky",14127,6917,7210,21879,9905,652,354,49,9,13845,850,388,1238,2260,885,1375,5910,20,6.73,87.6,2.916401217526722,15.997734834005804,412,98.00382246761521,41.83478445529836,0.48962978693282366
21125,"Laurel County, Kentucky",59950,29173,30777,20446,40879,2971,1540,402,217,59217,3785,2819,6604,13475,5999,7476,21908,100,8.62,87.5,3.6013344453711427,22.477064220183486,2159,98.77731442869057,36.543786488740615,0.48662218515429523
21127,"Lawrence County, Kentucky",15870,7924,7946,18885,10899,621,512,94,21,15760,762,944,1706,3519,1514,2005,4887,170,6.24,88.7,3.950850661625709,22.17391304347826,627,99.30686830497794,30.793950850661627,0.49930686830497795
21129,"Lee County, Kentucky",6896,3540,3356,16489,4962,146,196,36,0,6173,311,322,633,2360,1055,1305,1579,50,7.39,87.5,3.3642691415313224,34.222737819025525,232,89.51566125290023,22.897331786542924,0.5133410672853829
21131,"Leslie County, Kentucky",10869,5379,5490,15112,7658,456,177,76,33,10609,509,611,1120,3435,1589,1846,2508,8,7.65,86.9,2.631336829515135,31.603643389456252,286,97.60787560953169,23.07479988959426,0.49489373447419266
21133,"Letcher County, Kentucky",23382,11444,11938,18085,16557,1076,520,169,89,23199,1289,1232,2521,6889,3129,3760,7214,51,7.16,85.8,3.3273458215721496,29.46283465913951,778,99.21734667693097,30.85279274655718,0.4894363185356257
21135,"Lewis County, Kentucky",13646,6781,6865,19346,9500,579,409,78,34,13500,782,849,1631,3773,1720,2053,4361,88,5.91,86.9,3.8179686354975817,27.649127949582294,521,98.9300894034882,31.958082954712005,0.4969221749963359
21137,"Lincoln County, Kentucky",24424,11927,12497,19351,16801,1017,469,153,18,24200,1948,1503,3451,6049,2801,3248,8950,6,8.88,86.4,2.6203734032099573,24.766622993776615,640,99.08286930887651,36.64428431051425,0.4883311496888307
21139,"Livingston County, Kentucky",9353,4637,4716,24464,6815,362,258,16,48,9293,341,264,605,1282,456,826,3855,17,10.95,89.1,3.4427456431091628,13.70683203250294,322,99.3584946006629,41.21672190740939,0.49577675612103067
21141,"Logan County, Kentucky",26757,13151,13606,21465,18219,1651,650,104,29,26461,1559,1526,3085,4778,2156,2622,10350,107,13.27,89.6,2.9263370332996974,17.8570093807228,783,98.89374743057891,38.681466532122435,0.49149755204245615
21143,"Lyon County, Kentucky",8325,4643,3682,27098,6584,634,344,125,50,6962,364,260,624,1030,391,639,2721,26,13.05,88.9,6.2342342342342345,12.372372372372372,519,83.62762762762763,32.68468468468468,0.5577177177177177
21145,"McCracken County, Kentucky",65292,31043,34249,29881,46026,6390,2948,890,324,64129,3051,2601,5652,11342,4957,6385,28667,346,8.67,89.9,6.3744409728603815,17.371194020706977,4162,98.21877105924156,43.905838387551306,0.4754487532928996
21147,"McCreary County, Kentucky",17850,9799,8051,11492,12283,483,371,81,11,16255,1077,582,1659,6906,3422,3484,4372,171,8.26,87.2,2.5938375350140057,38.6890756302521,463,91.06442577030812,24.49299719887955,0.5489635854341737
21149,"McLean County, Kentucky",9492,4693,4799,22884,6578,311,219,68,9,9408,493,429,922,1718,849,869,3883,0,11.66,89,3.1184155077960387,18.09945217024863,296,99.11504424778761,40.908133164770334,0.4944163506110409
21151,"Madison County, Kentucky",87324,42491,44833,23733,53115,9272,4400,721,1071,86505,3911,3629,7540,17222,8035,9187,39409,585,7.02,87.1,7.09083413494572,19.721955018093535,6192,99.06211350831387,45.12963217443085,0.48659016994182586
21153,"Magoffin County, Kentucky",12887,6495,6392,17279,8842,433,247,213,4,12787,765,599,1364,3751,1817,1934,3497,13,6.64,87.7,3.6005276635368975,29.106851866221774,464,99.22402421044464,27.135873360751145,0.5039962753162102
21155,"Marion County, Kentucky",19497,9882,9615,21823,13237,1027,605,52,41,18630,945,701,1646,3541,1474,2067,7718,15,9.66,87.6,3.5800379545571115,18.16176847720162,698,95.5531620249269,39.58557726829768,0.5068472072626558
21157,"Marshall County, Kentucky",31213,15413,15800,27391,22645,2143,1117,265,85,30679,1189,1029,2218,3201,1574,1627,12759,217,10.13,90,4.699964758273796,10.25534232531317,1467,98.28917438246884,40.87719860314613,0.493800659981418
21159,"Martin County, Kentucky",12478,6922,5556,14914,8719,204,227,95,20,10973,686,650,1336,3538,1605,1933,2592,4,6.77,89.4,2.740823849975958,28.353902869049527,342,87.93877223914089,20.772559705080944,0.5547363359512743
21161,"Mason County, Kentucky",17229,8535,8694,25285,11771,954,707,179,25,16943,1187,797,1984,3446,1614,1832,6976,36,5.95,87.1,5.287596494282895,20.001160833478437,911,98.34000812583434,40.489871727900635,0.4953856869232109
21163,"Meade County, Kentucky",28751,14554,14197,25119,19124,1782,1042,85,22,27779,1543,1493,3036,4426,2010,2416,11822,47,6.96,87.3,3.996382734513582,15.39424715662064,1149,96.61924802615562,41.11856978887691,0.5062084797050538
21165,"Menifee County, Kentucky",6345,3334,3011,19744,4586,341,178,15,28,6268,288,196,484,1495,660,835,2303,0,7.59,86.3,3.4830575256107172,23.5618597320725,221,98.78644602048857,36.2962962962963,0.5254531126871552
21167,"Mercer County, Kentucky",21411,10599,10812,24981,14986,1654,875,82,168,21236,1184,760,1944,3846,1708,2138,9281,11,8.91,87.7,5.254308532997058,17.962729438139274,1125,99.18266311708935,43.34687777310728,0.49502592125542944
21169,"Metcalfe County, Kentucky",9983,4882,5101,18449,6976,387,353,37,21,9887,812,671,1483,2250,883,1367,3766,24,9,88.6,4.116998898126815,22.53831513573074,411,99.03836522087549,37.72413102273865,0.48903135330061104
21171,"Monroe County, Kentucky",10692,5325,5367,21985,7449,638,364,70,73,10524,594,594,1188,2749,1290,1459,3955,23,8.97,88.7,4.741863075196409,25.710811821922935,507,98.4287317620651,36.99027310138421,0.49803591470258135
21173,"Montgomery County, Kentucky",27391,13477,13914,21371,18505,1748,1034,201,84,27039,1940,1504,3444,6777,3164,3613,10773,18,7.12,87.2,4.8154503304004965,24.741703479245007,1319,98.71490635610238,39.33043700485561,0.4920229272388741
21175,"Morgan County, Kentucky",13379,7426,5953,17089,9853,671,362,111,33,11689,586,461,1047,2889,1317,1572,3579,38,6.95,87.1,3.782046490769116,21.59354211824501,506,87.36826369683833,26.750878242021077,0.555048957321175
21177,"Muhlenberg County, Kentucky",31216,15627,15589,20376,21649,1297,1021,270,39,30253,1680,1272,2952,5914,2597,3317,11632,223,13.13,89.1,4.260635571501794,18.945412608918502,1330,96.91504356740133,37.26294208098411,0.5006086622245003
21179,"Nelson County, Kentucky",44875,22161,22714,28156,29822,3156,1457,359,170,44590,1881,1804,3685,6185,2852,3333,20511,43,8.87,87.4,4.4256267409470755,13.782729805013927,1986,99.36490250696379,45.70696378830083,0.49383844011142064
21181,"Nicholas County, Kentucky",7062,3421,3641,21519,4881,218,169,42,84,6964,465,582,1047,1804,840,964,2776,6,6.24,87.4,4.177286887567261,25.54517133956386,295,98.61229113565562,39.30897762673464,0.48442367601246106
21183,"Ohio County, Kentucky",24152,11927,12225,21368,16448,859,467,188,113,23828,1123,979,2102,5003,2150,2853,9046,37,10.42,89,3.1798608810864524,20.714640609473335,768,98.65849619079165,37.45445511758861,0.49383073865518384
21185,"Oldham County, Kentucky",63876,33698,30178,38063,42333,10358,4718,1211,559,59669,1468,1046,2514,3566,1262,2304,29135,169,6.9,87.2,10.15717953534974,5.582691464712881,6488,93.41380174087294,45.61181038261632,0.527553384682823
21187,"Owen County, Kentucky",10673,5240,5433,22802,7315,543,229,54,0,10636,419,507,926,1858,970,888,3891,49,6.09,87.8,2.6515506418064274,17.408413754333363,283,99.65333083481683,36.45647896561417,0.490958493394547
21189,"Owsley County, Kentucky",4552,2037,2515,16582,3136,238,244,55,10,4474,153,286,439,1652,737,915,1264,44,7.46,87.8,6.788224956063269,36.291739894551846,309,98.28646748681898,27.768014059753956,0.4474956063268893
21191,"Pendleton County, Kentucky",14509,7250,7259,23191,9959,697,259,57,12,14412,622,587,1209,2126,902,1224,6331,0,5.94,87.6,2.2606657936453236,14.65297401612792,328,99.33144944517196,43.63498518161141,0.49968984768074987
21193,"Perry County, Kentucky",27818,13624,14194,19890,19511,1244,963,286,230,27171,1454,1509,2963,7394,3091,4303,8389,344,7.7,87.2,5.316701416349127,26.579912287008412,1479,97.67416780501833,30.156733050542815,0.4897548349989216
21195,"Pike County, Kentucky",62791,30796,31995,20576,43893,2958,1748,680,263,62078,2892,2673,5565,15528,6924,8604,20377,196,7.25,88.5,4.28564603207466,24.72965870905066,2691,98.86448694876654,32.452103008392925,0.4904524533770763
21197,"Powell County, Kentucky",12387,6073,6314,19302,8346,537,577,33,33,12146,532,546,1078,3115,1153,1962,4198,27,7.85,87.1,5.1909259707758135,25.14733188019698,643,98.05441188342617,33.890368935173974,0.49027205941713087
21199,"Pulaski County, Kentucky",63772,31166,32606,21036,44608,3881,1839,586,271,62980,3263,2555,5818,15643,7511,8132,24242,280,9.24,86.9,4.227560684940099,24.52957410775889,2696,98.75807564448347,38.01354826569654,0.4887097785862134
21201,"Robertson County, Kentucky",2191,1116,1075,21764,1587,182,58,29,0,2131,41,90,131,520,218,302,836,3,5.66,87.6,3.9707895937927886,23.733455043359196,87,97.26152441807393,38.156093108169785,0.5093564582382474
21203,"Rockcastle County, Kentucky",16893,8257,8636,19750,11828,602,427,117,4,16603,775,658,1433,3875,1718,2157,5949,84,8.6,86,3.2439471970638727,22.938495234712605,548,98.28331261469248,35.21576984549814,0.48878233587876635
21205,"Rowan County, Kentucky",24302,11766,12536,19032,13907,1366,1520,379,441,24080,1606,1233,2839,5510,2446,3064,9791,30,7.02,85.8,9.628837132746275,22.673031026252982,2340,99.08649493868818,40.28886511398239,0.48415768249526786
21207,"Russell County, Kentucky",17684,8652,9032,18857,12424,935,436,156,53,17539,1235,1243,2478,4606,2165,2441,6013,116,11.18,87.8,3.6473648495815425,26.046143406469124,645,99.18004976249718,34.00248812485863,0.4892558244741009
21209,"Scott County, Kentucky",51348,25446,25902,30702,33057,5762,2563,641,429,51090,2025,2222,4247,5309,2253,3056,25972,178,5.8,87.6,7.075251226922178,10.339253719716444,3633,99.49754615564385,50.58035366518657,0.49555971021266654
21211,"Shelby County, Kentucky",44967,21723,23244,30240,30362,4249,2311,438,243,43702,2743,2075,4818,5600,2842,2758,21050,165,8.31,87.2,6.653768318989481,12.453577067627371,2992,97.18682589454488,46.812106655992174,0.48308759757155245
21213,"Simpson County, Kentucky",17856,8800,9056,22663,12174,1069,470,141,47,17509,1086,936,2022,3317,1412,1905,7683,90,11.63,89.6,3.6850358422939067,18.57638888888889,658,98.05667562724014,43.027553763440864,0.492831541218638
21215,"Spencer County, Kentucky",17798,8952,8846,30779,12177,1464,681,97,31,17674,621,507,1128,1782,730,1052,8667,106,9.08,87.4,4.545454545454546,10.012360939431396,809,99.30329250477581,48.696482750870885,0.5029778626812001
21217,"Taylor County, Kentucky",25315,12390,12925,19885,16438,1492,912,287,153,24927,1633,1465,3098,6090,2611,3479,9845,137,8.06,87.8,5.3407070906577125,24.05688327078807,1352,98.46731187043255,38.88998617420501,0.4894331424056883
21219,"Todd County, Kentucky",12465,6230,6235,19555,8082,538,288,95,28,12231,1092,1241,2333,2107,880,1227,4614,50,14.61,89.1,3.2972322503008424,16.903329322101886,411,98.12274368231047,37.01564380264741,0.4997994384275973
21221,"Trigg County, Kentucky",14267,6993,7274,26224,10224,1040,683,63,55,14207,949,920,1869,2262,845,1417,5557,58,15.69,88.5,5.614354804794281,15.854769748370366,801,99.57944907829257,38.9500245321371,0.4901520992500175
21223,"Trimble County, Kentucky",8751,4338,4413,26542,6017,418,230,50,1,8739,662,489,1151,1539,751,788,3593,29,6.31,87.5,3.2110615929608044,17.586561535824476,281,99.86287281453548,41.05816478116787,0.4957147754542338
21225,"Union County, Kentucky",15065,7775,7290,21758,9725,645,432,64,41,14897,968,536,1504,3528,1854,1674,6173,25,9.85,88.9,3.564553601062064,23.418519747759706,537,98.88483239296383,40.97577165615665,0.5160969133753733
21227,"Warren County, Kentucky",121066,59236,61830,25840,73406,12826,6122,1293,1088,119751,6703,4833,11536,21838,9759,12079,56086,450,11.14,90.1,7.023441759040523,18.038094923430194,8503,98.91381560471147,46.326796953727715,0.48928683527992994
21229,"Washington County, Kentucky",12017,5936,6081,22611,8016,532,514,127,15,11891,654,580,1234,2060,1010,1050,5395,43,10.51,87.5,5.458933177997836,17.142381626029792,656,98.95148539568945,44.89473246234501,0.49396688025297497
21231,"Wayne County, Kentucky",20557,10227,10330,17627,14517,695,454,201,0,20268,1308,1027,2335,5138,2394,2744,6513,24,9.34,87.5,3.186262586953349,24.993919346208106,655,98.59415284331371,31.68263851729338,0.49749477063773895
21233,"Webster County, Kentucky",13331,6597,6734,21150,9155,523,242,41,13,13017,666,615,1281,2615,1166,1449,5037,34,12.47,89.2,2.2203885679993998,19.61593278823794,296,97.6445878028655,37.78411221963844,0.4948616007801365
21235,"Whitley County, Kentucky",35842,17637,18205,18463,22896,2341,1258,324,164,35232,2191,1585,3776,9191,4006,5185,12177,58,8.13,87.6,4.871379945315551,25.64310027342224,1746,98.29808604430556,33.97410858769042,0.4920763350259472
21237,"Wolfe County, Kentucky",7221,3516,3705,13533,5018,263,303,18,9,7095,407,371,778,2896,1406,1490,1808,13,7.3,87.1,4.570004154549231,40.105248580529015,330,98.25508932280847,25.038083367954577,0.48691316992106354
21239,"Woodford County, Kentucky",25591,12297,13294,31208,17668,3498,1391,489,253,25463,1198,834,2032,3636,1419,2217,12727,68,6.7,87.8,8.334961509905826,14.208120042202337,2133,99.49982415693017,49.73232777148216,0.48052049548669457
22001,"Acadia Parish, Louisiana",62372,30297,32075,21591,40069,3196,913,244,103,61470,4391,5209,9600,12579,4626,7953,24452,527,20.56,92.6,2.020137241069711,20.16770345667928,1260,98.55383826075803,39.20348874494966,0.4857468094657859
22003,"Allen Parish, Louisiana",25619,14808,10811,20103,17927,1200,666,191,72,21231,1451,1304,2755,3367,1501,1866,8373,227,12.49,92.3,3.6262149186150903,13.142589484367072,929,82.87208712283852,32.68277450329833,0.5780085093094969
22005,"Ascension Parish, Louisiana",117009,58083,58926,31520,74802,14164,4406,934,397,116152,6421,5533,11954,13320,5101,8219,55612,304,21.63,92.7,4.903041646369083,11.38373971232982,5737,99.2675777076977,47.52796793409054,0.49639771299643615
22007,"Assumption Parish, Louisiana",22973,11284,11689,25765,15542,1231,484,41,18,22772,1672,1467,3139,4186,1875,2311,9027,271,18.73,92.5,2.3636442780655553,18.221390327776085,543,99.12505985287076,39.29395377181909,0.49118530448787706
22009,"Avoyelles Parish, Louisiana",41252,20732,20520,20199,27923,1996,677,121,36,37646,3023,3178,6201,8671,3430,5241,14685,202,13.17,92.6,2.021720159022593,21.01958692911859,834,91.25860564336274,35.59827402307767,0.5025695723843693
22011,"Beauregard Parish, Louisiana",36435,18600,17835,24551,24097,2801,850,188,97,35567,3212,2676,5888,6815,3073,3742,14360,486,10.92,92.8,3.115136544531357,18.704542335666254,1135,97.61767531219981,39.41265266913682,0.5104981473857555
22013,"Bienville Parish, Louisiana",13924,6712,7212,22701,9597,803,359,34,48,13598,1081,1012,2093,3406,1304,2102,5104,43,18.86,94.6,3.167193335248492,24.461361677678827,441,97.6587187589773,36.656133295030166,0.4820453892559609
22015,"Bossier Parish, Louisiana",124720,61707,63013,27235,81134,13396,5894,998,780,119149,6999,6803,13802,18867,8289,10578,59582,638,14.9,94.7,6.151379089159718,15.127485567671584,7672,95.533194355356,47.77261064785119,0.494764271969211
22017,"Caddo Parish, Louisiana",253125,120312,132813,25565,167830,25065,9788,3213,1879,248535,17690,18272,35962,55675,23867,31808,106110,776,14.03,95,5.8785185185185185,21.99506172839506,14880,98.18666666666667,41.92,0.47530666666666666
22019,"Calcasieu Parish, Louisiana",197233,96206,101027,26569,129071,17712,6378,1619,843,194872,14314,14038,28352,33266,13630,19636,86127,902,13.1,92.4,4.482008588826414,16.86634589546374,8840,98.80293865631005,43.66764182464395,0.4877784143627081
22021,"Caldwell Parish, Louisiana",9997,5287,4710,20961,6746,545,156,92,0,9522,1140,878,2018,2391,1140,1251,3711,91,14.37,94,2.48074422326698,23.917175152545763,248,95.24857457237171,37.12113634090227,0.5288586575972792
22023,"Cameron Parish, Louisiana",6739,3290,3449,29681,4554,572,175,16,8,6708,345,303,648,601,303,298,3219,84,16.56,90.9,2.9529603798783204,8.918237127170203,199,99.53999109660187,47.766730968986494,0.4882029974773705
22025,"Catahoula Parish, Louisiana",10145,5415,4730,20717,6894,705,155,27,16,9190,1064,1162,2226,1875,810,1065,3592,47,11.49,93.7,1.9517003449975356,18.482010842779694,198,90.58649581074421,35.406604238541156,0.5337604731394776
22027,"Claiborne Parish, Louisiana",16452,9408,7044,16384,11727,1034,379,72,36,14487,1310,950,2260,4367,2163,2204,5025,18,17.96,94.2,2.9601264283977633,26.543885241915877,487,88.05616338439096,30.543398978847556,0.5718453683442742
22029,"Concordia Parish, Louisiana",20288,10295,9993,17551,13544,1095,352,59,21,18203,2064,2746,4810,5794,2517,3277,6892,73,11.16,93.4,2.1293375394321767,28.558753943217667,432,89.72298895899054,33.97082018927445,0.5074428233438486
22031,"De Soto Parish, Louisiana",27047,13053,13994,23471,18273,1769,534,125,32,26871,1737,1815,3552,7097,3186,3911,10523,31,14.07,94.4,2.554811993936481,26.239509002846898,691,99.34928088142863,38.90634820867379,0.48260435538137314
22033,"East Baton Rouge Parish, Louisiana",445337,213365,231972,30162,279129,60586,22403,6640,5839,442423,28272,24079,52351,85171,38045,47126,211782,1052,22.37,92.7,7.832719940180133,19.1250670840285,34882,99.34566407013116,47.55544677401608,0.47910907919171325
22035,"East Carroll Parish, Louisiana",7419,4256,3163,14694,4597,403,77,9,29,5497,483,605,1088,2671,1025,1646,1836,2,15.62,93.6,1.5500741339803208,36.00215662488206,115,74.09354360425934,24.747270521633645,0.5736622186278474
22037,"East Feliciana Parish, Louisiana",19756,10746,9010,21138,14229,1347,332,78,85,16829,928,953,1881,2885,1438,1447,6969,10,22.62,92.6,2.505567928730512,14.603158534116218,495,85.18424782344604,35.27535938449079,0.543936019437133
22039,"Evangeline Parish, Louisiana",33765,17283,16482,18655,21639,1837,549,174,19,31675,2409,2108,4517,8807,3935,4872,10989,100,15.37,92.3,2.197541833259292,26.083222271583,742,93.81015844809714,32.545535317636606,0.5118613949355841
22041,"Franklin Parish, Louisiana",20464,9963,10501,18786,13515,1084,466,29,28,19093,1889,1868,3757,6017,2431,3586,6801,170,13.78,94.6,2.555707584050039,29.40285379202502,523,93.30043002345583,33.23397185301016,0.4868549648162627
22043,"Grant Parish, Louisiana",22372,12543,9829,18509,15717,1028,344,50,45,18919,1183,1125,2308,3590,1489,2101,6966,162,10.93,93.1,1.962274271410692,16.046844269622742,439,84.56552833899518,31.13713570534597,0.5606561773645629
22045,"Iberia Parish, Louisiana",73799,36031,37768,23410,47452,4590,1285,366,281,72994,5613,5540,11153,14437,6001,8436,30547,431,21.49,90.8,2.617921652054906,19.562595699128714,1932,98.90919931164379,41.39215978536294,0.4882315478529519
22047,"Iberville Parish, Louisiana",33159,16812,16347,22252,22836,2101,697,111,148,29615,2054,1549,3603,5465,2196,3269,12841,132,18.44,92.2,2.883078500557918,16.48119665852408,956,89.31210229500286,38.725534545673874,0.5070116710395368
22049,"Jackson Parish, Louisiana",15999,8165,7834,20109,11210,988,376,95,71,14833,1066,913,1979,4035,1783,2252,5279,88,20.15,94.6,3.387711731983249,25.2203262703919,542,92.71204450278142,32.99581223826489,0.5103443965247828
22051,"Jefferson Parish, Louisiana",435204,211528,223676,28839,302942,50473,15723,6286,2697,431964,35743,28924,64667,69402,29275,40127,205709,2015,10.85,92,5.6768779698716,15.947004163564673,24706,99.25552154851518,47.267258572991054,0.486043326807658
22053,"Jefferson Davis Parish, Louisiana",31399,15351,16048,23068,20659,1922,898,156,29,30881,1627,2038,3665,6020,2503,3517,12562,407,17.29,92.3,3.449154431669798,19.17258511417561,1083,98.35026593203605,40.007643555527245,0.4889009204114781
22055,"Lafayette Parish, Louisiana",234963,114864,120099,30656,153993,33204,9855,2761,1742,232644,15514,15604,31118,37976,16279,21697,116412,1098,22.13,92.4,6.110749352025638,16.162544741086894,14358,99.01303609504475,49.54482195069011,0.48885994816205103
22057,"Lafourche Parish, Louisiana",97688,47946,49742,26331,65045,7288,2223,498,501,96839,6552,6996,13548,14646,6215,8431,41984,1817,12.73,91.5,3.2982556711162068,14.992629596265662,3222,99.13090655965932,42.97764310867251,0.4908074686757841
22059,"LaSalle Parish, Louisiana",14927,7767,7160,18836,10142,801,258,33,28,13599,1011,930,1941,3134,1340,1794,4970,127,11.99,93.4,2.137067059690494,20.995511489247672,319,91.10336973269914,33.2953708045823,0.5203322837810679
22061,"Lincoln Parish, Louisiana",47480,23134,24346,21934,25500,5191,2647,399,781,46855,3759,3371,7130,13916,6304,7612,20612,136,21.19,94.8,8.060235888795281,29.309182813816342,3827,98.68365627632687,43.41196293176074,0.4872367312552654
22063,"Livingston Parish, Louisiana",135925,66559,69366,27280,88415,11335,3038,539,472,134939,9414,8837,18251,19472,7831,11641,60383,432,22.95,93,2.9788486297590584,14.325547176751884,4049,99.27459996321501,44.423763104653304,0.4896744528232481
22065,"Madison Parish, Louisiana",11803,5884,5919,15134,7756,576,282,39,35,10182,1434,1527,2961,3973,1760,2213,3785,65,12.71,94.8,3.016182326527154,33.66093366093366,356,86.26620350758282,32.068118275014825,0.498517326103533
22067,"Morehouse Parish, Louisiana",26739,12774,13965,18776,17919,1840,336,190,81,25966,2188,1952,4140,7441,3181,4260,9577,105,21.73,93.5,2.2700923744343466,27.828265828939003,607,97.10909158906466,35.8165974793373,0.47772915965443735
22069,"Natchitoches Parish, Louisiana",39258,18654,20604,18219,23294,2588,1337,196,246,38546,2867,3285,6152,11401,4965,6436,13587,378,12.77,94.7,4.5315604462784655,29.041214529522644,1779,98.18635692088237,34.609506342656275,0.47516429772275715
22071,"Orleans Parish, Louisiana",382922,182959,199963,29275,265166,54907,24396,11236,5391,377073,28794,24664,53458,97252,42376,54876,171776,1990,9.67,91.5,10.71314784734228,25.397339405936457,41023,98.47253487655449,44.859266378009096,0.477797044828973
22073,"Ouachita Parish, Louisiana",156398,74967,81431,22538,99811,15723,6379,1310,724,150403,12265,12725,24990,35652,14120,21532,63077,369,22.76,93.9,5.3792247982710775,22.79568792439801,8413,96.16683077788718,40.331078402537116,0.4793347741019706
22075,"Plaquemines Parish, Louisiana",23584,11585,11999,26177,15232,1694,578,88,48,22726,1553,1239,2792,3990,1491,2499,10462,154,11.07,90.3,3.0274762550881955,16.918249660786973,714,96.36194029850746,44.36058344640434,0.4912228629579376
22077,"Pointe Coupee Parish, Louisiana",22366,10791,11575,27160,15406,1484,475,160,28,22241,1866,1580,3446,4182,1818,2364,8843,258,19.22,92.3,2.9643208441384243,18.698023786103906,663,99.44111597961191,39.53769113833497,0.48247339712062953
22079,"Rapides Parish, Louisiana",132373,63960,68413,23486,86793,11037,4180,1228,786,129620,9231,8458,17689,25882,11560,14322,52733,866,12.75,92.8,4.67920195205971,19.552325625316342,6194,97.92027075007744,39.836673641905826,0.48318010470413153
22081,"Red River Parish, Louisiana",8757,4230,4527,25154,5767,504,230,15,32,8635,714,668,1382,1953,831,1122,3258,134,17.29,94.7,3.163183738723307,22.302158273381295,277,98.60682882265615,37.20452209660843,0.4830421377183967
22083,"Richland Parish, Louisiana",20692,10072,10620,19975,13681,1220,477,139,45,19873,2793,2144,4937,4751,2122,2629,7615,92,20.42,94.1,3.1944712932534314,22.96056446936014,661,96.04194857916103,36.80166247825247,0.4867581674076938
22085,"Sabine Parish, Louisiana",24144,12018,12126,22980,16392,1464,609,137,61,23745,2019,1782,3801,4612,1886,2726,8226,243,11.54,94.7,3.342445328031809,19.102054340622928,807,98.34741550695826,34.07057654075547,0.4977634194831014
22087,"St. Bernard Parish, Louisiana",44091,21801,22290,20431,28135,2884,583,160,94,43760,3034,2492,5526,8784,3775,5009,17518,246,10.13,90.5,1.8983466013472137,19.92243314962237,837,99.24927989839196,39.731464471207275,0.4944546506089678
22089,"St. Charles Parish, Louisiana",52708,25783,26925,30378,34706,5320,1623,104,122,52063,3453,3217,6670,6522,2638,3884,24021,309,12.26,92.9,3.508006374743872,12.37383319420202,1849,98.77627684601958,45.57372694847082,0.48916672990817334
22091,"St. Helena Parish, Louisiana",10714,5205,5509,21148,7183,370,282,84,25,10582,1251,934,2185,2895,1303,1592,3565,58,21.98,93.1,3.6494306514840398,27.020720552548067,391,98.76796714579055,33.274220645883894,0.4858129550121337
22093,"St. James Parish, Louisiana",21581,10403,11178,25724,14516,1544,467,34,50,21366,1405,1365,2770,3496,1431,2065,8987,141,18.71,92.9,2.553171771465641,16.19943468791993,551,99.00375330151522,41.643111996663734,0.48204439089940226
22095,"St. John the Baptist Parish, Louisiana",43888,21472,22416,23380,28685,3488,895,294,165,43206,3148,2501,5649,7851,3463,4388,18763,325,14.84,93.2,3.085125774699234,17.888716733503465,1354,98.44604447685016,42.752005103900835,0.4892453518045935
22097,"St. Landry Parish, Louisiana",83699,40138,43561,19205,53830,4811,1688,421,160,82634,5603,6016,11619,23007,9893,13114,30208,233,17.91,92.2,2.710904550830954,27.487783605538894,2269,98.7275833641979,36.09123167540831,0.47955172702182824
22099,"St. Martin Parish, Louisiana",53385,26391,26994,23654,35313,3617,972,125,156,53131,3703,3549,7252,9103,3976,5127,23298,278,19.58,92,2.347101245668259,17.051606256439076,1253,99.5242109206706,43.64147232368643,0.494352346164653
22101,"St. Mary Parish, Louisiana",53053,26204,26849,22212,35182,2680,895,254,35,52200,4528,4027,8555,11227,4911,6316,20730,471,15.88,90.8,2.231730533617326,21.161857010913614,1184,98.39217386387197,39.07413341375606,0.4939211731664562
22103,"St. Tammany Parish, Louisiana",246269,119732,126537,33149,166729,34080,11518,4415,2151,243764,14481,13871,28352,27094,11561,15533,110944,1799,10.58,92.6,7.34318976403851,11.001790724776566,18084,98.98281959970602,45.049925081922616,0.48618380713772336
22105,"Tangipahoa Parish, Louisiana",127115,61684,65431,23520,81365,11043,3621,815,626,126309,10126,9146,19272,27460,12106,15354,53527,1008,20.2,93.2,3.982220823663612,21.602485937930222,5062,99.36592848995005,42.109113794595444,0.48526137749282144
22107,"Tensas Parish, Louisiana",4793,2335,2458,16194,3259,218,67,0,11,4774,772,571,1343,1615,773,842,1658,25,12.06,94.2,1.6273732526601294,33.69497183392447,78,99.60358856665971,34.59211349885249,0.4871687878155644
22109,"Terrebonne Parish, Louisiana",113099,55881,57218,24017,73521,7831,1911,626,152,111803,9785,8826,18611,22457,9871,12586,47783,1025,12.7,91.6,2.3775630200090188,19.856055314370597,2689,98.85410127410499,42.248826249568964,0.4940892492418147
22111,"Union Parish, Louisiana",22460,11100,11360,20742,15527,1326,435,68,53,22009,1356,1726,3082,5438,2343,3095,8189,57,20.47,94.2,2.4755120213713266,24.21193232413179,556,97.9919857524488,36.460373998219055,0.4942119323241318
22113,"Vermilion Parish, Louisiana",59524,28756,30768,23608,38826,3561,958,122,141,59075,4113,3677,7790,10150,4176,5974,24528,390,23.52,91.1,2.051273435925005,17.051945433774613,1221,99.24568241381627,41.20690813789396,0.48309925408238696
22115,"Vernon Parish, Louisiana",52101,27428,24673,22583,31138,3973,1207,234,120,46796,3012,2430,5442,7286,3272,4014,22200,262,9.98,93.5,2.996103721617627,13.984376499491372,1561,89.81785378399647,42.60954684171129,0.5264390318803862
22117,"Washington Parish, Louisiana",46367,22871,23496,18345,31312,2548,927,149,109,44576,3465,3721,7186,11756,5345,6411,15433,245,16.35,92.9,2.5556969396337914,25.354239006189747,1185,96.13733905579399,33.2844479910281,0.4932602928807126
22119,"Webster Parish, Louisiana",40335,19558,20777,19256,27591,2889,739,119,93,39416,3434,3146,6580,9693,4261,5432,14841,69,17.2,94.4,2.357753811825958,24.0312383785794,951,97.72158175282013,36.79434734101897,0.4848890541713152
22121,"West Baton Rouge Parish, Louisiana",25017,12436,12581,28140,16661,2238,759,194,87,24331,1520,1054,2574,4933,2119,2814,11479,104,20.35,92.5,4.157173122276852,19.718591357876644,1040,97.25786465203662,45.88479833713075,0.4971019706599512
22123,"West Carroll Parish, Louisiana",11370,5750,5620,22857,7752,602,294,62,2,10633,1546,1564,3110,2551,1015,1536,3797,74,18.91,93.6,3.148636763412489,22.43623570800352,358,93.51802990325417,33.39489885664028,0.5057167985927881
22125,"West Feliciana Parish, Louisiana",15384,9325,6059,23041,10595,1497,639,121,125,12343,622,770,1392,1923,765,1158,5099,10,20.87,92.1,5.752730109204368,12.5,885,80.23270930837234,33.14482579303172,0.6061492459698388
22127,"Winn Parish, Louisiana",14695,7735,6960,18417,10186,785,369,99,35,12959,1114,1121,2235,3319,1418,1901,5078,28,14.9,94.1,3.4229329703980946,22.585913576046273,503,88.18645797890439,34.55597141884995,0.5263695134399455
23001,"Androscoggin County, Maine",107376,52566,54810,26276,74194,10309,3592,974,486,106345,5262,3935,9197,15370,7028,8342,52190,202,6.49,81.7,4.704962002682164,14.314185665325585,5052,99.03982267918343,48.604902399046345,0.4895507375949933
23003,"Aroostook County, Maine",69405,34255,35150,23631,50858,6495,1919,449,339,68334,3691,2785,6476,11929,5510,6419,29996,304,5.08,76.6,3.9002953677688925,17.187522512787265,2707,98.45688350983359,43.21878827173835,0.4935523377278294
23005,"Cumberland County, Maine",288204,140167,148037,36780,205616,57284,22921,6886,3495,284982,12120,9233,21353,31192,14325,16867,152389,947,7.22,81.9,11.555009645945233,10.822889342271447,33302,98.88204188699672,52.87539381826762,0.4863464768011547
23007,"Franklin County, Maine",30270,14841,15429,24162,21515,3671,1381,211,279,30119,1638,1647,3285,4089,1819,2270,14040,68,4.95,76.2,6.181037330690453,13.508424182358771,1871,99.50115626032375,46.382556987115954,0.4902874132804757
23009,"Hancock County, Maine",54483,26530,27953,31178,40820,8103,3663,708,798,54042,3895,3089,6984,6420,2729,3691,25550,250,5.28,80,9.487363030670117,11.783492098452728,5169,99.19057320632123,46.89536185599178,0.486940880641668
23011,"Kennebec County, Maine",120953,58816,62137,27336,86359,13097,6304,1252,1165,119555,5886,4242,10128,17110,7727,9383,55717,509,4.95,81.1,7.210238687754748,14.145990591386736,8721,98.84417914396501,46.06500045472208,0.4862715269567518
23013,"Knox County, Maine",39717,19601,20116,29806,29796,5860,2253,525,368,38590,2664,2138,4802,4577,2318,2259,18831,121,6.22,78.2,7.92104136767631,11.524032530150818,3146,97.16242415086738,47.412946597175015,0.4935166301583705
23015,"Lincoln County, Maine",34165,16771,17394,31522,25993,4903,2580,434,517,33658,2194,1635,3829,4050,1881,2169,16306,180,5.49,79.5,10.335138299429241,11.854236792038636,3531,98.51602517195961,47.72720620518074,0.49088248207229623
23017,"Oxford County, Maine",57299,28391,28908,22862,41822,4971,2149,309,162,56958,3301,2990,6291,9447,4072,5375,24346,80,4.92,78.8,4.572505628370478,16.487198729471718,2620,99.4048761758495,42.489397720728114,0.49548857746208486
23019,"Penobscot County, Maine",152978,75521,77457,26347,106526,17025,6213,1371,1736,151304,8666,7240,15906,23793,10748,13045,71346,840,4.39,79.3,6.092379296369413,15.553216802416033,9320,98.90572500621005,46.63807867797984,0.49367229274797686
23021,"Piscataquis County, Maine",17044,8470,8574,23464,12999,1466,510,88,59,16910,1167,999,2166,3448,1566,1882,6417,29,4.87,76.7,3.8547289368692796,20.2299929593992,657,99.21379957756395,37.64961276695611,0.4969490729875616
23023,"Sagadahoc County, Maine",35134,17052,18082,32947,25868,5637,2248,450,328,34981,1541,1173,2714,3718,1554,2164,17677,116,6.02,81,8.612739796208801,10.582341891045711,3026,99.56452439232652,50.31308703819662,0.4853418341207947
23025,"Somerset County, Maine",51363,25361,26002,22641,37544,4106,1273,394,169,50873,3333,2434,5767,9118,4212,4906,21809,338,4.91,76.6,3.5745575608901348,17.75207834433347,1836,99.04600587971886,42.4605260596149,0.49376009968265094
23027,"Waldo County, Maine",39071,19311,19760,27763,28494,5238,2375,366,336,38861,2413,2213,4626,6097,2757,3340,17776,181,5.44,79.9,7.875406311586599,15.604924368457423,3077,99.46251695631031,45.49665992679993,0.49425405031865066
23029,"Washington County, Maine",31925,15779,16146,24311,23457,3089,1149,260,216,31349,2164,1808,3972,5561,2372,3189,12591,117,5.12,78.4,5.090054815974941,17.418950665622553,1625,98.19577133907596,39.43931088488645,0.49425215348472984
23031,"York County, Maine",200536,97912,102624,33635,145205,29182,10679,1978,1817,198742,10003,7224,17227,18486,7674,10812,102135,682,6.59,82.2,7.217656680097339,9.21829496948179,14474,99.10539753460725,50.931004906849644,0.48825148601747315
24001,"Allegany County, Maryland",73060,38077,34983,22355,50793,4733,3378,478,535,67674,2707,1872,4579,11430,5531,5899,28727,179,5.58,87.5,6.010128661374213,15.64467560908842,4391,92.6279770052012,39.31973720229948,0.5211743772241992
24003,"Anne Arundel County, Maryland",559737,276842,282895,43258,382657,88157,46830,9325,6321,538865,18458,13790,32248,33168,13982,19186,293520,2166,6.07,89.5,11.161670570285688,5.92564007739349,62476,96.2711058943754,52.43891327534181,0.4945929963536447
24005,"Baltimore County, Maryland",825666,391102,434564,37270,569088,121891,62727,16515,10559,817420,33410,26823,60233,74876,31332,43544,408917,3773,5.81,88.2,10.876189645692083,9.06855798833911,89801,99.00129107895928,49.52571620970223,0.4736806408402429
24009,"Calvert County, Maryland",90527,44966,45561,41469,60627,10038,6028,1025,664,89333,3046,2281,5327,5400,2178,3222,44872,385,8.32,88.8,8.524528593679234,5.9650711942293455,7717,98.68105648038707,49.567532338418374,0.4967136876291051
24011,"Caroline County, Maryland",32653,15822,16831,25355,22037,2112,1046,126,87,32278,1884,1363,3247,5484,2276,3208,15162,200,8.19,90,3.8556947294276176,16.794781490215293,1259,98.85156034667565,46.433712063210116,0.4845496585306098
24013,"Carroll County, Maryland",167535,82892,84643,39690,114734,24569,11083,1910,1105,165565,4179,3070,7249,9383,4159,5224,86900,290,5.87,87.2,8.414958068463307,5.600620765810129,14098,98.82412630196676,51.86975855791327,0.4947742262810756
24015,"Cecil County, Maryland",102175,50603,51572,32542,69319,9415,4613,715,848,101030,3959,3148,7107,10729,5025,5704,48948,327,5.15,87.5,6.044531441154882,10.50061169562026,6176,98.87937362368486,47.906043552728164,0.49525813555174947
24017,"Charles County, Maryland",154357,74489,79868,38890,101706,16756,9113,1109,852,151456,3810,2864,6674,11637,4529,7108,77928,375,8.14,89.9,7.174277810530135,7.53901669506404,11074,98.12059057898249,50.48556268909088,0.48257610603989454
24019,"Dorchester County, Maryland",32451,15519,16932,28911,23113,2928,1416,295,161,32019,1114,968,2082,5435,2310,3125,14819,84,9.15,89.9,5.768697420726634,16.74832824874426,1872,98.66876213367847,45.66577301161752,0.4782287140612
24021,"Frederick County, Maryland",243465,120072,123393,39566,163563,38413,19600,3220,3761,241125,8009,6657,14666,16995,7451,9544,127027,772,5.79,87.5,10.917791058262996,6.9804694719980285,26581,99.03887622450866,52.174645226213215,0.4931797178239172
24023,"Garrett County, Maryland",29677,14701,14976,26303,21250,2205,1414,246,224,29195,1413,1177,2590,3666,1627,2039,13790,59,6.39,82,6.348350574518988,12.353000640226439,1884,98.3758466152239,46.466960946187285,0.4953667823567072
24025,"Harford County, Maryland",249776,122076,127700,37972,171128,35441,18683,2478,2380,246870,6555,4704,11259,19012,7860,11152,127349,660,5.03,87.6,9.424844660816092,7.611620011530331,23541,98.8365575555698,50.98528281340081,0.48874191275382745
24027,"Howard County, Maryland",308447,151100,157347,51045,207335,62207,44000,10545,9814,305577,8139,7571,15710,15109,6277,8832,164257,1156,6.86,88,20.865497151860772,4.898410423832944,64359,99.06953220488447,53.252908927627765,0.48987346286396044
24029,"Kent County, Maryland",19819,9539,10280,32217,13928,2299,1230,348,377,19464,746,530,1276,2193,1051,1142,8919,68,6.35,89,9.86427165850951,11.06513951258893,1955,98.20878954538574,45.00227054846359,0.48130581764973007
24031,"Montgomery County, Maryland",1026371,494612,531759,51162,703977,186973,134785,45074,42217,1017915,50085,44164,94249,69889,28788,41101,537814,3248,5.99,88,21.63701039877393,6.809331128802353,222076,99.17612637145827,52.39957091539024,0.4819037170769634
24033,"Prince George's County, Maryland",897693,431752,465941,34391,597885,107860,61867,8844,9489,890902,65256,49268,114524,84744,37050,47694,462632,2823,5.89,89.5,8.934011961773123,9.440198375168348,80200,99.2435052963541,51.535658627169866,0.4809572983191358
24035,"Queen Anne's County, Maryland",48712,24151,24561,40553,34080,7229,3360,822,508,48165,1336,1063,2399,3139,1557,1582,25058,210,6.63,89.3,9.628017736902612,6.443997372310724,4690,98.87707341106915,51.44112333716538,0.4957915913943176
24037,"St. Mary's County, Maryland",110675,55176,55499,37528,72507,12584,7373,935,789,108002,3571,2956,6527,8440,3402,5038,55157,281,8.61,89.4,8.219561779986448,7.6259317822453125,9097,97.58482042014909,49.836909871244636,0.4985407725321888
24039,"Somerset County, Maryland",25899,13936,11963,18395,16959,1356,771,123,120,21455,917,1043,1960,4826,1896,2930,8013,123,13.15,89.4,3.9152090814317155,18.633924089733195,1014,82.84103633344917,30.939418510367197,0.5380902737557435
24041,"Talbot County, Maryland",37668,17733,19935,44785,28138,5392,3037,891,763,37276,1418,1169,2587,4064,1617,2447,17383,95,6.59,89.6,12.45354146755867,10.788998619517892,4691,98.95932887331422,46.147923967293195,0.47077094616119786
24043,"Washington County, Maryland",149571,76043,73528,28742,103724,12720,6500,1003,623,141178,6186,4933,11119,18166,7570,10596,65935,346,5.26,88.2,5.432871345381123,12.145402517867769,8126,94.38861811447406,44.08274331254053,0.5084073784356593
24045,"Wicomico County, Maryland",101527,48364,53163,27755,63454,9966,5279,1004,1123,100239,5204,3904,9108,15924,7004,8920,47925,319,12.99,89.6,7.294611285667852,15.684497719818374,7406,98.73137195031863,47.204191988338074,0.4763658928166892
24047,"Worcester County, Maryland",51441,24999,26442,34425,38616,7325,3098,754,383,50790,2337,1633,3970,5162,2237,2925,23365,225,13.46,88.5,8.232732645166307,10.034797146245213,4235,98.73447250247857,45.42096771058105,0.48597422289613346
24510,"Baltimore city, Maryland",621000,292168,328832,28488,422021,66163,38436,12068,8756,611099,31120,24075,55195,137964,60287,77677,270104,2384,6.17,90,9.542673107890499,22.216425120772946,59260,98.40563607085346,43.495008051529794,0.47047987117552337
25001,"Barnstable County, Massachusetts",214703,102542,112161,40886,164809,39130,20786,4372,3442,212428,4233,3274,7507,17433,7650,9783,101171,790,6.54,82.2,13.320726771400492,8.119588454749119,28600,98.94039673409314,47.12137231431326,0.47759928831921306
25003,"Berkshire County, Massachusetts",128563,62125,66438,33245,92918,17122,9444,2263,1493,126319,2437,1401,3838,15136,6625,8511,62119,472,4.95,81.7,10.267339747827913,11.773216244176007,13200,98.25455224286925,48.3179452875244,0.48322612260137054
25005,"Bristol County, Massachusetts",554868,268739,286129,32406,383924,64704,28565,4911,3633,548298,11649,7257,18906,67338,29240,38098,266778,1196,5.63,85.5,6.687896941254497,12.135859339518587,37109,98.81593460066178,48.079543242717186,0.4843296063207826
25007,"Dukes County, Massachusetts",17137,8231,8906,42956,12726,3058,1292,459,254,17027,844,423,1267,1544,701,843,8227,21,6.74,82.8,11.699830775514968,9.009744996207038,2005,99.35811402229095,48.0072358055669,0.48030577113847234
25009,"Essex County, Massachusetts",769362,370538,398824,38604,527506,119624,60568,12688,7785,762048,16568,9828,26396,84757,35734,49023,382711,5815,6.66,84.3,10.533532979273735,11.016530579883073,81041,99.04934218222371,49.74394368320765,0.4816172360995214
25011,"Franklin County, Massachusetts",70916,34721,36195,33010,52404,9749,6943,858,1263,70143,1167,801,1968,7881,3601,4280,36408,220,4.79,84.3,12.781318743301934,11.113147949686953,9064,98.90997800214338,51.33961306334255,0.48960742286648995
25013,"Hampden County, Massachusetts",468072,225908,242164,28072,311830,48953,25138,5147,2569,462740,10422,5851,16273,80119,35147,44972,210668,1839,5.06,85.5,7.019005623066537,17.11681108889231,32854,98.86085901314328,45.007605667504144,0.48263515014784053
25015,"Hampshire County, Massachusetts",161035,75315,85720,32198,98409,21496,14792,2910,4813,159618,2551,2047,4598,20315,9692,10623,81188,380,4.96,85,13.981432607818176,12.615269972366256,22515,99.12006706616575,50.41636911230478,0.4676933585866427
25017,"Middlesex County, Massachusetts",1567610,765170,802440,47616,1092070,290215,195353,41669,51610,1552097,27861,17900,45761,124652,55065,69587,832827,5590,6.08,86.6,18.41223263439248,7.951722686127289,288632,99.01040437353679,53.127180867690306,0.4881124769553652
25019,"Nantucket County, Massachusetts",10694,5728,4966,47924,7785,1843,1102,244,82,10643,443,164,607,1083,652,431,6165,12,6.88,79.9,13.353282214325791,10.127174116326913,1428,99.52309706377407,57.649149055545166,0.5356274546474659
25021,"Norfolk County, Massachusetts",691218,331220,359998,49816,481812,135256,74648,21333,15489,682577,8253,6414,14667,45372,18102,27270,353547,1977,6.5,86.6,16.126605499278085,6.564065171913926,111470,98.74988787907722,51.14840759355225,0.47918312312468714
25023,"Plymouth County, Massachusetts",506657,246500,260157,39247,348844,78494,33129,6990,3544,499437,8338,6011,14349,39602,16768,22834,252517,1637,6.14,85.5,8.617861788152537,7.816333337938684,43663,98.57497281198128,49.83983247048793,0.48652244023076757
25025,"Suffolk County, Massachusetts",767719,371314,396405,38031,522045,124874,64123,20095,13930,760729,21457,12382,33839,145744,62450,83294,403630,3396,6.42,86.3,12.784365112756099,18.984029312808463,98148,99.08951061521208,52.57522609183829,0.48365873451093433
25027,"Worcester County, Massachusetts",813589,401320,412269,34691,552915,117602,56110,9921,8926,801421,14737,9445,24182,89860,39518,50342,401840,3327,5.23,84.3,9.213128496083403,11.044888758328836,74957,98.5044045580754,49.39103158966014,0.4932711725453515
26001,"Alcona County, Michigan",10461,5277,5184,24463,8552,789,306,91,50,10361,491,425,916,1536,711,825,3234,54,4.17,82.1,4.273014052193863,14.683108689417837,447,99.04406844469936,30.914826498422713,0.504445081732148
26003,"Alger County, Michigan",9396,5167,4229,21771,7245,925,315,19,52,8415,452,394,846,1096,584,512,3163,14,5.32,77.5,4.108131119625373,11.66453810131971,386,89.55938697318008,33.663260962111536,0.5499148573861218
26005,"Allegan County, Michigan",113666,56627,57039,27172,76426,11004,4182,648,536,112938,4812,3829,8641,13093,5870,7223,51808,266,6.77,83.6,4.720848802632274,11.518835887600513,5366,99.35952703534917,45.579152956908835,0.4981876726549716
26007,"Alpena County, Michigan",28929,14258,14671,24030,21150,2157,1058,244,89,28579,1532,1303,2835,4615,2014,2601,12208,77,4.44,82.4,4.808323827301324,15.952850081233365,1391,98.79014138062152,42.19986864392133,0.492861834145667
26009,"Antrim County, Michigan",23215,11544,11671,29307,17290,2859,1374,229,152,23049,1125,1017,2142,2962,1274,1688,9373,63,4.53,82,7.559767391772561,12.758992031014431,1755,99.28494507861296,40.37475769976309,0.49726469954770625
26011,"Arenac County, Michigan",15327,7751,7576,22622,11426,789,443,45,24,15181,884,548,1432,2897,1434,1463,5643,60,4.94,82.8,3.340510210739218,18.901285313499056,512,99.0474326352189,36.81738109219025,0.5057088797546813
26013,"Baraga County, Michigan",8612,5262,3350,18975,6422,638,259,68,40,6418,206,279,485,947,409,538,2360,17,5.74,77,4.261495587552253,10.996284254528565,367,74.52392011147236,27.403622851834648,0.6110078959591267
26015,"Barry County, Michigan",59316,29844,29472,27166,41144,5060,2209,336,178,58893,1983,1823,3806,5461,2482,2979,26797,82,9.15,83.4,4.590666936408389,9.206622159282487,2723,99.28687032166701,45.17668082810709,0.503135747521748
26017,"Bay County, Michigan",106107,52254,53853,25462,74904,9256,3217,661,434,105145,4641,3160,7801,16515,8018,8497,45530,229,5.76,83.4,4.063822367987032,15.564477367185955,4312,99.0933680153053,42.909515866059735,0.49246515310017247
26019,"Benzie County, Michigan",17462,8709,8753,26790,13009,1926,1066,206,136,17272,1161,700,1861,1926,926,1000,7530,64,4.43,81.4,8.063222998511053,11.029664414156453,1408,98.91192303287137,43.122208223571185,0.49874012140648266
26021,"Berrien County, Michigan",155134,75899,79235,27505,106865,16937,8736,1818,1109,153951,8661,6918,15579,26963,11661,15302,68394,543,10.63,83.3,7.518016682352031,17.38045818453724,11663,99.23743344463496,44.08704732682713,0.48924800495055887
26023,"Branch County, Michigan",43603,22540,21063,22977,29903,2769,1007,185,114,41585,2692,2273,4965,7368,3649,3719,18342,151,6.38,83.6,2.9952067518290026,16.897919867899,1306,95.37187808178336,42.06591289590166,0.5169369080109166
26025,"Calhoun County, Michigan",134691,65829,68862,24859,90994,12668,4913,765,536,133025,6079,5024,11103,22245,10082,12163,56724,261,8.19,83,4.613522804047784,16.515580105574983,6214,98.76309478732803,42.11417243913847,0.48874089582822905
26027,"Cass County, Michigan",51795,26062,25733,28019,36542,4232,1672,280,165,51672,2992,2193,5185,7636,3690,3946,22059,128,10.17,83.6,4.087267110724974,14.742735785307461,2117,99.76252534028382,42.58905299739357,0.5031759822376677
26029,"Charlevoix County, Michigan",26172,12905,13267,31730,19033,3196,1608,406,214,25913,1268,985,2253,3208,1420,1788,11615,39,4.51,81.4,8.512914565184166,12.257374293137705,2228,99.0103927861837,44.37948953079627,0.4930842121351062
26031,"Cheboygan County, Michigan",25579,12719,12860,24956,19223,2229,1041,153,87,25264,1627,1370,2997,4704,2055,2649,10056,64,4.23,80.9,5.0080143868016735,18.390085617107783,1281,98.76852105242581,39.3134993549396,0.4972438328316197
26033,"Chippewa County, Michigan",38330,21209,17121,21958,26407,3383,1284,237,301,34490,1984,1526,3510,5995,3052,2943,15013,85,5.58,78,4.753456822332376,15.64049047743282,1822,89.981737542395,39.16775371771458,0.5533263762066266
26035,"Clare County, Michigan",30608,15126,15482,21198,22225,1644,759,89,35,30276,2161,1832,3993,7289,3248,4041,10470,101,4.58,83.1,2.8848667015159437,23.814035546262414,883,98.91531625718767,34.2067433350758,0.4941845269210664
26037,"Clinton County, Michigan",77245,38180,39065,32792,52058,10330,3814,1050,794,76624,2564,1596,4160,8665,3916,4749,36170,171,7.31,84.5,7.32474593824843,11.217554534274063,5658,99.19606447019224,46.825037219237494,0.49427147388180465
26039,"Crawford County, Michigan",13840,6983,6857,22891,10325,1120,411,145,46,13648,528,561,1089,2326,1052,1274,5136,58,4.45,81.6,4.3497109826589595,16.80635838150289,602,98.61271676300578,37.10982658959538,0.5045520231213872
26041,"Delta County, Michigan",36570,18088,18482,25582,26485,3824,1160,321,145,36176,1838,1596,3434,5961,2782,3179,15371,140,4.35,79.1,4.446267432321575,16.300246103363413,1626,98.92261416461581,42.031719989062076,0.49461307082307904
26043,"Dickinson County, Michigan",25889,12837,13052,25998,18806,3058,939,292,112,25525,1213,781,1994,3720,1585,2135,10930,67,4.3,80.8,5.187531383985476,14.369037042759473,1343,98.59399745065471,42.218702924021784,0.4958476573061918
26045,"Eaton County, Michigan",108544,52977,55567,30064,75109,12563,4881,938,566,107860,4205,3212,7417,11895,5237,6658,51356,250,9.21,83.5,5.882407134433962,10.958689563679245,6385,99.3698408018868,47.31353183962264,0.48806935436320753
26047,"Emmet County, Michigan",33091,16364,16727,31356,23718,4889,2072,586,252,32758,1727,1369,3096,3426,1555,1871,15613,150,4.29,79.2,8.793931884802515,10.353268260252031,2910,98.99368408328549,47.18201323622737,0.4945151249584479
26049,"Genesee County, Michigan",413090,199181,213909,25180,278481,34598,16045,3184,1600,410606,18007,12978,30985,85283,38516,46767,160220,855,5.35,84.8,5.042242610569126,20.645137863419595,20829,99.39867825413349,38.78573676438548,0.48217337626183154
26051,"Gladwin County, Michigan",25367,12741,12626,23491,18727,1485,887,114,22,25177,1758,1396,3154,5099,2290,2809,8573,148,4.32,83.9,4.032798517759294,20.100918516182443,1023,99.25099538770844,33.79587653250286,0.5022667244845666
26053,"Gogebic County, Michigan",15650,8425,7225,22297,11901,1395,527,102,64,14223,877,744,1621,2908,1360,1548,5716,41,5.51,77.6,4.4281150159744405,18.5814696485623,693,90.8817891373802,36.52396166134185,0.5383386581469649
26055,"Grand Traverse County, Michigan",90715,44604,46111,31701,64721,12375,5735,1588,800,88868,4123,3391,7514,8649,4105,4544,44301,406,4.09,82.3,8.954417681750538,9.534255635782396,8123,97.96395303973985,48.835363501074795,0.4916937661908174
26057,"Gratiot County, Michigan",41676,22119,19557,20597,28260,2488,1201,143,196,37373,1680,1373,3053,6807,2907,3900,15560,112,5.85,84.3,3.6951722814089645,16.333141376331703,1540,89.67511277473845,37.33563681735291,0.5307371148862655
26059,"Hillsdale County, Michigan",46024,22964,23060,23831,31222,3321,1369,322,194,45622,2650,2245,4895,8261,3891,4370,18770,159,5.88,83.5,4.095689205631844,17.949330783938816,1885,99.1265426733878,40.783069702763775,0.498957065878672
26061,"Houghton County, Michigan",36565,19817,16748,21462,21430,4016,1553,327,739,36129,1898,1309,3207,7821,4611,3210,14400,84,5.55,78.1,7.162587173526597,21.389306714070834,2619,98.80760289894708,39.38192260358266,0.5419663612744428
26063,"Huron County, Michigan",32021,15928,16093,26352,23515,2377,857,231,43,31646,1562,1151,2713,4399,2016,2383,13657,76,5.23,82.3,3.5320570875363044,13.737859529683645,1131,98.82889353861529,42.65013584834952,0.4974235657849536
26065,"Ingham County, Michigan",284559,138257,146302,27399,170159,34987,18097,4756,6353,282798,12494,9471,21965,59145,27489,31656,131515,503,7.78,84.1,10.263600870118323,20.784793311756086,29206,99.3811476706061,46.217128960953616,0.4858640914537934
26067,"Ionia County, Michigan",64126,33776,30350,22715,43274,4854,1596,164,137,60422,2900,1937,4837,8597,4013,4584,26598,104,8.27,84.2,2.958238468016093,13.406418613354957,1897,94.22387175248728,41.47771574712285,0.5267130337148739
26069,"Iosco County, Michigan",25373,12625,12748,24099,19508,1946,940,184,101,25048,1429,1183,2612,4205,2045,2160,8733,81,4.59,82.7,4.827966736294487,16.572734796831277,1225,98.71911086588105,34.41847633311,0.49757616363851337
26071,"Iron County, Michigan",11393,5619,5774,23658,8914,1116,386,73,42,11116,533,485,1018,1907,924,983,4249,18,5.26,78.8,4.397437022733257,16.738348108487667,501,97.56868252435706,37.29483015886948,0.49319757745984377
26073,"Isabella County, Michigan",70574,34284,36290,22009,37410,6022,3139,411,975,69978,4004,3375,7379,18428,8672,9756,31690,144,4.79,84.3,6.411709694788449,26.111599172499787,4525,99.15549635843229,44.90322214980021,0.48578796724006007
26075,"Jackson County, Michigan",159483,81632,77851,25952,109502,15493,5386,958,705,151652,6788,6057,12845,25032,10698,14334,64997,404,8.04,83.6,4.419906823924807,15.695716784861082,7049,95.0897587830678,40.754813992713956,0.5118539280048657
26077,"Kalamazoo County, Michigan",258605,126410,132195,29258,160127,34182,17092,3204,3329,256652,11157,8528,19685,43657,20371,23286,124308,1336,7.72,83.4,9.1355542236229,16.881730825003384,23625,99.2447941841805,48.068676166354095,0.48881498810927865
26079,"Kalkaska County, Michigan",17259,8835,8424,22822,12366,1049,460,98,76,17202,1085,837,1922,2839,1396,1443,6637,31,4.35,81.9,3.6734457384552988,16.44938872472333,634,99.66973752824613,38.45529868474419,0.5119068312184947
26081,"Kent County, Michigan",629352,309450,319902,29433,408603,90518,34389,7576,5042,625162,30335,22540,52875,92049,42375,49674,306936,2280,6.91,84.1,7.469111085688136,14.625996262822714,47007,99.33423584893669,48.770163596842465,0.4916962208748046
26083,"Keweenaw County, Michigan",2195,1138,1057,28700,1710,247,101,66,11,2187,148,86,234,371,187,184,836,6,5.03,75.8,8.109339407744875,16.902050113895218,178,99.63553530751709,38.086560364464695,0.5184510250569476
26085,"Lake County, Michigan",11415,5841,5574,18199,8741,507,218,30,36,11076,719,548,1267,3001,1465,1536,3264,48,4.73,82.4,2.4879544459045118,26.289969338589575,284,97.03022339027595,28.593955321944808,0.5116951379763469
26087,"Lapeer County, Michigan",88310,44709,43601,26650,61478,6874,3211,422,422,86823,3813,3368,7181,8914,4006,4908,37122,188,5.41,84,4.591778960480127,10.09398709092968,4055,98.31615898539236,42.03600951194655,0.5062733552259088
26089,"Leelanau County, Michigan",21764,10686,11078,37061,16628,3901,2267,436,236,21619,982,716,1698,1872,919,953,9534,87,4.2,81.3,13.503951479507444,8.601360044109539,2939,99.33376217607058,43.806285609263,0.4909943025179195
26091,"Lenawee County, Michigan",98673,49994,48679,25649,67537,8828,3652,615,367,95524,4646,3437,8083,13434,6016,7418,42291,131,5.13,85.2,4.696320168637824,13.614666626128729,4634,96.80865079606377,42.859748867471346,0.5066634236315912
26093,"Livingston County, Michigan",185841,93057,92784,36845,127944,28598,11891,1934,1081,185009,5511,4535,10046,10972,4916,6056,91640,565,6.38,85.2,8.02083501487831,5.903971674711178,14906,99.55230546542475,49.31097013038027,0.5007344988457876
26095,"Luce County, Michigan",6451,3784,2667,19442,4916,482,142,42,14,5444,324,212,536,1140,541,599,1968,35,6.74,77.6,3.0692915827003566,17.671678809486902,198,84.3900170516199,30.506898155324755,0.5865757246938459
26097,"Mackinac County, Michigan",10998,5581,5417,26967,8394,995,471,91,47,10879,850,668,1518,1687,742,945,4433,99,5.47,77.6,5.537370430987452,15.339152573195127,609,98.91798508819785,40.307328605200944,0.5074559010729224
26099,"Macomb County, Michigan",859703,418599,441104,29740,597899,92908,40270,6096,3013,853142,37977,29989,67966,102536,44358,58178,399727,1949,6.32,84.7,5.743727775755115,11.926909642050802,49379,99.23682946319833,46.49594104010338,0.48691117746477564
26101,"Manistee County, Michigan",24465,12691,11774,24398,18130,2229,1032,238,112,23243,1314,884,2198,3723,1615,2108,8932,43,4.83,81.6,5.6488861639076235,15.217657878602084,1382,95.00510933987329,36.509298998569385,0.5187410586552218
26103,"Marquette County, Michigan",67418,34041,33377,25550,44635,8958,3169,796,490,65383,3224,2057,5281,10403,4905,5498,28938,150,5.29,78.5,6.608027529739832,15.43059716989528,4455,96.98151828888427,42.923254917084456,0.5049245008751372
26105,"Mason County, Michigan",28755,14295,14460,26251,20576,2731,1155,216,170,28452,1716,1107,2823,4601,2081,2520,12098,125,5,81.4,5.359067988175969,16.000695531211964,1541,98.94627021387585,42.07268301165015,0.49713093375065204
26107,"Mecosta County, Michigan",43259,21816,21443,21978,26482,3459,1597,219,341,43033,2191,1608,3799,9084,4372,4712,17127,189,4.51,83,4.98624563674611,20.999098453501006,2157,99.47756536212118,39.5917612519938,0.5043112415913451
26109,"Menominee County, Michigan",23568,11917,11651,26151,17312,1988,564,158,35,23264,1065,891,1956,3492,1430,2062,10085,88,4.44,81.4,3.2119823489477257,14.816700610997964,757,98.7101154107264,42.791072640868975,0.505643245078072
26111,"Midland County, Michigan",83559,41100,42459,33013,57485,11270,5338,964,1332,82970,3324,2728,6052,10065,4616,5449,37303,235,4.98,84.4,9.136059550736606,12.045381107959646,7634,99.29510884524707,44.64270754796012,0.4918680213980541
26113,"Missaukee County, Michigan",15032,7685,7347,21805,10411,937,383,56,20,14921,918,678,1596,2234,1039,1195,6021,36,4.69,81.9,3.0534858967535925,14.861628525811602,459,99.26157530601384,40.05455029270889,0.5112426822778073
26115,"Monroe County, Michigan",149945,73941,76004,29245,103660,13266,5099,754,369,149065,5609,4471,10080,16078,7061,9017,67026,457,4.81,86.2,4.149521491213445,10.722598286038213,6222,99.41311814331922,44.70039014305245,0.49312081096402016
26117,"Montcalm County, Michigan",62922,32440,30482,21509,43290,3786,1275,281,96,60444,3580,2665,6245,10448,4655,5793,24649,268,6.4,84,2.6254728076030642,16.604685165760785,1652,96.0617907885954,39.17389784177235,0.5155589459966308
26119,"Montmorency County, Michigan",9317,4738,4579,23155,7434,556,276,27,17,9208,591,399,990,1496,594,902,2758,21,3.98,82.1,3.4345819469786414,16.05667060212515,320,98.8300955243104,29.601803155522163,0.5085327895245251
26121,"Muskegon County, Michigan",172148,85520,86628,22829,115950,14389,5311,796,401,167337,7460,5616,13076,32351,14736,17615,70147,249,6.15,82.7,3.7804679694216605,18.79255059599879,6508,97.20531170852988,40.74807723586681,0.49678183888282174
26123,"Newaygo County, Michigan",47957,24143,23814,22735,33063,3215,1231,169,126,47444,2432,1922,4354,8596,3889,4707,18432,300,5.18,83,3.1820172237629545,17.92439059991242,1526,98.93029171966553,38.434430844298014,0.5034301561815794
26125,"Oakland County, Michigan",1235215,600602,634613,40941,860757,221412,121228,30749,14132,1229304,46020,39699,85719,117008,50993,66015,607233,3294,6.15,84.7,13.44778034593168,9.472682893261497,166109,99.52145982683177,49.160105730581314,0.48623276109827035
26127,"Oceana County, Michigan",26152,13234,12918,22185,17816,1971,800,172,95,25977,1662,1320,2982,5136,2480,2656,10069,79,6.59,81.8,4.079993881921077,19.63903334353013,1067,99.33083511777302,38.501835423676965,0.5060416029366779
26129,"Ogemaw County, Michigan",21103,10562,10541,22028,15655,1160,472,120,27,20814,1137,915,2052,4135,1859,2276,7532,105,4.38,82.7,2.933232241861347,19.594370468653747,619,98.63052646543146,35.69160782827086,0.500497559588684
26131,"Ontonagon County, Michigan",6165,3160,3005,22958,5053,604,213,34,26,6102,410,368,778,928,420,508,1937,12,5.31,78.5,4.428223844282239,15.05271695052717,273,98.97810218978103,31.419302514193024,0.5125709651257097
26133,"Osceola County, Michigan",23172,11692,11480,21090,15991,1353,582,86,64,22912,1570,1260,2830,5172,2298,2874,8601,48,4.99,81.9,3.1589849818746765,22.32004142931124,732,98.87795615397894,37.11807353702745,0.5045744864491628
26135,"Oscoda County, Michigan",8374,4312,4062,22343,6228,453,137,42,5,8330,724,614,1338,1621,770,851,2694,80,3.76,82.2,2.1972772868402197,19.357535228086935,184,99.47456412705995,32.17100549319322,0.5149271554812515
26137,"Otsego County, Michigan",24198,11924,12274,26012,16963,2230,996,211,37,24010,1075,1017,2092,3365,1440,1925,10850,36,4.22,81.1,5.140920737251013,13.90610794280519,1244,99.22307628729646,44.838416398049425,0.4927679973551533
26139,"Ottawa County, Michigan",276583,136286,140297,29121,169697,36141,13587,2140,1761,275217,8409,6649,15058,26511,12015,14496,136402,646,5.05,83.4,6.3228759540535755,9.585187809807545,17488,99.50611570486979,49.31684159908599,0.4927490120506322
26141,"Presque Isle County, Michigan",12955,6459,6496,24793,10079,1059,481,107,32,12803,749,569,1318,1729,784,945,4409,62,4.68,81.2,4.785796989579313,13.346198379004246,620,98.82670783481281,34.033191817830954,0.49857197993052876
26143,"Roscommon County, Michigan",23900,11858,12042,22333,18885,1592,871,77,92,23678,1500,1101,2601,4644,1997,2647,7490,79,4.41,82.2,4.351464435146443,19.430962343096233,1040,99.07112970711297,31.338912133891213,0.4961506276150628
26145,"Saginaw County, Michigan",195201,94684,100517,25348,131885,17972,6836,1760,767,191876,7674,7064,14738,33795,15061,18734,80086,266,6.08,84.5,4.796594279742419,17.312923601825812,9363,98.29662757875215,41.0274537527984,0.4850589904764832
26147,"St. Clair County, Michigan",160069,79403,80666,27807,111685,12656,5501,962,527,158877,7220,5615,12835,22366,9554,12812,69204,460,5.62,84.1,4.366866788697374,13.972724262661727,6990,99.25532114275718,43.23385539985881,0.4960548263561339
26149,"St. Joseph County, Michigan",60923,30276,30647,23702,40651,3849,1865,299,216,60367,3378,2737,6115,9697,4433,5264,26433,184,8.3,83.5,3.906570589104279,15.916813026279074,2380,99.08737258506639,43.387554782266136,0.49695517292319813
26151,"Sanilac County, Michigan",41761,20737,21024,23924,29278,2380,1206,188,65,41457,2629,2267,4896,6476,2776,3700,17032,115,5.39,82.7,3.49369028519432,15.507291492061972,1459,99.27204808313977,40.78446397356385,0.49656377960297887
26153,"Schoolcraft County, Michigan",8186,4047,4139,21534,6109,673,235,30,23,8076,456,322,778,1728,821,907,2713,5,5.14,78.2,3.518201807964818,21.10921084778891,288,98.65624236501344,33.14194967016858,0.4943806498900562
26155,"Shiawassee County, Michigan",68800,33922,34878,25218,47519,4950,2082,325,135,68370,3423,2680,6103,9649,4300,5349,29266,213,5.72,84.7,3.6947674418604652,14.024709302325581,2542,99.375,42.53779069767442,0.49305232558139533
26157,"Tuscola County, Michigan",54014,27123,26891,23573,38124,3464,1533,219,64,53135,2520,2034,4554,8330,3851,4479,22661,114,5.84,83.5,3.3620913096604585,15.421927648387456,1816,98.37264412929981,41.95393786796016,0.5021475913652016
26159,"Van Buren County, Michigan",75216,37361,37855,25433,50901,6726,2803,439,380,74743,4735,3490,8225,12998,5937,7061,31869,132,7.96,83.9,4.815464794724527,17.280897681344396,3622,99.37114443735375,42.36997447351627,0.49671612422888745
26161,"Washtenaw County, Michigan",358082,177102,180980,37455,221550,55999,39394,9644,12907,353152,11308,8985,20293,51476,24932,26544,176009,879,5.32,85.2,17.299110259661195,14.375478242413749,61945,98.62322037968957,49.15326657022693,0.49458503918096974
26163,"Wayne County, Michigan",1767593,849914,917679,24847,1168342,157925,77609,15897,9554,1755443,104407,79462,183869,428189,195180,233009,694613,5602,6.17,85.8,5.8305277289511785,24.224411388820844,103060,99.31262456911743,39.297111948282215,0.48083127733590253
26165,"Wexford County, Michigan",32829,16433,16396,22028,22657,2537,909,238,101,32582,2139,1490,3629,6080,2998,3082,13312,85,4.61,81.7,3.801516951475829,18.52021078924122,1248,99.24761643668708,40.54951414907551,0.5005635261506595
27001,"Aitkin County, Minnesota",15722,8016,7706,26883,12182,1373,413,141,22,15535,545,390,935,1978,966,1012,6191,69,7.79,78.4,3.6636560234066913,12.58109655260145,576,98.81058389517872,39.3779417376924,0.5098587965907645
27003,"Anoka County, Minnesota",341249,170762,170487,34321,229933,46259,14593,2448,1600,338996,9954,7868,17822,24864,11326,13538,181815,834,7.78,82,5.462580110124865,7.286175197582996,18641,99.33977828506457,53.27927700887036,0.5004029315836823
27005,"Becker County, Minnesota",33375,16693,16682,28525,22835,3778,1077,319,244,32989,1780,1245,3025,4209,1784,2425,15864,73,7.7,78.6,4.913857677902621,12.61123595505618,1640,98.84344569288389,47.53258426966292,0.5001647940074906
27007,"Beltrami County, Minnesota",45644,22773,22871,23748,27550,4834,1607,407,535,45130,2866,2272,5138,8247,3999,4248,20187,79,5.55,78.3,5.58452370519674,18.068092191744807,2549,98.87389361142758,44.2270616072211,0.49892647445447375
27009,"Benton County, Minnesota",39457,19736,19721,27018,26541,4242,1200,282,170,38941,1393,1050,2443,5220,2207,3013,20014,147,7.92,80.1,4.186836302810654,13.22959170742834,1652,98.69224725650709,50.723572496641914,0.500190080340624
27011,"Big Stone County, Minnesota",5098,2494,2604,29035,3709,460,96,40,19,4965,146,134,280,562,219,343,2399,9,6.97,82.8,3.0404080031384857,11.023930953315025,155,97.39113377795213,47.05766967438211,0.4892114554727344
27013,"Blue Earth County, Minnesota",65524,32979,32545,28283,37943,8065,2687,602,660,64944,1987,1277,3264,11323,5438,5885,35599,47,8.36,82,6.026799340699591,17.280691044502777,3949,99.11482815456932,54.32971125083939,0.5033117636285941
27015,"Brown County, Minnesota",25327,12563,12764,29696,17370,2665,589,242,133,24984,730,516,1246,1925,946,979,13352,36,7.56,82.1,3.80621471157263,7.60058435661547,964,98.64571406009397,52.71844276858688,0.49603190271252023
27017,"Carlton County, Minnesota",35482,18491,16991,26900,24670,4034,1101,163,126,34644,1110,759,1869,4507,2389,2118,16626,89,6.9,78.2,3.9174792852714053,12.702215207710951,1390,97.63823910715293,46.8575615805197,0.5211374781579392
27019,"Carver County, Minnesota",97143,48209,48934,44212,62455,20403,6588,1079,686,96883,2039,1510,3549,3957,1722,2235,53082,245,8.2,82.4,8.598663825494373,4.073376362681819,8353,99.7323533347745,54.64315493653686,0.4962683878406061
27021,"Cass County, Minnesota",28633,14588,14045,28004,20695,3025,965,193,136,28396,1391,932,2323,4468,2057,2411,11947,155,6.72,78.7,4.519260992561031,15.604372577096358,1294,99.17228372856495,41.72458352250899,0.5094820661474523
27023,"Chippewa County, Minnesota",12126,6006,6120,29354,8446,1043,298,41,10,11934,546,425,971,1285,489,796,6339,9,7.32,82.8,2.8781131453076036,10.597064159656936,349,98.41662543295398,52.27610094012865,0.49529935675408215
27025,"Chisago County, Minnesota",54041,27920,26121,32105,37112,5677,1875,422,202,52676,1716,1259,2975,3137,1417,1720,27057,200,7.46,81.7,4.624266760422642,5.804851871727022,2499,97.47414000481116,50.06754131122666,0.5166447697118854
27027,"Clay County, Minnesota",61402,30311,31091,28122,36983,8901,2494,260,553,60917,1975,1275,3250,6827,3109,3718,32954,157,6.96,81.2,5.385818051529266,11.118530341031237,3307,99.2101234487476,53.66926158757044,0.49364841536106313
27029,"Clearwater County, Minnesota",8764,4440,4324,24515,5978,640,184,32,19,8667,532,420,952,1435,681,754,3547,34,4.81,78,2.6814240073026014,16.37380191693291,235,98.89319945230488,40.47238703788224,0.5066179826563213
27031,"Cook County, Minnesota",5215,2606,2609,31831,4093,1001,421,140,58,5171,280,190,470,617,269,348,2653,10,5.73,73.6,11.86960690316395,11.831255992329817,619,99.15627996164909,50.87248322147651,0.499712368168744
27033,"Cottonwood County, Minnesota",11557,5669,5888,27206,7932,1189,280,65,46,11361,400,205,605,1802,832,970,5266,53,7.32,81,3.3832309422860605,15.592281734014017,391,98.30405814657783,45.56545816388336,0.4905252228086874
27035,"Crow Wing County, Minnesota",63321,31646,31675,30013,44683,7091,2648,687,383,62588,2527,1696,4223,6531,2970,3561,29319,181,9.98,79.2,5.871669746213736,10.314113801108636,3718,98.84240615277712,46.30217463400768,0.49977100803840746
27037,"Dakota County, Minnesota",411402,202188,209214,38863,275344,77821,25573,5644,3092,409552,11657,9757,21414,29265,13140,16125,223600,1270,8.19,82.6,8.339531650307972,7.113480245599195,34309,99.55031818027136,54.350732373688025,0.4914609068502341
27039,"Dodge County, Minnesota",20361,10198,10163,31417,13190,2418,548,131,47,20221,622,402,1024,1341,591,750,10913,63,8.26,80.2,3.565640194489465,6.586120524532194,726,99.3124109817789,53.59756397033544,0.5008594862727764
27041,"Douglas County, Minnesota",36862,18388,18474,33336,26249,4839,1166,345,227,36463,961,760,1721,3141,1557,1584,18785,124,7.27,79.7,4.714882534859747,8.520970104714882,1738,98.91758450436764,50.96033856003472,0.4988334870598448
27043,"Faribault County, Minnesota",14119,7060,7059,29116,10153,1292,287,112,30,13817,458,413,871,1728,727,1001,6963,42,8.4,81.8,3.0384588143636235,12.238827112401728,429,97.86103831716127,49.316523833132656,0.5000354132728947
27045,"Fillmore County, Minnesota",20877,10470,10407,28441,14422,2093,648,138,63,20538,1054,852,1906,2476,1102,1374,10381,107,10.13,80.1,4.0666762465871535,11.859941562485032,849,98.37620347751114,49.724577286008525,0.501508837476649
27047,"Freeborn County, Minnesota",30751,15350,15401,27603,21874,2636,729,223,77,30285,1220,898,2118,3383,1350,2033,14874,172,9.42,80.7,3.3462326428408833,11.001268251438978,1029,98.48460212676011,48.36915872654548,0.49917075867451466
27049,"Goodhue County, Minnesota",46450,23180,23270,33477,32472,5556,1710,373,267,45649,1483,1497,2980,4980,2363,2617,23345,185,9.69,81.3,5.059203444564047,10.721205597416576,2350,98.27556512378902,50.258342303552205,0.49903121636167924
27051,"Grant County, Minnesota",5943,2972,2971,30359,4249,639,139,36,18,5890,160,166,326,676,254,422,2839,18,7.36,80.9,3.247518088507488,11.374726569072859,193,99.10819451455494,47.770486286387346,0.5000841325929665
27053,"Hennepin County, Minnesota",1209265,596243,613022,41794,831660,254187,98334,27863,15331,1200092,46374,34719,81093,141453,66258,75195,650345,3714,8.65,82.5,11.703638160370142,11.697436045862569,141528,99.2414400482938,53.780188792365614,0.4930623147118291
27055,"Houston County, Minnesota",18791,9390,9401,30150,13394,2177,587,129,129,18574,532,367,899,1910,886,1024,9773,126,11.71,81.4,4.4968335905486665,10.164440423607045,845,98.84519184716088,52.008940450215526,0.4997073066893726
27057,"Hubbard County, Minnesota",20640,10302,10338,28073,14961,2551,895,229,124,20542,938,636,1574,2363,1011,1352,9180,81,5.95,78.5,6.046511627906977,11.448643410852712,1248,99.5251937984496,44.47674418604651,0.4991279069767442
27059,"Isanti County, Minnesota",38461,19431,19030,30145,26122,3267,1092,196,66,38149,1429,910,2339,2732,1379,1353,19285,182,8.05,81.2,3.520449286290008,7.1032994461922465,1354,99.18878864304101,50.14170198382777,0.5052130729830218
27061,"Itasca County, Minnesota",45356,22906,22450,27497,32508,4900,1744,406,185,44565,2002,1666,3668,5886,2728,3158,19696,171,5.47,77.5,5.148161213510892,12.977334861980774,2335,98.25601904929889,43.42534615045418,0.5050268983155481
27063,"Jackson County, Minnesota",10163,5130,5033,31010,7147,1134,295,61,22,10038,294,113,407,895,442,453,5255,18,5.84,81.4,3.7193742005313393,8.80645478697235,378,98.77004821411,51.70717307881531,0.5047722129292532
27065,"Kanabec County, Minnesota",15918,8062,7856,26345,11255,937,439,126,46,15783,577,393,970,2130,995,1135,7225,90,9.7,80.6,3.8384219123005403,13.381078024877498,611,99.15190350546551,45.388867948234704,0.5064706621434854
27067,"Kandiyohi County, Minnesota",42510,21312,21198,29375,28588,4293,1421,544,179,41885,1793,1077,2870,4732,2038,2694,21470,93,7.51,81,5.043519171959539,11.131498470948012,2144,98.52975770406962,50.50576334980005,0.5013408609738885
27069,"Kittson County, Minnesota",4436,2243,2193,30525,3169,497,111,35,12,4307,164,117,281,481,178,303,2171,10,6.07,79.4,3.5617673579801625,10.843101893597836,158,97.09197475202886,48.9404869251578,0.5056357078449053
27071,"Koochiching County, Minnesota",12930,6461,6469,26804,9516,1204,390,92,64,12767,523,359,882,2139,998,1141,5721,31,6.46,78.1,4.2227378190255225,16.54292343387471,546,98.73936581593195,44.245939675174014,0.4996906419180201
27073,"Lac qui Parle County, Minnesota",6916,3453,3463,31427,5066,697,148,66,18,6791,182,115,297,574,230,344,3412,12,6.98,83.4,3.35454019664546,8.299595141700404,232,98.1925968768074,49.334875650665126,0.49927703875072293
27075,"Lake County, Minnesota",10721,5481,5240,32319,8135,1394,465,199,158,10549,285,232,517,1255,648,607,4717,32,5.78,76.5,7.667195224326089,11.705997574853091,822,98.39567204551814,43.99776140285421,0.5112396231694805
27077,"Lake of the Woods County, Minnesota",3901,2030,1871,24964,2910,408,85,1,0,3847,180,65,245,312,124,188,2014,0,6.5,79,2.2045629325813896,7.997949243783645,86,98.61573955396052,51.627787746731606,0.5203793899000256
27079,"Le Sueur County, Minnesota",27650,14005,13645,31135,18871,2871,854,134,173,27480,790,657,1447,2339,1108,1231,14421,36,8.44,81.5,4.198915009041591,8.459312839059674,1161,99.38517179023508,52.155515370705245,0.506509945750452
27081,"Lincoln County, Minnesota",5793,2914,2879,28382,4122,627,107,22,22,5628,208,159,367,652,268,384,2827,9,5.09,81.8,2.606594165372001,11.254962886242016,151,97.15173485240808,48.80027619540825,0.503020887277749
27083,"Lyon County, Minnesota",25670,12840,12830,30203,16448,3197,795,170,242,25371,1042,619,1661,3396,1418,1978,13701,30,5.47,83.2,4.701986754966887,13.229450720685625,1207,98.83521620568757,53.37358784573432,0.5001947798987144
27085,"McLeod County, Minnesota",35926,17807,18119,30145,24697,3082,868,165,161,35630,1238,851,2089,2885,1245,1640,18957,73,6.24,81.8,3.3234983020653566,8.03039581361688,1194,99.17608417302232,52.76679841897233,0.4956577409118744
27087,"Mahnomen County, Minnesota",5480,2765,2715,20720,3362,314,79,18,13,5444,392,434,826,1209,580,629,2201,13,6.12,78.5,2.0072992700729926,22.062043795620436,110,99.34306569343066,40.16423357664234,0.5045620437956204
27089,"Marshall County, Minnesota",9406,4793,4613,28585,6556,1022,217,46,26,9335,363,287,650,698,302,396,4684,39,6.43,79.1,3.0725069104826708,7.4207952370827135,289,99.24516266213055,49.79800127578142,0.5095683606208803
27091,"Martin County, Minnesota",20193,9989,10204,30806,14336,2055,409,128,56,19969,760,555,1315,2308,866,1442,9996,116,6.66,82.2,2.936661219234388,11.429703362551379,593,98.8907046996484,49.50230277819046,0.49467637300054473
27093,"Meeker County, Minnesota",23094,11734,11360,29216,15791,2156,603,160,65,22786,866,553,1419,2116,908,1208,11283,54,7.04,80.6,3.5853468433359312,9.162553044080713,828,98.66632025634364,48.85684593400883,0.5080973413007708
27095,"Mille Lacs County, Minnesota",25788,12944,12844,25732,17729,1889,707,81,92,25325,1003,794,1797,2970,1223,1747,11736,151,9.06,80.2,3.412439894524585,11.516984644020475,880,98.20459128276718,45.50953932061424,0.5019388863037072
27097,"Morrison County, Minnesota",32850,16617,16233,28040,22679,2580,804,155,124,32508,1198,892,2090,3801,1627,2174,16390,141,9.39,79.7,3.2968036529680367,11.570776255707763,1083,98.95890410958904,49.89345509893455,0.5058447488584474
27099,"Mower County, Minnesota",39248,19689,19559,28613,26194,3597,1073,296,274,38851,1899,1086,2985,5403,2544,2859,18632,255,8.98,80.4,4.186200570729719,13.766306563391765,1643,98.98848348960456,47.4724826742764,0.5016561353444762
27101,"Murray County, Minnesota",8463,4197,4266,30553,6108,751,231,92,14,8350,237,276,513,761,315,446,4156,11,5.03,81.8,3.9820394659104337,8.992083185631573,337,98.66477608413092,49.10788136594588,0.4959234314073024
27103,"Nicollet County, Minnesota",33226,16586,16640,29722,21497,4749,1319,330,537,33042,571,577,1148,3655,1859,1796,18073,41,7.69,81.8,6.5791849756215015,11.000421356768795,2186,99.44621681815445,54.39414916029615,0.4991873833744658
27105,"Nobles County, Minnesota",21729,11130,10599,24935,13963,1327,376,121,62,21443,1340,975,2315,3004,1303,1701,10337,67,7.25,81.9,2.572598831055272,13.82484237654747,559,98.68378664457637,47.5723687238253,0.5122186939113627
27107,"Norman County, Minnesota",6638,3332,3306,27099,4652,606,87,21,15,6512,311,169,480,761,328,433,3033,15,6.06,80.4,1.8529677613739077,11.46429647484182,123,98.10183790298282,45.69147333534197,0.50195842121120815
27109,"Olmsted County, Minnesota",150104,73514,76590,37956,101189,24599,10015,4740,3138,148170,4840,3025,7865,13635,5936,7699,78857,403,8.27,80.6,11.920401854714065,9.083701966636465,17893,98.71155998507702,52.5349091296701,0.4897537707189682
27111,"Otter Tail County, Minnesota",57694,28994,28700,29932,41119,6942,2060,532,358,56992,1975,1431,3406,5497,2493,3004,27337,201,7.14,79.4,5.113183346621833,9.527853849620412,2950,98.78323569175305,47.382743439525775,0.502547925260859
27113,"Pennington County, Minnesota",14156,7121,7035,28562,9690,1268,288,71,58,13958,422,206,628,1211,548,663,7481,76,6.49,78.8,2.9457473862673074,8.55467646227748,417,98.60129980220401,52.846849392483755,0.5030375812376378
27115,"Pine County, Minnesota",29067,15548,13519,24044,21058,2049,685,81,87,27442,1279,985,2264,3737,1832,1905,12412,74,9.37,79.6,2.9345993738603915,12.85650393917501,853,94.40946778133278,42.70134516806,0.5349021226820794
27117,"Pipestone County, Minnesota",9285,4533,4752,28706,6313,970,178,87,22,9129,399,233,632,1155,481,674,4402,11,4.79,82,3.091007000538503,12.439418416801292,287,98.31987075928917,47.40980075390414,0.48820678513731824
27119,"Polk County, Minnesota",31550,15931,15619,28260,20979,3503,1125,225,155,30974,1059,874,1933,3950,1910,2040,15630,35,6.26,79.5,4.770206022187005,12.519809825673534,1505,98.1743264659271,49.54041204437401,0.5049445324881141
27121,"Pope County, Minnesota",10975,5543,5432,32454,7948,1285,383,99,19,10797,361,195,556,1026,414,612,5312,32,8.15,80.3,4.56492027334852,9.348519362186789,501,98.37813211845102,48.40091116173121,0.5050569476082004
27123,"Ramsey County, Minnesota",531528,258733,272795,32544,349954,86357,37119,10914,9099,527242,22584,16830,39414,82252,37771,44481,265788,1486,9.43,82,10.748634126518263,15.474631628060987,57132,99.1936454899836,50.004515284237144,0.4867720985536039
27125,"Red Lake County, Minnesota",4042,2056,1986,26988,2790,319,79,15,6,4019,169,54,223,418,184,234,1974,7,6.73,79,2.4740227610094014,10.341415141019297,100,99.43097476496784,48.83720930232558,0.5086590796635329
27127,"Redwood County, Minnesota",15578,7830,7748,27543,10614,1447,330,74,43,15308,669,578,1247,1767,863,904,7487,44,7.95,82.6,2.869431249197586,11.3429195018616,447,98.26678649377327,48.061368596738994,0.5026319168057517
27129,"Renville County, Minnesota",14995,7603,7392,31215,10538,1216,246,55,38,14703,483,434,917,1533,616,917,7373,44,8.52,82.2,2.260753584528176,10.223407802600867,339,98.05268422807603,49.16972324108036,0.5070356785595198
27131,"Rice County, Minnesota",65116,33132,31984,28603,41110,6952,2857,708,678,62450,2146,1826,3972,6678,2675,4003,33398,190,9.42,81.4,6.516063640272744,10.255543952331225,4243,95.90576816757786,51.290005528595124,0.5088150377787334
27133,"Rock County, Minnesota",9554,4668,4886,29000,6493,969,264,81,21,9326,317,377,694,998,416,582,4707,30,6.93,83,3.830856185890726,10.445886539669248,366,97.61356499895332,49.26732258739795,0.48859116600376806
27135,"Roseau County, Minnesota",15609,7999,7610,27935,10486,1441,381,105,31,15415,336,230,566,1286,631,655,8249,76,5.11,79,3.3121916842847074,8.238836568646294,517,98.75712729835351,52.847716061246715,0.5124607598180537
27137,"St. Louis County, Minnesota",200353,100702,99651,29197,136035,25281,8641,2254,1574,197022,6086,4485,10571,29875,14009,15866,94788,618,5.7,78.1,6.223515495151059,14.911181764186212,12469,98.33743442823416,47.310496972842934,0.5026228706333322
27139,"Scott County, Minnesota",139490,69528,69962,38322,89060,25268,7452,1159,718,138005,3898,3176,7074,7905,3269,4636,74975,472,8.16,82.6,6.687934618969102,5.6670729084522184,9329,98.93540755609722,53.74937271488996,0.49844433292709156
27141,"Sherburne County, Minnesota",91188,46610,44578,33048,58467,11239,3413,647,321,89223,1962,1417,3379,6382,2824,3558,47808,338,6.98,80.6,4.804360222836338,6.9987279027942275,4381,97.84511119884195,52.42795104619029,0.5111418169057332
27143,"Sibley County, Minnesota",14957,7555,7402,29884,10244,1301,253,115,45,14826,390,371,761,1442,636,806,7860,27,6.77,82.1,2.761248913552183,9.640970782911012,413,99.12415591361903,52.55064518285752,0.505114662031156
27145,"Stearns County, Minnesota",153661,77355,76306,29148,94448,16838,5030,1535,1105,152512,4492,3218,7710,19983,9497,10486,81841,405,7.89,79.6,4.991507279010289,13.004601037348449,7670,99.25225008297485,53.26074931179675,0.5034133579763245
27147,"Steele County, Minnesota",36541,18073,18468,29930,24392,4432,1252,280,82,36154,985,592,1577,3396,1266,2130,18405,72,9.99,80.7,4.41695629566788,9.293670123970335,1614,98.9409156837525,50.36807969130566,0.49459511233956377
27149,"Stevens County, Minnesota",9762,4884,4878,31419,5718,1158,208,83,161,9676,186,153,339,1637,773,864,5044,20,8.1,81.4,4.63019872976849,16.769104691661546,452,99.11903298504404,51.66973980741651,0.5003073140749846
27151,"Swift County, Minnesota",9483,4775,4708,29470,6679,891,192,44,29,9350,302,180,482,1155,405,750,4779,52,7.71,81.9,2.7944743224717916,12.179689971527997,265,98.59749024570284,50.395444479595064,0.5035326373510493
27153,"Todd County, Minnesota",24335,12419,11916,24988,16589,1845,550,118,34,24150,1399,1266,2665,3253,1509,1744,11276,162,7.89,79,2.8847339223340867,13.367577563180603,702,99.23977809739058,46.336552290938975,0.5103349085679063
27155,"Traverse County, Minnesota",3397,1635,1762,30234,2486,326,89,31,5,3310,74,69,143,305,118,187,1597,9,6.1,82.2,3.679717397703856,8.97851045039741,125,97.43891669119812,47.01206947306447,0.4813070356196644
27157,"Wabasha County, Minnesota",21327,10627,10700,32307,15048,2204,725,155,112,21148,627,446,1073,1399,590,809,11132,71,9.55,81.8,4.6513808786983635,6.559759928728841,992,99.16068832934778,52.196745908941715,0.49828855441459186
27159,"Wadena County, Minnesota",13755,6809,6946,24200,9363,831,256,90,40,13463,549,322,871,2081,884,1197,5865,47,7.84,79.5,2.8062522719011267,15.129043984005817,386,97.87713558705926,42.639040348964016,0.49501999272991637
27161,"Waseca County, Minnesota",19034,8996,10038,27383,13163,1962,509,58,85,17873,420,496,916,1387,666,721,9330,90,11.25,81.3,3.4254491961752653,7.286960176526216,652,93.90038877797625,49.01754754649574,0.47262792896921296
27163,"Washington County, Minnesota",248745,123093,125652,41591,166376,45894,17006,4394,3085,245438,5767,4233,10000,12496,5236,7260,130048,497,8.63,81.9,9.843413937968602,5.023618565197291,24485,98.67052604072444,52.28165390259101,0.4948561780136284
27165,"Watonwan County, Minnesota",10996,5414,5582,26884,7428,947,214,37,16,10861,858,748,1606,1272,435,837,5664,16,8.05,82.4,2.4281556929792654,11.567842851946162,267,98.7722808293925,51.50963986904329,0.4923608584939978
27167,"Wilkin County, Minnesota",6479,3258,3221,28575,4632,779,164,28,17,6323,159,156,315,577,215,362,3273,9,6.13,81.8,3.225806451612903,8.905695323352369,209,97.59222102176261,50.51705510109585,0.5028553789164995
27169,"Winona County, Minnesota",51145,25238,25907,27200,31030,5943,2188,377,577,50619,2311,1360,3671,6539,3210,3329,27932,144,9.04,81.6,6.143318017401506,12.785218496431714,3142,98.97155147130707,54.61335418907029,0.49345977123863527
27171,"Wright County, Minnesota",129922,65372,64550,32506,83193,16515,4207,913,628,129131,3095,2389,5484,7150,3149,4001,68539,713,7.11,81.2,4.424192977324856,5.503301981188713,5748,99.39117316543772,52.753960068348704,0.5031634365234525
27173,"Yellow Medicine County, Minnesota",10038,5115,4923,28182,7003,880,169,69,19,9863,432,326,758,1115,526,589,5001,36,6.49,83.5,2.5602709703128115,11.107790396493325,257,98.25662482566248,49.82068141063957,0.509563658099223
28001,"Adams County, Mississippi",31747,15901,15846,17721,22155,2502,1115,254,134,29327,2690,2108,4798,8905,3755,5150,10531,70,11.99,93,4.734305603679088,28.049894478218416,1503,92.37723249440891,33.17163826503292,0.5008662235801808
28003,"Alcorn County, Mississippi",37309,18354,18955,20527,25189,2560,1010,438,161,36857,3239,2638,5877,7305,3393,3912,14531,58,6.78,92.1,4.312632340722078,19.57972607145729,1609,98.78849607333352,38.947706987590124,0.4919456431424053
28005,"Amite County, Mississippi",12692,6302,6390,19665,9245,663,405,18,41,12585,881,947,1828,3519,1576,1943,4439,38,17.81,92.7,3.6558462023321776,27.72612669398046,464,99.15694925937599,34.97478726757012,0.4965332492908919
28007,"Attala County, Mississippi",19085,8996,10089,20617,12622,1141,569,119,37,18780,1289,1026,2315,4574,1803,2771,6484,266,9.67,93.4,3.798794865077286,23.966465810846213,725,98.4018862981399,33.974325386429136,0.4713649462929002
28009,"Benton County, Mississippi",8378,4159,4219,18599,5730,375,201,57,23,8300,730,797,1527,1882,940,942,2934,60,9.23,92.1,3.3540224397230842,22.46359513010265,281,99.0689902124612,35.02029123895918,0.4964191931248508
28011,"Bolivar County, Mississippi",33615,15773,17842,16984,21344,2878,1209,279,220,32858,3272,2582,5854,12097,5135,6962,11582,57,17.45,91.8,5.081065000743716,35.9869106053845,1708,97.74802915365164,34.45485646288859,0.4692250483415142
28013,"Calhoun County, Mississippi",14724,7018,7706,17837,9900,603,397,26,56,14554,1043,1091,2134,3791,1630,2161,5303,72,9.74,92.8,3.2531920673729964,25.747079597935343,479,98.84542243955447,36.01602825319207,0.47663678348274924
28015,"Carroll County, Mississippi",10301,5229,5072,22995,7274,716,306,102,50,10143,652,555,1207,1759,728,1031,3722,11,10.14,93,4.446170274730608,17.076012037666246,458,98.46616833317154,36.13241432870595,0.5076206193573439
28017,"Chickasaw County, Mississippi",17357,8437,8920,19609,11339,941,194,81,32,17056,1421,1156,2577,4623,1940,2683,6450,124,7.82,92.7,1.7687388373566861,26.634787117589447,307,98.2658293483897,37.1607996773636,0.48608630523708013
28019,"Choctaw County, Mississippi",8320,4037,4283,19816,5701,545,242,50,42,8214,582,411,993,1993,842,1151,2895,79,9.19,93,4.014423076923077,23.954326923076923,334,98.72596153846153,34.79567307692308,0.4852163461538462
28021,"Claiborne County, Mississippi",9209,4309,4900,13095,5277,549,351,66,48,9155,801,640,1441,3554,1717,1837,2336,28,12.48,94,5.049408187642523,38.592681072863506,465,99.41361711369312,25.366489303941798,0.4679118253882072
28023,"Clarke County, Mississippi",16203,7616,8587,20564,11108,1035,415,103,11,16148,803,970,1773,3087,1260,1827,5894,186,9.06,92.8,3.2648275010800467,19.0520274023329,529,99.66055668703326,36.37597975683516,0.4700364130099364
28025,"Clay County, Mississippi",20147,9343,10804,19220,13395,1608,768,108,52,19875,1501,1545,3046,5159,2175,2984,7628,4,7.71,93.4,4.606144835459373,25.60679009281779,928,98.6499230654688,37.861716384573384,0.46374149997518244
28027,"Coahoma County, Mississippi",24804,11476,13328,16699,15186,1816,608,155,37,24515,2028,1930,3958,8541,3659,4882,8324,75,15.79,92.1,3.2252862441541685,34.43396226415094,800,98.8348653442993,33.559103370424126,0.4626673117239155
28029,"Copiah County, Mississippi",28780,13820,14960,18756,18770,1770,477,65,103,28632,2654,2449,5103,7844,3398,4446,9718,45,11.49,93.2,2.241139680333565,27.255038220986798,645,99.48575399583044,33.76650451702571,0.48019457956914524
28031,"Covington County, Mississippi",19503,9299,10204,18749,12798,970,624,192,61,19254,1578,1482,3060,4943,1956,2987,6958,132,9.95,93,4.4967440906527205,25.344818745833976,877,98.72327334256268,35.67656258011588,0.47679844126544635
28033,"DeSoto County, Mississippi",170890,82763,88127,28316,110504,17748,6170,1052,654,170001,9896,9188,19084,16948,7039,9909,83011,421,15.52,92.1,4.608812686523494,9.91749078354497,7876,99.47978231610978,48.5756919655919,0.48430569372110716
28035,"Forrest County, Mississippi",76274,36332,39942,20783,46623,6695,3724,764,786,75598,6830,5417,12247,19870,8782,11088,31891,1979,11.58,92.5,6.914544930120355,26.05081679209167,5274,99.11372158271494,41.81110207934552,0.47633531740829116
28037,"Franklin County, Mississippi",7818,3811,4007,24864,5329,583,257,21,28,7736,656,582,1238,1442,702,740,2889,43,13,92.7,3.9140445126630854,18.444614991046304,306,98.95113839856741,36.953184957789716,0.4874648247633666
28039,"George County, Mississippi",23313,11736,11577,20973,15142,1298,542,69,73,22860,2131,1691,3822,4096,1882,2214,7901,187,9.28,92,2.93398533007335,17.5695963625445,684,98.05687813666195,33.89096212413675,0.5034101145283747
28041,"Greene County, Mississippi",13941,8190,5751,18002,9956,558,189,33,0,10622,954,1014,1968,1914,787,1127,3776,87,9.82,92.5,1.5924252205724123,13.729287712502689,222,76.19252564378452,27.085574922889318,0.5874757908327953
28043,"Grenada County, Mississippi",21518,10281,11237,20150,14485,1579,732,79,48,21179,1542,1463,3005,5090,2403,2687,8159,121,9.61,93,3.992006692071754,23.654614741146947,859,98.42457477460731,37.9170926666047,0.47778603959475785
28045,"Hancock County, Mississippi",46028,22404,23624,24373,31990,4182,1938,383,195,45882,4441,3743,8184,8490,3996,4494,19312,190,10.55,91.3,5.466237942122186,18.44529416876684,2516,99.68280177283393,41.95706960980273,0.4867471973581298
28047,"Harrison County, Mississippi",198570,98115,100455,23127,129834,17647,7429,1572,1284,191097,17893,16414,34307,40538,17781,22757,87294,610,10.5,90.4,5.179533665709825,20.41496701415118,10285,96.23659163015562,43.96132346275873,0.4941078712796495
28049,"Hinds County, Mississippi",244596,114238,130358,22397,154494,25244,11951,3656,2450,242056,19081,17391,36472,60356,25684,34672,103400,1120,11.99,93.6,7.382377471422264,24.675791918101687,18057,98.96155292809367,42.273790250044975,0.4670477031513189
28051,"Holmes County, Mississippi",18547,8830,9717,12394,11171,889,311,74,24,18401,1871,1654,3525,8046,3479,4567,5085,64,10.02,93.2,2.2052083894969536,43.38167897773225,409,99.21281069714779,27.416832910982908,0.4760877769989756
28053,"Humphreys County, Mississippi",8822,4177,4645,15696,5579,476,278,15,9,8735,841,779,1620,3706,1742,1964,2542,15,10.45,93.2,3.4232600317388346,42.00861482656994,302,99.01382906370438,28.81432781682158,0.4734754024030832
28055,"Issaquena County, Mississippi",1352,831,521,16348,1054,50,28,10,7,1067,94,53,147,431,218,213,358,4,13.78,93.6,3.328402366863905,31.87869822485207,45,78.92011834319527,26.4792899408284,0.6146449704142012
28057,"Itawamba County, Mississippi",23511,11643,11868,20859,15655,1358,571,89,39,23282,1551,1423,2974,4544,2137,2407,9003,62,6.43,92.4,2.9730764323082814,19.327123474118498,699,99.02598783548126,38.29271404874314,0.4952150057419931
28059,"Jackson County, Mississippi",140850,69209,71641,24665,94378,11707,5937,1173,497,139496,10864,11387,22251,21818,9425,12393,58524,481,8.51,91.3,5.400780972665957,15.490237841675542,7607,99.0386936457224,41.55058572949947,0.4913667021654242
28061,"Jasper County, Mississippi",16538,8038,8500,20619,11265,987,453,71,28,16454,1111,1082,2193,3641,1686,1955,6096,171,11.31,93,3.337767565606482,22.015963236183335,552,99.49207884871205,36.86056355061071,0.48603216833958157
28063,"Jefferson County, Mississippi",7528,3732,3796,13758,4937,340,459,54,27,7083,499,291,790,2812,1042,1770,2003,44,13.64,93.2,7.1732199787460145,37.3538788522848,540,94.08873538788522,26.607332624867162,0.4957492029755579
28065,"Jefferson Davis County, Mississippi",11771,5705,6066,17035,8174,767,366,19,39,11660,1117,1135,2252,4005,1658,2347,3958,53,10.92,93.1,3.602072891003313,34.02429700110441,424,99.05700450259111,33.625010619318665,0.4846657038484411
28067,"Jones County, Mississippi",68313,33207,35106,20958,44779,4665,2854,663,207,67566,4164,4443,8607,15859,6419,9440,26536,360,11.56,93,5.451378214981043,23.215200620672494,3724,98.90650388652233,38.84472940728705,0.48610074217206095
28069,"Kemper County, Mississippi",10128,4931,5197,15790,6852,515,222,35,8,9596,647,679,1326,2755,1029,1726,3508,110,9.07,92.8,2.6165086887835702,27.20181674565561,265,94.74723538704582,34.636650868878355,0.48686808846761453
28071,"Lafayette County, Mississippi",52193,25377,26816,25719,29500,6752,2743,780,1451,51636,3158,2207,5365,11902,5728,6174,23002,159,10.17,92,9.530013603356773,22.803824267622094,4974,98.93280708140938,44.07104400973311,0.4862146264824785
28073,"Lamar County, Mississippi",59623,28686,30937,28342,38492,9062,3350,961,792,58827,4086,4181,8267,9535,4285,5250,28211,1190,11.39,92.3,8.558777652919176,15.99215068010667,5103,98.66494473609178,47.31563322878755,0.4811230565385841
28075,"Lauderdale County, Mississippi",79233,38430,40803,23339,52341,6469,2618,616,361,76212,5080,6012,11092,17541,6844,10697,32346,375,10.01,92.9,4.537250892936024,22.13850289652039,3595,96.18719472946879,40.823899132937036,0.48502517890272995
28077,"Lawrence County, Mississippi",12603,6176,6427,21826,8429,777,270,46,54,12593,984,1058,2042,2736,1253,1483,4704,65,10.84,93.7,2.9358089343807032,21.709116876934065,370,99.9206538125843,37.32444656034278,0.49004205347933033
28079,"Leake County, Mississippi",23011,11492,11519,18825,14471,1253,364,115,41,22235,1974,1832,3806,6013,2522,3491,8096,71,9.16,93.2,2.2597887966624657,26.130980835252704,520,96.62769979574986,35.18317326496024,0.49941332406240496
28081,"Lee County, Mississippi",85281,40811,44470,23968,55985,8267,3179,972,507,84330,5457,5015,10472,15531,6763,8768,37141,201,6.69,92.5,5.461943457511052,18.21155943293348,4658,98.8848629823759,43.55131858209918,0.4785473903917637
28083,"Leflore County, Mississippi",30500,14123,16377,15403,18494,2210,940,162,160,30002,2488,2427,4915,11765,4901,6864,9251,23,13.62,92.6,4.137704918032787,38.57377049180328,1262,98.3672131147541,30.331147540983608,0.46304918032786885
28085,"Lincoln County, Mississippi",34691,16606,18085,20627,22981,2037,956,249,158,34097,2142,2340,4482,8687,3809,4878,12467,145,11.68,92.6,3.928972932460869,25.041076936381195,1363,98.28774033611023,35.93727479749791,0.4786832319621804
28087,"Lowndes County, Mississippi",59785,28561,31224,23141,39356,5574,2447,510,286,57964,3991,4316,8307,12783,5198,7585,25103,274,8,93.7,5.424437567951827,21.381617462574223,3243,96.95408547294471,41.98879317554571,0.47772852722254744
28089,"Madison County, Mississippi",101791,48681,53110,36627,66923,17618,8224,3136,1580,100675,4345,3769,8114,12720,5006,7714,48992,550,10.98,93.8,12.712322307473157,12.496193180143628,12940,98.90363588136476,48.12999184603747,0.47824463852403454
28091,"Marion County, Mississippi",25810,12554,13256,19610,17402,1416,578,126,98,25059,1973,2409,4382,6840,3060,3780,9161,398,14.3,92.7,3.1073227431228205,26.501356063541262,802,97.09027508717551,35.49399457574584,0.48640061991476174
28093,"Marshall County, Mississippi",36196,17809,18387,19775,24478,2206,769,76,143,34915,2876,2826,5702,6230,2808,3422,14048,106,11.31,91.9,2.729583379378937,17.211846612885402,988,96.46093490993479,38.81091833351751,0.49201569234169523
28095,"Monroe County, Mississippi",36029,17184,18845,21643,24560,2726,907,101,91,35597,2164,2380,4544,7308,3134,4174,14027,19,6.53,92.9,3.050320575092287,20.283660384690112,1099,98.80096588858974,38.93252657581393,0.4769491243165228
28097,"Montgomery County, Mississippi",10353,4916,5437,22666,7013,842,333,74,37,10233,411,554,965,2913,1120,1793,3781,51,9.28,93,4.288611996522747,28.136771950159375,444,98.84091567661548,36.52081522264078,0.4748382111465276
28099,"Neshoba County, Mississippi",29474,14131,15343,19243,18645,1884,578,105,111,29065,2415,2087,4502,6463,2659,3804,11951,168,9.02,92.4,2.693899708217412,21.927800773563142,794,98.61233629639682,40.547601275700615,0.4794395060052928
28101,"Newton County, Mississippi",21652,10184,11468,21177,13819,1429,612,37,105,21485,1369,1422,2791,4895,2041,2854,7951,150,9.99,93,3.4823572880103453,22.607611306114908,754,99.22870866432662,36.721780897838535,0.4703491594309994
28103,"Noxubee County, Mississippi",11098,5256,5842,16591,7266,672,352,14,17,10900,1005,735,1740,3510,1524,1986,4009,36,6.91,93.7,3.451072265273022,31.6273202378807,383,98.21589475581186,36.12362587853667,0.47359884663903407
28105,"Oktibbeha County, Mississippi",49424,24879,24545,21322,24909,5321,3040,637,1459,49023,3087,2411,5498,14343,6753,7590,19993,68,7.9,93.7,10.39171252832632,29.020314017481386,5136,99.18865328585302,40.45200712204597,0.5033789252185173
28107,"Panola County, Mississippi",34319,16579,17740,20191,22250,2324,923,163,59,34122,2933,2406,5339,7630,3438,4192,12695,99,12.77,92.1,3.3363442990763135,22.23258253445613,1145,99.42597395028993,36.991171071418165,0.4830851714793555
28109,"Pearl River County, Mississippi",55167,27310,27857,22136,37048,3770,1250,94,143,54214,4443,4165,8608,10886,4830,6056,20214,299,11.1,92.1,2.6954519912266393,19.732811282107058,1487,98.27251799082785,36.64147044428734,0.4950423260282415
28111,"Perry County, Mississippi",12174,5925,6249,19308,8295,549,139,51,8,12090,1217,973,2190,2375,904,1471,3940,183,11.33,92.6,1.6264169541646132,19.508789222934123,198,99.31000492853623,32.36405454246756,0.48669295219319864
28113,"Pike County, Mississippi",39939,18925,21014,17470,25466,2523,1178,127,169,39330,2999,3093,6092,12290,5136,7154,13794,511,14.26,93.1,3.6906282080172264,30.77192718896317,1474,98.47517464132802,34.53766994666867,0.4738476176168657
28115,"Pontotoc County, Mississippi",30862,15393,15469,20421,19928,2059,694,89,94,30616,3278,2364,5642,5517,2618,2899,13007,201,7.95,92.2,2.8416823277817382,17.876352796319097,877,99.20290324671116,42.145680772471,0.49876871233231806
28117,"Prentiss County, Mississippi",25339,12355,12984,19016,16756,1221,614,146,23,25050,1958,1964,3922,5485,2441,3044,9619,64,6.42,91.5,3.0900982674927975,21.646473815067683,783,98.85946564584238,37.961245510872565,0.48758830261652
28119,"Quitman County, Mississippi",7634,3670,3964,15189,5029,470,144,36,0,7467,830,828,1658,2799,1178,1621,2187,4,15.54,92.4,2.3578726748755567,36.66492009431491,180,97.812418129421,28.648152999738013,0.4807440398218496
28121,"Rankin County, Mississippi",147930,71428,76502,29055,100309,19007,7580,1947,1140,142384,8018,6907,14925,13568,5145,8423,69338,240,11.59,93.7,7.21084296626783,9.171905631041708,10667,96.25092949367944,46.87216926924897,0.482849996620023
28123,"Scott County, Mississippi",28268,13707,14561,20520,18170,1506,470,66,100,27998,2709,2440,5149,7412,3350,4062,10713,113,9.7,93.2,2.2498938729305222,26.220461298995332,636,99.04485637469931,37.89797651054196,0.48489458044431866
28125,"Sharkey County, Mississippi",4662,2148,2514,17192,3052,438,109,9,23,4563,569,398,967,1435,629,806,1439,5,12.19,93.4,3.0244530244530243,30.78078078078078,141,97.87644787644787,30.86658086658087,0.46074646074646075
28127,"Simpson County, Mississippi",27279,13309,13970,19336,18086,1498,603,181,24,26683,2219,2095,4314,7299,3374,3925,10075,133,10.46,93.6,2.9619854100223617,26.75684592543715,808,97.81516917775578,36.93317203709813,0.4878844532424209
28129,"Smith County, Mississippi",16137,7733,8404,21864,10764,756,489,25,16,16050,824,1079,1903,3640,1470,2170,6242,188,11.02,93.3,3.2843775175063517,22.556856912685134,530,99.46086633203197,38.681291442027636,0.47920927062031354
28131,"Stone County, Mississippi",17995,9197,8798,21615,11914,1244,383,12,30,17377,1606,1166,2772,3513,1801,1712,7150,88,10.02,91,2.361767157543762,19.522089469297025,425,96.56571269797166,39.73325923867741,0.5110864128924701
28133,"Sunflower County, Mississippi",27424,14350,13074,14427,17856,1710,647,83,85,23725,2387,2200,4587,8109,3408,4701,8293,107,16.14,92,2.9718494749124855,29.568990665110853,815,86.51181446907817,30.239935822637108,0.5232642940490082
28135,"Tallahatchie County, Mississippi",14776,8726,6050,14163,10130,636,203,16,48,10687,735,643,1378,3002,1241,1761,3542,19,13.8,92.4,1.8069842988630211,20.31672983216026,267,72.32674607471576,23.971304818624798,0.5905522468868435
28137,"Tate County, Mississippi",28338,13846,14492,21671,18225,1920,712,238,77,27871,2342,1779,4121,4158,1841,2317,10905,110,13.89,91.9,3.6241089702872467,14.672877408426848,1027,98.3520361352248,38.48189709930129,0.4886018773378502
28139,"Tippah County, Mississippi",22061,10819,11242,19780,14491,1270,602,50,56,21958,1331,1360,2691,5103,2265,2838,8584,82,7.83,91.7,3.2092833507093967,23.131317709985947,708,99.53311273287703,38.91029418430715,0.490412945922669
28141,"Tishomingo County, Mississippi",19503,9461,10042,19379,13650,1002,345,82,55,19247,1326,1356,2682,3581,1555,2026,7815,83,6.49,91.7,2.471414654155771,18.361277752140698,482,98.68738142849818,40.07075834487002,0.4851048556632313
28143,"Tunica County, Mississippi",10407,4809,5598,18486,6292,826,280,88,0,10283,811,821,1632,2925,1145,1780,4147,34,14.53,92.3,3.536081483616796,28.106082444508505,368,98.80849428269434,39.84817911021428,0.4620928221389449
28145,"Union County, Mississippi",27989,13672,14317,19518,18531,1592,965,212,107,27741,2242,1891,4133,5277,1926,3351,11052,42,7.75,92,4.587516524348851,18.853835435349602,1284,99.11393761835006,39.48694129836721,0.48847761620636676
28147,"Walthall County, Mississippi",14812,7253,7559,20155,9826,566,347,42,2,14676,1223,1605,2828,3724,1663,2061,5158,148,16.64,92.7,2.639751552795031,25.141776937618147,391,99.0818255468539,34.8231163921145,0.4896705374021064
28149,"Warren County, Mississippi",47834,22725,25109,22542,31728,4394,2328,396,379,47401,3586,3063,6649,11252,4605,6647,19254,153,11.85,94.1,6.4870176025421245,23.523017100806957,3103,99.09478613538488,40.251703809006145,0.4750804866831124
28151,"Washington County, Mississippi",48824,22920,25904,19247,31122,3790,1316,329,329,48395,4733,5065,9798,16831,7302,9529,16843,107,16.35,93.1,4.043093560543995,34.472800262166146,1974,99.12133377027692,34.49737833852204,0.46944125839750944
28153,"Wayne County, Mississippi",20517,9871,10646,21515,13553,936,556,52,22,20398,1647,1200,2847,5144,2440,2704,7380,307,11.54,92.4,3.0706243602865917,25.071891602086076,630,99.4199931763903,35.97017107764293,0.48111322318077693
28155,"Webster County, Mississippi",9922,4872,5050,20662,6812,870,329,17,45,9835,788,479,1267,2110,903,1207,3639,80,9.47,92.8,3.940737754484983,21.26587381576295,391,99.12316065309413,36.67607337230397,0.4910300342672848
28157,"Wilkinson County, Mississippi",9233,4888,4345,12722,6379,589,192,51,0,8188,778,582,1360,2913,1262,1651,2524,8,18.11,92.4,2.6318639662081664,31.549875446767032,243,88.68190187371385,27.3367269576519,0.5294053936965233
28159,"Winston County, Mississippi",18519,9046,9473,23527,12718,1500,484,85,126,18061,1045,1243,2288,5113,2023,3090,7124,136,8.62,92.8,3.752902424536962,27.60948215346401,695,97.52686430152816,38.468599816404776,0.4884712997462066
28161,"Yalobusha County, Mississippi",12380,5937,6443,20037,8434,693,367,17,71,12196,1002,606,1608,2630,1128,1502,4950,14,11.12,92.4,3.6752827140549273,21.24394184168013,455,98.51373182552504,39.98384491114701,0.4795638126009693
28163,"Yazoo County, Mississippi",27719,15297,12422,16927,18571,1481,687,89,130,23809,2364,1625,3989,8180,3657,4523,8049,56,10.48,93.6,3.2685161802373823,29.510444099715,906,85.89415202568635,29.037844078069195,0.5518597351996826
29001,"Adair County, Missouri",25547,12038,13509,21778,13621,2114,1263,228,548,25242,1091,1118,2209,5929,2759,3170,10849,25,8.16,87.5,7.981367675265197,23.20820448584961,2039,98.80612204955573,42.46682585039339,0.4712099268015814
29003,"Andrew County, Missouri",17347,8574,8773,28003,12005,1865,872,102,40,17139,692,554,1246,1568,836,732,8397,28,7.91,88.8,5.845391133913645,9.039026921081454,1014,98.80094540842796,48.4060644491843,0.49426413789127804
29005,"Atchison County, Missouri",5380,2656,2724,28209,3945,666,153,46,16,5285,363,246,609,635,285,350,2597,8,7.88,89,3.996282527881041,11.802973977695167,215,98.23420074349443,48.27137546468401,0.49368029739776953
29007,"Audrain County, Missouri",25868,11710,14158,21226,17659,1419,599,144,62,24034,1786,1307,3093,4193,1954,2239,10584,244,9.01,88.2,3.1119529921138085,16.209216019792795,805,92.91015927014071,40.915416731096336,0.4526828513994124
29009,"Barry County, Missouri",35716,17958,17758,20840,24688,2111,866,137,49,35416,3525,2883,6408,7876,3596,4280,13885,149,6.46,89,2.9454586179863367,22.051741516407212,1052,99.16004031806473,38.876133945570615,0.5027998656064508
29011,"Barton County, Missouri",12075,5991,6084,24628,8154,913,243,76,6,11955,720,640,1360,2722,1201,1521,4962,17,6.91,89.6,2.691511387163561,22.542443064182194,325,99.00621118012423,41.09316770186335,0.4961490683229814
29013,"Bates County, Missouri",16513,8097,8416,25873,11323,942,537,18,63,16211,1179,1055,2234,2623,1208,1415,7123,49,7.04,88.4,3.742505904438927,15.884454672076545,618,98.17113789135833,43.135711257796885,0.4903409434990613
29015,"Benton County, Missouri",18825,9336,9489,20163,14451,1035,377,81,38,18622,1254,1149,2403,3581,1575,2006,5971,46,8.56,89.2,2.634794156706507,19.02257636122178,496,98.92164674634795,31.718459495351926,0.4959362549800797
29017,"Bollinger County, Missouri",12282,6181,6101,20687,8594,562,212,8,30,12194,728,638,1366,2881,1291,1590,4658,13,10.5,88.6,2.0354991043803943,23.45709167887966,250,99.2835043152581,37.9254193128155,0.5032567985670087
29019,"Boone County, Missouri",172773,83740,89033,28495,101676,26549,12780,3824,4381,171399,7545,6232,13777,31461,14160,17301,89093,607,9.71,88.1,12.145995033946276,18.209442447604662,20985,99.20473685124412,51.566506340689806,0.4846822130772748
29021,"Buchanan County, Missouri",89415,44984,44431,24271,59825,8257,2763,716,517,86414,5686,5129,10815,15652,7136,8516,41283,265,8.25,89.8,4.469048817312531,17.504892915058996,3996,96.64373986467595,46.17010568696527,0.5030923223172846
29023,"Butler County, Missouri",42887,20730,22157,20855,29211,2805,1256,329,168,42251,3126,2091,5217,9053,3644,5409,16879,288,11.2,90.1,4.087485718282929,21.108960757339055,1753,98.51703313358361,39.356914682771006,0.48336325693100474
29025,"Caldwell County, Missouri",9057,4610,4447,24200,6223,826,208,55,22,8861,421,338,759,1153,502,651,3742,28,9.97,88.1,3.146737330241802,12.730484707960693,285,97.83592801148284,41.316109086894116,0.50899856464613
29027,"Callaway County, Missouri",44693,22841,21852,24208,30003,4175,1523,206,235,42137,2002,2298,4300,5354,2242,3112,19465,396,8.59,88.3,4.394424182757926,11.979504620410355,1964,94.28098359922136,43.55268162799543,0.5110643724968116
29029,"Camden County, Missouri",44152,21895,22257,25492,32899,4458,1867,417,272,43703,3512,3661,7173,7943,3572,4371,16772,179,7.41,88.7,5.7890922268526905,17.990125022649032,2556,98.98305852509513,37.986954158362025,0.4959005254575104
29031,"Cape Girardeau County, Missouri",78089,37830,40259,25965,50061,9417,4008,845,676,76947,3362,3454,6816,13236,5944,7292,36486,237,9.93,89.2,7.08038264032066,16.949890509546798,5529,98.5375661104637,46.72361023959841,0.48444723328509776
29033,"Carroll County, Missouri",9009,4366,4643,24642,6248,655,370,43,14,8915,553,564,1117,1632,731,901,3763,48,9.43,88.5,4.73970473970474,18.115218115218116,427,98.95659895659895,41.76934176934177,0.4846264846264846
29035,"Carter County, Missouri",6249,2998,3251,21569,4247,354,106,35,21,6216,578,504,1082,1275,590,685,2410,75,10.76,88.9,2.5924147863658185,20.40326452232357,162,99.47191550648104,38.56617058729397,0.47975676108177306
29037,"Cass County, Missouri",101324,49752,51572,30618,67897,11052,4858,809,448,100456,4491,3917,8408,9330,3770,5560,48407,239,6.37,88.2,6.035095337728475,9.208084955193241,6115,99.14334214993487,47.77446606924322,0.49101890963641387
29039,"Cedar County, Missouri",13932,6940,6992,20228,9669,950,330,112,44,13788,1178,1043,2221,3171,1678,1493,5050,35,6.15,89.5,3.488372093023256,22.760551248923342,486,98.96640826873384,36.247487797875394,0.49813379270743613
29041,"Chariton County, Missouri",7615,3769,3846,23463,5378,557,251,17,23,7396,274,276,550,1130,545,585,3272,33,6.27,88.9,3.8214051214707814,14.83913328956008,291,97.12409717662509,42.96782665791201,0.4949441891004596
29043,"Christian County, Missouri",82053,39892,42161,26628,54396,9810,3361,689,539,81589,4697,4111,8808,8935,3731,5204,37721,503,6.69,88.4,5.592726652285718,10.889303255213093,4589,99.43451183990835,45.971506221588484,0.4861735707408626
29045,"Clark County, Missouri",6860,3468,3392,26253,4784,416,151,22,0,6768,457,487,944,928,461,467,3149,59,6.76,87.1,2.521865889212828,13.527696793002915,173,98.65889212827989,45.903790087463555,0.5055393586005831
29047,"Clay County, Missouri",233135,114237,118898,31953,155930,33780,12357,2535,1033,231632,11299,9828,21127,20867,9412,11455,118872,792,11.63,89,6.830806185257469,8.950608016814293,15925,99.35530915563943,50.988483067750444,0.49000364595620566
29049,"Clinton County, Missouri",20494,10286,10208,27655,14059,1869,541,139,65,20025,1191,1176,2367,1887,771,1116,9699,55,11.32,88.5,3.635210305455255,9.207572948179955,745,97.71152532448521,47.32604664779936,0.5019029959988289
29051,"Cole County, Missouri",76603,38731,37872,27559,51995,10752,4317,1011,423,72589,3447,3203,6650,9067,4299,4768,36044,352,7.15,88.7,7.507538869234886,11.836351056747125,5751,94.75999634479068,47.05298748090806,0.5056068300197121
29053,"Cooper County, Missouri",17613,9266,8347,22371,12030,1681,624,120,40,16048,866,741,1607,2137,959,1178,7740,52,8.97,88.2,4.451257593822745,12.133083517856129,784,91.11451768580027,43.94481349003577,0.5260886844944075
29055,"Crawford County, Missouri",24545,12098,12447,20799,16873,1347,567,74,123,24253,1930,1899,3829,5166,2374,2792,9187,40,6.98,88,3.1126502342635973,21.04705642697087,764,98.81034833978407,37.42921165206763,0.4928906090853534
29057,"Dade County, Missouri",7590,3871,3719,20468,5459,514,227,51,23,7453,707,546,1253,1520,792,728,3117,45,6.22,89.7,3.9657444005270093,20.02635046113307,301,98.19499341238472,41.06719367588933,0.5100131752305666
29059,"Dallas County, Missouri",16508,8209,8299,19647,11363,975,425,61,34,16306,1723,1677,3400,2970,1401,1569,5710,109,9.48,88.2,3.149987884661982,17.99127695662709,520,98.776350860189,34.58929004119215,0.4972740489459656
29061,"Daviess County, Missouri",8257,4172,4085,22642,5451,670,146,45,56,8049,798,724,1522,1301,560,741,3357,100,8.77,88.2,2.99140123531549,15.756327964151629,247,97.4809252755238,40.65641274070486,0.5052682572362843
29063,"DeKalb County, Missouri",12706,8016,4690,18994,9477,967,276,25,19,9206,440,368,808,1296,557,739,4119,66,9.04,88.2,2.5184951991185267,10.199905556430034,320,72.45395875964111,32.41775539115378,0.630883047379191
29065,"Dent County, Missouri",15578,7764,7814,20908,10914,872,431,48,21,15400,1589,1239,2828,3426,1543,1883,5768,151,8.21,86.9,3.2096546411606113,21.99255360123251,500,98.85736294774682,37.02657594042881,0.4983951726794197
29067,"Douglas County, Missouri",13467,6749,6718,18095,9663,590,276,34,11,13346,1158,1112,2270,2704,1380,1324,4887,31,7.13,88,2.3836043662285586,20.078710922996954,321,99.10150738843097,36.288705725105814,0.5011509616098612
29069,"Dunklin County, Missouri",31271,15043,16228,18878,20521,1407,600,280,62,30587,2578,2551,5129,8355,3744,4611,11341,92,8.92,91,3.0123756835406605,26.718045473441848,942,97.81266988583671,36.26682869111957,0.48105273256371717
29071,"Franklin County, Missouri",102063,50830,51233,27209,69763,8867,3917,614,363,101300,5008,4590,9598,12057,5583,6474,48448,229,7.65,89.2,4.7950775501406,11.813291790364774,4894,99.25242252334343,47.46872030020673,0.49802572920647054
29073,"Gasconade County, Missouri",14875,7389,7486,25963,10646,1169,486,51,40,14608,642,554,1196,2074,979,1095,6493,12,8.65,88.5,3.8789915966386554,13.942857142857143,577,98.20504201680673,43.65042016806723,0.49673949579831933
29075,"Gentry County, Missouri",6745,3242,3503,20903,4590,643,202,22,25,6583,374,358,732,1039,481,558,2975,27,8.57,87.4,3.6916234247590807,15.404002965159377,249,97.5982209043736,44.106745737583395,0.48065233506300964
29077,"Greene County, Missouri",285449,139153,146296,25529,185485,35508,14165,3247,2507,281556,19829,16700,36529,51145,22063,29082,134341,1041,7.19,88.8,6.9781291929556595,17.917386293173212,19919,98.63618369656226,47.06304804010524,0.487488132731241
29079,"Grundy County, Missouri",10231,4950,5281,22014,6870,763,392,89,39,10050,911,743,1654,1975,911,1064,4354,60,8.79,88.2,5.082592121982211,19.304075847913204,520,98.23086697292543,42.55693480598182,0.48382367315022967
29081,"Harrison County, Missouri",8649,4305,4344,20947,5929,602,174,40,9,8439,682,569,1251,1564,720,844,3731,83,8.72,87.2,2.578332755231819,18.08301537750029,223,97.57197363857094,43.13793502138976,0.4977454040929587
29083,"Henry County, Missouri",21930,10847,11083,24371,15554,1674,609,86,37,21692,1598,1259,2857,4575,2190,2385,9027,87,7.9,88.8,3.337893296853625,20.861833105335158,732,98.91472868217055,41.16279069767442,0.49461924304605565
29085,"Hickory County, Missouri",9267,4523,4744,19711,7174,468,173,37,26,9183,753,700,1453,2295,1007,1288,2936,77,8.67,88.8,2.5466709830581635,24.76529621236646,236,99.09355778569116,31.682313585842238,0.48807596849034207
29087,"Holt County, Missouri",4537,2274,2263,25306,3345,462,177,20,13,4420,242,228,470,614,315,299,2125,23,8.49,89.4,4.628609213136434,13.53317169936081,210,97.42120343839541,46.837117037690106,0.5012122547939167
29089,"Howard County, Missouri",10148,5075,5073,23430,6566,1049,489,34,90,10022,485,376,861,1719,906,813,4731,89,8.49,88.1,6.040599132834056,16.939298383918015,613,98.75837603468663,46.62002364998029,0.5000985415845487
29091,"Howell County, Missouri",40265,19617,20648,20274,27214,2144,1260,333,175,39841,2452,2692,5144,8980,3991,4989,16125,164,8.26,89.4,4.390910219793866,22.30224760958649,1768,98.94697628213088,40.047187383583754,0.48719731776977526
29093,"Iron County, Missouri",10220,5071,5149,19414,7259,504,255,18,49,9883,852,722,1574,2124,1098,1026,3714,59,9.24,86.7,3.1506849315068495,20.782778864970645,322,96.70254403131115,36.34050880626223,0.4961839530332681
29095,"Jackson County, Missouri",683643,330662,352981,28965,459102,85778,35470,8893,4957,676819,47766,42165,89931,115709,51744,63965,326636,3229,9.09,88.4,7.214291669775014,16.925354315044547,49320,99.00181820043503,47.778738318098775,0.48367642175813985
29097,"Jasper County, Missouri",117376,57174,60202,23390,76064,11382,4188,597,610,116332,8440,8043,16483,20393,9190,11203,55280,342,6.31,90,4.5963399672846235,17.37407988004362,5395,99.110550708833145,47.096510359869136,0.48710128135223557
29099,"Jefferson County, Missouri",222453,110600,111853,27443,151205,18769,7426,837,837,220838,11218,9936,21154,24089,11000,13089,106506,285,8.33,89.1,4.090751754303156,10.828804286748213,9100,99.27400394690115,47.87797871910021,0.49718367475376823
29101,"Johnson County, Missouri",54229,27952,26277,23304,31046,5175,2523,395,535,50409,2750,2324,5074,8426,4431,3995,26552,112,8.82,88.8,6.3674417746961955,15.537811871876672,3453,92.95579855796714,48.96273211750171,0.5154437662505301
29103,"Knox County, Missouri",3997,2025,1972,22171,2714,287,98,14,22,3920,386,401,787,786,377,409,1646,7,8.98,87.9,3.352514385789342,19.664748561421067,134,98.07355516637477,41.18088566424819,0.5066299724793595
29105,"Laclede County, Missouri",35505,17608,17897,20534,24121,2316,715,170,97,35149,2652,2704,5356,6698,3170,3528,14720,159,7.79,87.2,2.765807632727785,18.864948598788903,982,98.99732432051823,41.458949443740316,0.4959301506830024
29107,"Lafayette County, Missouri",32789,16121,16668,27260,22568,2861,969,103,202,32286,1817,1379,3196,3912,1486,2426,14926,245,10.24,88.5,3.885449388514441,11.930830461435237,1274,98.46594894629297,45.52136387203026,0.4916587880081735
29109,"Lawrence County, Missouri",38204,19079,19125,21022,25512,2871,1088,134,42,37621,3055,2780,5835,6803,3123,3680,15751,251,5.92,89,3.3085540781070044,17.8070359124699,1264,98.47398178201236,41.2286671552717,0.4993979687990786
29111,"Lewis County, Missouri",10146,5094,5052,22083,6608,542,241,53,85,9950,517,534,1051,1299,578,721,4745,53,8.2,88,3.7354622511334514,12.803075103489059,379,98.0682042184112,46.767198896116696,0.5020697811945595
29113,"Lincoln County, Missouri",54286,27178,27108,24023,35324,3625,1405,134,210,53787,2452,2726,5178,7358,3193,4165,23753,221,7.36,89.4,3.2218251482886933,13.554139188741113,1749,99.08079431160888,43.75529602475776,0.5006447334487714
29115,"Linn County, Missouri",12319,5900,6419,22361,8459,794,302,119,18,12246,814,866,1680,2241,926,1315,5302,70,7.75,88.4,3.563600941634873,18.19141164055524,439,99.40741943339557,43.03920772789999,0.4789349784885137
29117,"Livingston County, Missouri",15057,6773,8284,22248,10682,1450,555,98,9,13872,987,897,1884,2463,1059,1404,6571,68,8.4,88.4,4.39662615394833,16.357840207212593,662,92.12990635584778,43.640831506940295,0.44982400212525736
29119,"McDonald County, Missouri",22720,11570,11150,19577,14827,1241,438,166,127,22563,2471,2447,4918,4636,2142,2494,9082,85,7.19,90.5,3.2174295774647885,20.404929577464788,731,99.30897887323944,39.973591549295776,0.5092429577464789
29121,"Macon County, Missouri",15399,7595,7804,20890,10626,1203,395,56,27,15130,939,850,1789,2845,1285,1560,6369,81,8.12,87.9,3.1040976686797843,18.475225664004157,478,98.25313332034548,41.35982856029612,0.4932138450548737
29123,"Madison County, Missouri",12403,6087,6316,20081,8576,754,222,29,47,12223,783,765,1548,1978,762,1216,5025,95,8.67,87.4,2.402644521486737,15.947754575505925,298,98.54873820849794,40.51439167943239,0.49076836249294525
29125,"Maries County, Missouri",8987,4453,4534,22087,6367,612,200,64,13,8879,530,636,1166,1675,830,845,3587,38,8.17,88.1,3.0822298876154446,18.638032713920108,277,98.79826415934127,39.913207967063535,0.4954934905975298
29127,"Marion County, Missouri",28858,13914,14944,22662,19339,2717,906,214,122,28184,1705,1841,3546,4734,2130,2604,13072,86,7.11,88.2,4.303832559428928,16.404463233765334,1242,97.66442580913439,45.29766442580913,0.48215399542587845
29129,"Mercer County, Missouri",3702,1856,1846,20374,2515,271,126,14,13,3646,381,307,688,530,243,287,1583,14,6.86,86.9,4.13290113452188,14.31658562938952,153,98.48730415991356,42.76066990815775,0.5013506212857914
29131,"Miller County, Missouri",25011,12354,12657,23346,17171,1793,799,60,38,24716,1694,1360,3054,4763,2072,2691,10697,202,7.15,88.7,3.5864219743312944,19.043620806844988,897,98.82051897165248,42.76918156011355,0.4939426652273
29133,"Mississippi County, Missouri",14112,7568,6544,17918,9865,812,230,84,0,12385,1113,1072,2185,3752,1471,2281,4912,24,8.41,90.2,2.2250566893424035,26.58730158730159,314,87.76218820861678,34.807256235827666,0.536281179138322
29135,"Moniteau County, Missouri",15840,8295,7545,21305,10584,1476,370,51,38,14490,1087,1089,2176,1779,851,928,6718,115,7.19,88.3,2.897727272727273,11.231060606060606,459,91.47727272727273,42.41161616161616,0.5236742424242424
29137,"Monroe County, Missouri",8642,4333,4309,22255,6118,575,229,38,16,8533,629,630,1259,1333,620,713,3822,75,8.47,87.9,3.2747049294144874,15.424670215227957,283,98.73871788937745,44.22587364036103,0.5013885674612358
29139,"Montgomery County, Missouri",11820,5885,5935,21757,8298,716,352,21,32,11486,651,571,1222,1999,858,1141,4966,26,7.77,89.4,3.4263959390862944,16.912013536379018,405,97.17428087986464,42.01353637901861,0.4978849407783418
29141,"Morgan County, Missouri",20182,10136,10046,20055,14402,1158,404,104,25,19847,2420,2373,4793,4798,2421,2377,6961,258,5.99,88.7,2.640967198493707,23.773659696759488,533,98.3401050440987,34.49113071053414,0.5022297096422554
29143,"New Madrid County, Missouri",18229,8758,9471,20261,12554,839,525,23,7,17864,1602,1767,3369,4370,1930,2440,6861,34,8.36,90.7,3.044599264907565,23.972790608371277,555,97.99769597893466,37.637829831587034,0.480443249766855
29145,"Newton County, Missouri",58741,29291,29450,25837,39172,4685,1816,482,239,58116,4579,4261,8840,8294,3777,4517,25885,336,5.63,90.6,4.31895950017875,14.119609812567031,2537,98.93600721812703,44.066325054050836,0.4986466011814576
29147,"Nodaway County, Missouri",23026,11399,11627,21056,12566,1747,862,251,278,22183,1231,1201,2432,5046,2251,2795,11123,83,6.97,88.1,6.040997133674976,21.91435768261965,1391,96.33892121949101,48.30626248588552,0.4950490749587423
29149,"Oregon County, Missouri",10922,5384,5538,18309,7707,615,290,18,45,10787,848,916,1764,2809,1232,1577,3941,91,8.69,90.2,3.2320087895989746,25.718732832814503,353,98.763962644204355,36.08313495696759,0.49295000915583226
29151,"Osage County, Missouri",13704,7153,6551,24995,9255,1281,398,74,13,13566,556,304,860,923,483,440,6682,59,8.45,88.4,3.539112667834209,6.7352597781669585,485,98.99299474605955,48.7594862813777,0.521964389959136
29153,"Ozark County, Missouri",9450,4739,4711,17857,7070,479,236,66,30,9393,776,710,1486,2546,1176,1370,3047,20,6.44,89.6,3.513227513227513,26.941798941798943,332,99.39682539682539,32.24338624338624,0.5014814814814815
29155,"Pemiscot County, Missouri",17599,8318,9281,18883,11387,869,391,28,40,17421,1333,1462,2795,5036,2063,2973,6358,46,9.76,91,2.6081027331098356,28.61526223080857,459,98.98857889652821,36.12705267344735,0.47264049093698507
29157,"Perry County, Missouri",19152,9481,9671,24846,12956,1383,508,169,27,18837,746,651,1397,1487,642,845,9205,23,8.34,88.7,3.6758563074352546,7.764202172096909,704,98.35526315789474,48.062865497076025,0.49503968253968256
29159,"Pettis County, Missouri",42193,20704,21489,22304,27875,3165,1116,326,196,41436,3223,2780,6003,7000,3034,3966,18521,56,8.94,88.6,3.882160547958192,16.590429692129025,1638,98.20586353186548,43.895906903988816,0.4906975090654848
29161,"Phelps County, Missouri",44833,23404,21429,23691,27780,4210,2221,479,827,43958,2477,2058,4535,8620,4557,4063,18702,193,7.24,87.9,7.866972988646756,19.22690875025093,3527,98.04831262685968,41.71480828853746,0.5220261860682979
29163,"Pike County, Missouri",18475,10249,8226,20947,12757,1220,375,90,13,16204,1239,990,2229,2447,1022,1425,7426,94,8.95,89.1,2.5872801082543977,13.244925575101488,478,87.70771312584574,40.19485791610284,0.5547496617050067
29165,"Platte County, Missouri",94970,46798,48172,37443,64196,16503,7302,1475,866,94004,3443,3609,7052,6689,2732,3957,50502,209,9.97,89.8,10.153732757712962,7.043276824260293,9643,98.98283668526904,53.17679267136991,0.4927661366747394
29167,"Polk County, Missouri",31113,15225,15888,21357,19738,2317,1233,165,156,30708,1881,1995,3876,5228,2353,2875,13151,37,7.83,89.3,4.99469675055443,16.803265516022243,1554,98.6982933179057,42.268505126474466,0.48934528975026514
29169,"Pulaski County, Missouri",53302,30338,22964,21716,28651,4528,2031,130,152,39900,2542,2302,4844,6372,2817,3555,28210,97,7.8,88.3,4.339424411841957,11.954523282428427,2313,74.85647818093129,52.92484334546546,0.5691718884844846
29171,"Putnam County, Missouri",4877,2448,2429,20729,3432,424,172,22,15,4821,336,368,704,900,413,487,2137,7,8.2,86.3,4.285421365593603,18.453967603034652,209,98.85175312692229,43.81792085298339,0.5019479188025425
29173,"Ralls County, Missouri",10225,5191,5034,24687,7264,616,246,52,9,10165,565,523,1088,1268,572,696,4791,17,8.27,88.4,3.002444987775061,12.400977995110024,307,99.41320293398533,46.8557457212714,0.507677261613692
29175,"Randolph County, Missouri",25081,13155,11926,19984,17167,1599,640,115,117,23025,1311,1270,2581,4025,1841,2184,9559,44,6.36,87.9,3.4767353773772975,16.048004465531676,872,91.80255970655078,38.11251544994219,0.5245006179976875
29177,"Ray County, Missouri",22921,11340,11581,26781,15717,1511,572,76,21,22654,1109,942,2051,3619,1760,1859,9856,28,9.3,88.3,2.9187208236987914,15.789014440905719,669,98.83512935735789,42.99986911565813,0.49474281226822564
29179,"Reynolds County, Missouri",6530,3374,3156,21593,4745,305,117,8,3,6385,400,431,831,1245,625,620,2392,47,8.85,87.5,1.9601837672281777,19.06584992343032,128,97.77947932618683,36.63093415007657,0.5166921898928024
29181,"Ripley County, Missouri",13936,6897,7039,18434,9650,672,298,68,53,13865,1225,963,2188,3312,1453,1859,5161,86,13.12,89.7,3.006601607347876,23.765786452353616,419,99.49052812858783,37.03358208955224,0.4949052812858783
29183,"St. Charles County, Missouri",379856,186762,193094,35628,254000,60331,26554,2715,2211,377983,11924,11271,23195,22765,9862,12903,200349,1260,6.96,89.6,8.28735099616697,5.99306052820016,31480,99.5069184111874,52.74340802830546,0.49166526262583715
29185,"St. Clair County, Missouri",9444,4750,4694,20827,7014,455,243,67,38,9199,841,718,1559,2052,952,1100,3251,91,7.34,89.3,3.684879288437103,21.72808132147395,348,97.40576027107159,34.423972892842016,0.5029648454044896
29186,"Ste. Genevieve County, Missouri",17937,9037,8900,26418,12420,1143,470,62,57,17729,415,720,1135,2561,985,1576,8267,54,7.85,88,3.2837152255115125,14.277749902436305,589,98.84038579472599,46.089089591347495,0.5038189217817918
29187,"St. Francois County, Missouri",66230,35676,30554,20944,46050,3947,1884,315,192,59694,4187,3476,7663,9955,4650,5305,25795,207,9.29,87.1,3.6101464593084707,15.030952740449948,2391,90.13136041069002,38.94760682470179,0.5386682772157633
29189,"St. Louis County, Missouri",1000560,474388,526172,38081,687472,169996,85313,22202,13854,988628,42118,38709,80827,100613,42309,58304,486100,3221,6.31,89.6,12.130107140001599,10.055668825457744,121369,98.8074678180219,48.58279363556409,0.47412249140481333
29195,"Saline County, Missouri",23214,11587,11627,21729,15127,1761,865,143,82,22756,1048,1059,2107,3748,1759,1989,10520,136,9.53,88.6,4.69544240544499,16.14542948220901,1090,98.02705264064788,45.3174808305333,0.4991384509347807
29197,"Schuyler County, Missouri",4396,2155,2241,19882,2901,206,125,26,7,4345,454,328,782,951,452,499,1872,27,8.79,87,3.59417652411283,21.633303002729754,158,98.83985441310283,42.584167424931756,0.49021838034576887
29199,"Scotland County, Missouri",4893,2388,2505,23785,3121,294,117,4,22,4796,803,599,1402,781,292,489,2169,40,8.29,87.3,2.9225424075209485,15.961577764152871,143,98.01757612916411,44.32863274064991,0.4880441446965052
29201,"Scott County, Missouri",38994,18943,20051,22939,26422,2255,1069,253,95,38509,2379,2543,4922,7467,3230,4237,17060,86,7.18,90,3.6338923937015952,19.149099861517158,1417,98.75621890547264,43.750320562137766,0.48579268605426473
29203,"Shannon County, Missouri",8256,4056,4200,17903,5766,585,224,39,19,8191,747,646,1393,1831,781,1050,3110,65,9.78,89,3.4156976744186047,22.17781007751938,282,99.2126937984496,37.66957364341085,0.49127906976744184
29205,"Shelby County, Missouri",6148,3065,3083,22349,4241,402,147,19,25,5936,469,414,883,928,407,521,2900,13,8.35,87.8,3.106701366297983,15.09433962264151,191,96.55172413793103,47.16981132075472,0.4985361093038386
29207,"Stoddard County, Missouri",29788,14509,15279,21684,20830,1833,800,121,73,29383,2098,1804,3902,4848,1936,2912,11985,167,8.35,89.9,3.3369141936350206,16.2750100711696,994,98.64039210420303,40.234322545991674,0.48707533234859673
29209,"Stone County, Missouri",31197,15297,15900,26052,23805,2757,943,185,128,30890,2063,2154,4217,4139,1808,2331,12015,30,6.43,89.6,4.026028143731769,13.26730134307786,1256,99.01593101900824,38.5133185883258,0.49033560919319163
29211,"Sullivan County, Missouri",6416,3255,3161,21168,4444,321,165,16,13,6325,432,420,852,1037,411,626,2724,22,8.05,87.1,3.0236907730673317,16.16271820448878,194,98.58167082294264,42.45635910224439,0.5073254364089775
29213,"Taney County, Missouri",53853,26219,27634,21381,37036,4644,1555,423,210,53400,5092,5268,10360,9264,4164,5100,23259,133,6.15,89.4,4.06291200118842,17.20238426828589,2188,99.15882123558576,43.189794440421146,0.48686238463966724
29215,"Texas County, Missouri",25690,13201,12489,17918,17760,1642,615,91,48,24195,2178,1926,4104,6301,3149,3152,8746,34,8.08,87.3,2.9349941611521992,24.527053328143246,754,94.18061502530168,34.04437524328532,0.5138575321136629
29217,"Vernon County, Missouri",20836,10209,10627,22369,13921,1387,642,183,48,20363,1795,1681,3476,3499,1544,1955,9065,99,6.11,89.2,4.189863697446727,16.79305048953734,873,97.72989057400653,43.50643117680937,0.48996928393165673
29219,"Warren County, Missouri",33290,16777,16513,26845,22813,2800,1080,189,85,33114,1941,1871,3812,4506,2193,2313,14406,85,7.6,89.8,4.06728747371583,13.535596275157705,1354,99.471312706518475,43.27425653349354,0.5039651547011115
29221,"Washington County, Missouri",25002,12835,12167,18314,17250,886,381,90,15,23888,1876,1751,3627,4678,2099,2579,8797,70,9.34,88.1,1.9438444924406046,18.71050315974722,486,95.54435645148388,35.18518518518518,0.5133589312854971
29223,"Wayne County, Missouri",13341,6640,6701,18897,9626,843,188,40,70,13195,978,902,1880,3003,1313,1690,4542,31,12.01,88.4,2.2337156135222247,22.509557004722286,298,98.90562926317368,34.04542388126827,0.49771381455662994
29225,"Webster County, Missouri",37075,18883,18192,20468,24057,2421,1126,224,125,36166,3166,2899,6065,6737,3124,3613,14463,166,10.2,86.9,3.978422117329737,18.17127444369521,1475,97.54821308159137,39.01011463250168,0.5093189480782199
29227,"Worth County, Missouri",2061,984,1077,22961,1500,161,64,26,9,2001,122,111,233,262,103,159,970,1,7.91,86.9,4.8034934497816595,12.712275594371665,99,97.08879184861718,47.06453178068899,0.4774381368267831
29229,"Wright County, Missouri",18378,9003,9375,19805,12416,811,400,90,89,18184,1799,1556,3355,4560,2121,2439,6494,105,8.58,86.6,3.1505060398302316,24.812275546849495,579,98.94439003155948,35.335727500272064,0.489879203395364
29510,"St. Louis city, Missouri",316030,152766,163264,26739,218566,40651,20825,5979,4688,311212,24291,21385,45676,81916,36978,44938,146727,1234,6.96,90,9.964876752207068,25.920324019871533,31492,98.47546119039332,46.42818719741797,0.4833908173274689
30001,"Beaverhead County, Montana",9317,4649,4668,28420,6279,1299,367,135,137,9186,537,498,1035,1508,628,880,4429,48,3.36,75,6.858430825372974,16.185467425136846,639,98.59396801545562,47.536760759901256,0.49898035848449074
30003,"Big Horn County, Montana",13214,6522,6692,17905,7537,763,295,38,90,13075,2632,2496,5128,3615,1696,1919,4748,61,3.61,86.7,3.2011502951415167,27.357348266989558,423,98.94808536400787,35.93158771000454,0.49356742848494023
30005,"Blaine County, Montana",6609,3283,3326,17059,4019,598,154,12,23,6513,958,917,1875,1856,840,1016,2508,33,4.3,80.8,2.8597367226509305,28.082917234074745,189,98.547435315478893,37.94825238311394,0.4967468603419579
30007,"Broadwater County, Montana",5692,2928,2764,32268,4161,801,299,12,24,5646,398,289,687,471,194,277,2473,65,3.36,80,5.885453267744202,8.274771609276177,335,99.19184820801124,43.44694307800422,0.5144061841180604
30009,"Carbon County, Montana",10340,5171,5169,31697,7863,1539,522,121,111,10260,561,605,1166,1108,498,610,4965,98,2.64,81.1,7.292069632495164,10.715667311411993,754,99.22630560928434,48.0174081237911,0.5000967117988394
30011,"Carter County, Montana",1295,625,670,30659,951,138,18,2,5,1273,91,114,205,160,50,110,620,14,2.43,88.4,1.9305019305019304,12.355212355212355,25,98.3011583011583,47.87644787644788,0.4826254826254826
30013,"Cascade County, Montana",82049,41248,40801,28350,55400,9752,3535,878,206,78264,4632,4416,9048,11694,5094,6600,38785,198,3.06,80.8,5.629562822215993,14.25245889651306,4619,95.38690294823824,47.270533461711906,0.5027239820107496
30015,"Chouteau County, Montana",5837,2898,2939,22014,3891,733,201,16,13,5793,545,561,1106,1257,563,694,2468,15,3.15,82.9,3.940380332362515,21.535035120781224,230,99.24618811033065,42.28199417508994,0.4964879218776769
30017,"Custer County, Montana",11980,5999,5981,28501,8317,1254,297,56,44,11741,595,527,1122,1289,561,728,6251,32,3.31,89.6,3.313856427378965,10.759599332220366,397,98.00500834724541,52.17863105175292,0.5007512520868114
30019,"Daniels County, Montana",1787,878,909,36108,1315,245,56,7,4,1756,35,57,92,84,34,50,957,0,3.44,80.4,3.749300503637381,4.700615556799105,67,98.2652490207051,53.55344152210409,0.49132624510352546
30021,"Dawson County, Montana",9431,4975,4456,29130,6517,935,234,60,3,9107,470,417,887,1365,810,555,4667,24,3.14,84.5,3.1491888452974233,14.473544693033613,297,96.56452125967554,49.485738521895875,0.5275156399109321
30023,"Deer Lodge County, Montana",9176,4883,4293,25107,6843,717,288,64,19,8628,709,474,1183,1785,856,929,3749,31,2.92,73.9,4.043156059285091,19.452920662598082,371,94.02789886660854,40.85658238884045,0.5321490845684395
30025,"Fallon County, Montana",2913,1525,1388,32371,1978,203,36,3,50,2861,180,149,329,197,62,135,1509,8,3.51,86.1,3.0552694816340544,6.762787504291109,89,98.21489872983179,51.80226570545829,0.5235152763474081
30027,"Fergus County, Montana",11429,5750,5679,27491,8398,1890,390,72,50,11236,802,697,1499,1574,740,834,5279,63,4.12,81.3,4.479832006299763,13.771983550616852,512,98.31131332575029,46.18951789307901,0.503106133519993
30029,"Flathead County, Montana",94696,47281,47415,28379,66344,13146,3765,1458,821,94104,7105,6103,13208,12875,6079,6796,43478,311,8.35,73.7,6.3825293571006165,13.59613922446566,6044,99.37484159837797,45.91323815155867,0.499292472754921
30031,"Gallatin County, Montana",97958,50509,47449,33181,61913,19538,6802,1600,1790,97611,5637,4308,9945,12716,6562,6154,53521,264,4.29,77.5,10.404459053880235,12.98107352130505,10192,99.64576655301252,54.63668102656241,0.515618938728843
30033,"Garfield County, Montana",1061,510,551,29896,758,80,25,6,0,1061,78,83,161,71,35,36,549,5,3.49,84.3,2.9217719132893496,6.691800188501413,31,100,51.74363807728558,0.4806786050895382
30035,"Glacier County, Montana",13695,6722,6973,16737,7991,1056,249,127,27,13564,2899,2733,5632,4502,2102,2400,4485,11,4.28,73.6,2.9426798101496896,32.87331142752829,403,99.04344651332603,32.74917853231106,0.49083607155896314
30037,"Golden Valley County, Montana",730,344,386,25110,573,105,30,0,0,730,33,78,111,119,43,76,334,1,2.66,82.8,4.109589041095891,16.301369863013697,30,100,45.75342465753425,0.4712328767123288
30039,"Granite County, Montana",3212,1648,1564,29144,2443,369,198,24,20,3185,211,184,395,456,230,226,1142,11,2.91,74.1,7.534246575342466,14.196762141967621,242,99.15940224159402,35.55417185554172,0.5130759651307597
30041,"Hill County, Montana",16529,8355,8174,21780,10303,1773,476,66,105,16397,1108,1312,2420,3532,1501,2031,6993,60,3.2,81.5,3.9143323855042653,21.36850384173271,647,99.20140359368384,42.30745961643173,0.5054752253614859
30043,"Jefferson County, Montana",11601,5958,5643,32387,8437,1944,605,126,115,11425,548,540,1088,973,505,468,5260,70,2.66,77.7,7.292474786656323,8.387207999310403,846,98.48288940608568,45.3409188863029,0.5135764158262219
30045,"Judith Basin County, Montana",1981,1034,947,28709,1554,420,59,4,4,1981,86,124,210,249,131,118,963,0,4.01,77.6,3.382130237253912,12.569409389197375,67,100,48.6118122160525,0.5219586067642604
30047,"Lake County, Montana",29311,14418,14893,24348,19912,3084,1273,389,221,29144,3426,3128,6554,6206,3099,3107,11608,70,5.69,78.7,6.424209341202961,21.172938487257344,1883,99.43024802974992,39.60287946504725,0.4918972399440483
30049,"Lewis and Clark County, Montana",65989,32839,33150,31252,46073,11169,4436,1173,494,65349,3144,2650,5794,7786,3780,4006,33306,204,2.94,76.4,9.248511115488945,11.798936186334085,6103,99.0301413872009,50.472048371698314,0.4976435466517147
30051,"Liberty County, Montana",2292,1137,1155,36525,1641,259,30,6,7,2270,148,132,280,349,146,203,971,6,2.94,80.9,1.8760907504363002,15.226876090750435,43,99.04013961605585,42.36474694589878,0.49607329842931935
30053,"Lincoln County, Montana",19268,9639,9629,22483,14616,1998,607,139,27,19098,1665,1439,3104,3410,1510,1900,6626,142,8.91,76.4,4.0118330911355615,17.697737180817935,773,99.11770811708533,34.38862362466266,0.500259497612622
30055,"McCone County, Montana",1678,914,764,28230,1242,182,11,8,3,1656,63,30,93,175,102,73,834,2,3.38,84,1.3110846245530394,10.429082240762813,22,98.68891537544697,49.70202622169249,0.5446960667461264
30057,"Madison County, Montana",7810,4046,3764,31620,6176,1147,333,72,88,7750,623,529,1152,874,426,448,3765,64,4.02,77.1,6.312419974391806,11.19078104993598,493,99.23175416133162,48.20742637644046,0.5180537772087068
30059,"Meagher County, Montana",1960,937,1023,20095,1437,241,48,13,3,1933,170,160,330,295,107,188,917,10,3.82,76.1,3.2653061224489797,15.051020408163266,64,98.62244897959184,46.785714285714285,0.47806122448979593
30061,"Mineral County, Montana",4223,2155,2068,22894,3119,278,65,22,30,4169,402,182,584,869,392,477,1550,9,8.09,77.2,2.7705422685294816,20.577788302154865,117,98.72128818375562,36.703765095903385,0.510300734075302
30063,"Missoula County, Montana",113101,56928,56173,29681,74509,19180,7758,2451,1768,112445,7608,6206,13814,17671,8378,9293,58673,349,5.71,77,10.589649958886305,15.624088204348325,11977,99.41998744485018,51.876641232173014,0.5033377246885528
30065,"Musselshell County, Montana",4778,2374,2404,23908,3413,309,137,47,5,4745,317,295,612,795,344,451,1858,0,3.35,84.2,3.955629970699037,16.63876098786103,189,99.30933444956048,38.88656341565508,0.49686061113436586
30067,"Park County, Montana",15843,7917,7926,29181,11836,2773,1013,260,121,15757,1281,862,2143,1905,856,1049,7758,70,5.03,76.5,8.798838603799785,12.024237833743609,1394,99.45717351511709,48.96799848513539,0.4997159628858171
30069,"Petroleum County, Montana",445,239,206,31549,357,43,27,4,2,445,41,61,102,69,38,31,246,2,3.76,84.2,7.415730337078652,15.50561797752809,33,100,55.28089887640449,0.5370786516853933
30071,"Phillips County, Montana",4150,2086,2064,22369,2927,400,98,11,0,4109,494,371,865,664,296,368,1650,16,4.19,82.4,2.6265060240963853,16,109,99.01204819277109,39.75903614457831,0.5026506024096385
30073,"Pondera County, Montana",6166,3100,3066,22866,4194,718,149,51,33,6095,517,383,900,1228,611,617,2559,7,2.84,78.4,3.7787868958806357,19.91566655854687,233,98.84852416477457,41.501783976646124,0.5027570548167369
30075,"Powder River County, Montana",1648,811,837,31211,1266,281,28,0,12,1616,84,135,219,124,59,65,946,5,3.37,90.9,2.4271844660194173,7.524271844660194,40,98.05825242718447,57.40291262135922,0.49211165048543687
30077,"Powell County, Montana",6928,4314,2614,23990,5335,588,315,15,44,5324,388,361,749,555,247,308,2583,22,3.81,75.4,5.3983833718244805,8.010969976905312,374,76.84757505773672,37.283487297921475,0.6226905311778291
30079,"Prairie County, Montana",1414,747,667,28366,1012,138,32,19,5,1395,101,43,144,255,130,125,568,7,2.91,86.3,3.9603960396039604,18.033946251768032,56,98.65629420084866,40.16973125884017,0.5282885431400283
30081,"Ravalli County, Montana",41130,20385,20745,25151,30071,5055,2036,301,352,40885,3456,2987,6443,7173,3244,3929,16891,186,4.02,75.6,6.537806953561877,17.439824945295406,2689,99.40432774130805,41.067347434962315,0.49562363238512036
30083,"Richland County, Montana",11392,5864,5528,33709,7576,990,327,58,20,11392,912,797,1709,981,474,507,5956,37,2.79,84.3,3.555126404494382,8.611306179775282,405,100,52.282303370786515,0.514747191011236
30085,"Roosevelt County, Montana",11230,5525,5705,18030,6407,684,191,24,8,11003,1586,1310,2896,2953,1381,1572,3644,16,2.94,83.6,1.9857524487978628,26.295636687444347,223,97.9786286731968,32.448797862867316,0.4919857524487979
30087,"Rosebud County, Montana",9348,4629,4719,23832,5794,871,201,26,50,9269,839,1029,1868,1813,864,949,4057,42,3.13,87.6,2.963200684638425,19.394522892597347,277,99.15489944373128,43.399657680787335,0.49518613607188705
30089,"Sanders County, Montana",11375,5837,5538,23020,8598,1072,240,36,60,11238,890,1180,2070,2493,1092,1401,3940,31,8.17,78.8,2.953846153846154,21.916483516483517,336,98.7956043956044,34.637362637362635,0.5131428571428571
30091,"Sheridan County, Montana",3645,1866,1779,32833,2642,416,85,17,12,3594,161,115,276,395,204,191,1830,15,3.19,81.5,3.1275720164609053,10.83676268861454,114,98.60082304526749,50.205761316872426,0.5119341563786008
30093,"Silver Bow County, Montana",34560,17188,17372,26248,23436,4188,1286,436,168,33985,2291,2144,4435,6555,3066,3489,15917,308,2.38,76.4,5.46875,18.96701388888889,1890,98.33622685185185,46.05613425925926,0.49733796296296295
30095,"Stillwater County, Montana",9342,4748,4594,31583,6744,1133,389,121,73,9290,481,502,983,675,282,393,4373,97,2.78,81.2,6.240633697281096,7.22543352601156,583,99.443374009848,46.81010490259045,0.5082423463926354
30097,"Sweet Grass County, Montana",3634,1770,1864,28065,2607,502,108,23,11,3607,217,166,383,427,200,227,1536,29,3.08,79.9,3.907539900935608,11.750137589433132,142,99.25701706108971,42.267473858007705,0.4870665932856357
30099,"Teton County, Montana",6067,2979,3088,26884,4190,660,197,56,20,6002,409,474,883,631,275,356,2744,64,3.06,77.5,4.499752760837317,10.400527443547057,273,98.92863029503873,45.228284160210976,0.4910169770891709
30101,"Toole County, Montana",5114,2919,2195,26354,3648,414,62,59,1,4481,415,341,756,747,363,384,2294,10,2.57,80.4,2.3856081345326556,14.606961282753227,122,87.6222135314822,44.85725459522878,0.5707860774344935
30103,"Treasure County, Montana",846,433,413,22880,600,94,18,2,5,846,29,31,60,162,91,71,392,6,3.03,87.1,2.955082742316785,19.148936170212767,25,100,46.335697399527184,0.5118203309692672
30105,"Valley County, Montana",7576,3805,3771,29096,5330,868,213,39,26,7462,505,338,843,711,367,344,3728,5,4.01,81.1,3.66948257655755,9.384899683210138,278,98.49524815205913,49.20802534318902,0.5022439281942978
30107,"Wheatland County, Montana",2109,1094,1015,20165,1426,215,43,2,12,2075,148,97,245,365,176,189,948,0,2.92,80.3,2.7027027027027026,17.306780464675203,57,98.38786154575628,44.950213371266,0.5187292555713608
30109,"Wibaux County, Montana",1143,552,591,24662,834,151,13,2,2,1119,68,67,135,143,61,82,524,3,4,84.3,1.4873140857392826,12.510936132983376,17,97.9002624671916,45.84426946631671,0.48293963254593175
30111,"Yellowstone County, Montana",155344,76301,79043,32296,105681,21546,6484,1896,964,153001,9571,8710,18281,15767,6585,9182,78556,480,3.05,86.4,6.015037593984962,10.149732207230405,9344,98.49173447316923,50.56905963538984,0.49117442579050363
31001,"Adams County, Nebraska",31536,16007,15529,28085,20312,2944,1258,224,157,31257,1766,1184,2950,3314,1410,1904,15523,73,5.94,89.1,5.197234906139015,10.508625063419585,1639,99.11529680365297,49.22311009639777,0.5075786402841197
31003,"Antelope County, Nebraska",6421,3217,3204,28091,4492,599,199,20,16,6326,284,262,546,748,342,406,3086,44,6.65,85.3,3.6598660644759384,11.649275813736178,235,98.52047967606292,48.06104968073509,0.501012303379536
31005,"Arthur County, Nebraska",437,210,227,21799,280,61,12,1,1,437,17,29,46,35,17,18,174,0,4.37,86.1,3.203661327231121,8.009153318077804,14,100,39.816933638443935,0.4805491990846682
31007,"Banner County, Nebraska",793,368,425,30736,569,65,11,12,9,793,29,52,81,95,24,71,422,0,3.63,88.4,4.03530895334174,11.97982345523329,32,100,53.2156368221942,0.4640605296343001
31009,"Blaine County, Nebraska",580,308,272,28503,391,64,17,12,5,580,68,45,113,94,54,40,290,9,5.73,86.8,5.862068965517241,16.20689655172414,34,100,50,0.5310344827586206
31011,"Boone County, Nebraska",5353,2693,2660,28861,3705,449,162,15,28,5254,172,170,342,394,149,245,2751,14,5.46,85.9,3.8296282458434523,7.360358677377172,205,98.15056977395852,51.39174294787969,0.5030823837100691
31013,"Box Butte County, Nebraska",11279,5741,5538,28483,7528,836,291,56,0,11114,420,539,959,1544,592,952,5597,35,3.53,87.4,3.076513875343559,13.689156840145403,347,98.5371043532228,49.62319354552709,0.5089990247362355
31015,"Boyd County, Nebraska",2006,1024,982,26413,1464,226,49,5,7,1979,128,96,224,246,109,137,977,5,8.58,86.4,3.0408773678963112,12.26321036889332,61,98.65403788634097,48.703888334995014,0.5104685942173479
31017,"Brown County, Nebraska",3022,1439,1583,29664,2288,268,76,37,47,2978,157,205,362,512,231,281,1571,11,5.46,86.6,5.294506949040371,16.942422236929186,160,98.5440105890139,51.98544010589014,0.4761747187293183
31019,"Buffalo County, Nebraska",48402,24188,24214,28553,29339,6769,2143,416,493,47806,2185,1766,3951,6252,2814,3438,26885,165,8.35,88,6.305524565100615,12.916821618941366,3052,98.76864592372216,55.54522540390893,0.49973141605718774
31021,"Burt County, Nebraska",6594,3241,3353,26421,4712,621,173,37,9,6492,260,313,573,647,266,381,2955,21,6.12,88.1,3.3212010919017287,9.81195025781013,219,98.45313921747042,44.81346678798908,0.49150743099787686
31023,"Butler County, Nebraska",8205,4126,4079,27216,5663,722,215,40,11,8035,344,303,647,697,324,373,4088,33,7.16,88.2,3.2419256550883606,8.494820231566118,266,97.9280926264473,49.82327848872639,0.5028641072516759
31025,"Cass County, Nebraska",25463,12760,12703,32509,17377,2957,1055,170,151,25002,696,770,1466,1764,865,899,12905,74,9.76,88.5,5.403919412480855,6.927699014255979,1376,98.18952990613832,50.681380827082435,0.501119271099242
31027,"Cedar County, Nebraska",8657,4396,4261,29694,5882,744,222,43,26,8508,265,225,490,881,396,485,4490,58,5.28,85.6,3.361441607947326,10.1767355896962,291,98.27884948596511,51.86554233568211,0.50779715836895
31029,"Chase County, Nebraska",4061,1983,2078,33708,2796,413,75,6,23,3993,272,301,573,387,163,224,1974,54,4.79,89.8,2.560945579906427,9.529672494459493,104,98.32553558236887,48.608717064762374,0.488303373553312
31031,"Cherry County, Nebraska",5781,2844,2937,27891,4205,578,139,22,63,5721,336,222,558,458,137,321,3328,38,4.78,86.1,3.874762151876838,7.922504756962463,224,98.96211728074728,57.56789482788445,0.4919564089257914
31033,"Cheyenne County, Nebraska",10090,4956,5134,32995,7005,1288,338,55,31,9989,371,285,656,996,381,615,5473,12,2.96,88.8,4.202180376610506,9.871159563924678,424,98.9990089197225,54.241823587710606,0.49117938553022794
31035,"Clay County, Nebraska",6313,3224,3089,27275,4333,604,155,29,20,6212,342,356,698,615,267,348,3075,31,4.64,89.2,3.2314272136860445,9.741802629494693,204,98.40012672263583,48.70901314747347,0.5106922223982259
31037,"Colfax County, Nebraska",10499,5449,5050,23393,6461,578,206,77,38,10411,700,516,1216,1227,630,597,5110,158,6.29,88.3,3.0574340413372703,11.686827316887323,321,99.16182493570817,48.67130202876464,0.5190018096961615
31039,"Cuming County, Nebraska",9055,4578,4477,28762,6095,909,222,65,20,8904,489,303,792,1102,372,730,4650,17,5.7,87.1,3.3903920485919383,12.170071783545003,307,98.33241303147432,51.35284373274434,0.5055770292655991
31041,"Custer County, Nebraska",10784,5331,5453,32605,7519,1086,366,48,112,10659,620,521,1141,1152,452,700,5535,63,6.6,86.7,4.87759643916914,10.682492581602373,526,98.84087537091987,51.32603857566765,0.49434347181008903
31043,"Dakota County, Nebraska",20697,10072,10625,22463,12661,1130,410,53,51,20487,1480,1631,3111,3273,1434,1839,10108,46,5.71,87.2,2.4834517079770015,15.813886070444992,514,98.98536019713002,48.837995844808425,0.4866405759288786
31045,"Dawes County, Nebraska",9082,4476,4606,24811,5468,1118,443,133,202,9004,624,632,1256,1272,516,756,4634,22,3.53,88.9,8.566395067165823,14.005725611098876,778,99.14115833516847,51.02400352345298,0.49284298612640387
31047,"Dawson County, Nebraska",23924,12122,11802,24912,15259,1541,551,152,78,23656,1574,1692,3266,3585,1602,1983,12066,56,7.37,87.1,3.264504263501087,14.9849523491055,781,98.87978598896505,50.43470991472998,0.5066878448419997
31049,"Deuel County, Nebraska",1932,944,988,28225,1408,168,68,12,3,1912,166,116,282,198,62,136,1025,50,3.87,88.3,4.296066252587992,10.248447204968944,83,98.9648033126294,53.05383022774327,0.4886128364389234
31051,"Dixon County, Nebraska",5809,2921,2888,26094,3918,501,208,9,25,5728,278,247,525,675,295,380,2879,8,5.19,85.8,4.1659493888793255,11.619900154932003,242,98.60561198140816,49.561025994147016,0.5028404200378722
31053,"Dodge County, Nebraska",36679,17969,18710,27162,24724,3267,1067,246,96,36114,2117,2104,4221,4192,1883,2309,18122,127,6.08,87.9,3.8414351536301425,11.428883012077756,1409,98.45960904059544,49.40701763952125,0.48989885220425855
31055,"Douglas County, Nebraska",543253,267547,275706,32023,351559,86834,30721,9589,5064,536932,30900,26494,57394,75422,33432,41990,276802,2036,7.52,88.5,8.352277852124148,13.883402392623694,45374,98.83645373334339,50.95268686965373,0.4924906075069995
31057,"Dundy County, Nebraska",1823,912,911,26949,1326,176,63,17,3,1785,115,100,215,151,74,77,845,14,4.71,90.8,4.552934722984092,8.283049917718047,83,97.91552386176632,46.35216675809106,0.5002742731760834
31059,"Fillmore County, Nebraska",5676,2834,2842,30874,4097,572,174,17,36,5442,286,220,506,551,183,368,2851,25,6.13,89.1,3.9992952783650457,9.70754052149401,227,95.87737843551797,50.229034531360114,0.4992952783650458
31061,"Franklin County, Nebraska",3076,1541,1535,28635,2276,327,67,30,3,3013,98,104,202,392,168,224,1526,5,6.84,90,3.250975292587776,12.743823146944083,100,97.9518855656697,49.609882964889465,0.5009752925877763
31063,"Frontier County, Nebraska",2599,1303,1296,27900,1745,198,107,8,14,2590,126,141,267,269,90,179,1220,9,6.05,89,4.963447479799923,10.350134667179685,129,99.65371296652559,46.94113120430935,0.5013466717968449
31065,"Furnas County, Nebraska",4850,2363,2487,24522,3420,461,76,20,16,4768,243,202,445,739,283,456,2277,16,5.8,89.7,2.3092783505154637,15.237113402061855,112,98.30927835051547,46.94845360824742,0.48721649484536084
31067,"Gage County, Nebraska",21778,10807,10971,27424,15422,2320,541,131,111,21485,698,599,1297,2235,987,1248,10876,70,6.56,89.6,3.5953714758012674,10.26265038111856,783,98.65460556524934,49.940306731563965,0.49623473229865
31069,"Garden County, Nebraska",1930,927,1003,35602,1492,246,45,33,3,1879,104,93,197,218,86,132,922,8,4.04,87.4,4.196891191709844,11.295336787564766,81,97.35751295336787,47.7720207253886,0.4803108808290155
31071,"Garfield County, Nebraska",1968,982,986,25856,1411,176,58,23,4,1928,99,70,169,140,57,83,997,10,7.68,86.3,4.319105691056911,7.1138211382113825,85,97.96747967479675,50.66056910569106,0.49898373983739835
31073,"Gosper County, Nebraska",1977,944,1033,31901,1392,222,55,12,2,1940,91,70,161,112,38,74,1088,11,6.55,87.8,3.490136570561457,5.6651492159838135,69,98.1284774911482,55.03287809812848,0.47749114820435
31075,"Grant County, Nebraska",647,341,306,22693,460,77,23,1,0,647,52,26,78,103,45,58,329,6,4.51,85.8,3.7094281298299845,15.919629057187016,24,100,50.8500772797527,0.527047913446677
31077,"Greeley County, Nebraska",2447,1220,1227,25544,1705,197,73,10,3,2419,74,87,161,211,78,133,1147,4,7.2,87,3.5145075602778912,8.622803432774827,86,98.85574172456069,46.873722926031874,0.4985696771557009
31079,"Hall County, Nebraska",61105,30720,30385,26419,39111,5139,1608,486,189,60335,4776,4176,8952,8894,4023,4871,31094,120,6.05,88.5,3.7361918009982817,14.5552737091891,2283,98.73987398739874,50.886179527043616,0.50274118320923
31081,"Hamilton County, Nebraska",9118,4560,4558,31989,6201,1093,372,72,30,8972,248,204,452,804,339,465,4647,37,5.72,88.2,5.198508444834394,8.81772318490897,474,98.39877166045186,50.96512393068655,0.5001096731739416
31083,"Harlan County, Nebraska",3465,1824,1641,26375,2507,312,59,39,3,3413,176,196,372,542,254,288,1593,2,7.19,89.6,2.914862914862915,15.642135642135642,101,98.4992784992785,45.97402597402598,0.5264069264069264
31085,"Hayes County, Nebraska",1013,558,455,27183,758,122,32,2,0,1013,105,87,192,80,42,38,511,3,5.33,89.4,3.3563672260612045,7.897334649555775,34,100,50.44422507403751,0.5508390918065152
31087,"Hitchcock County, Nebraska",2866,1434,1432,25290,2078,197,94,5,10,2830,194,221,415,452,233,219,1312,0,5.53,91.2,3.8032100488485696,15.771109560362875,109,98.74389392882065,45.778087927424984,0.5003489183531054
31089,"Holt County, Nebraska",10360,5145,5215,27858,7209,1092,311,83,40,10192,384,358,742,990,463,527,5500,54,7.36,86,4.1891891891891895,9.555984555984557,434,98.37837837837837,53.08880308880309,0.4966216216216216
31091,"Hooker County, Nebraska",669,316,353,27714,541,95,33,0,0,643,18,31,49,104,56,48,305,9,4.63,85.4,4.932735426008969,15.54559043348281,33,96.1136023916293,45.59043348281016,0.47234678624813153
31093,"Howard County, Nebraska",6365,3232,3133,26734,4457,715,138,43,9,6351,192,132,324,603,285,318,3245,29,6.91,88.3,2.985074626865672,9.473684210526315,190,99.78004713275726,50.98193244304792,0.5077769049489396
31095,"Jefferson County, Nebraska",7354,3580,3774,26859,5276,580,157,27,20,7241,280,218,498,846,323,523,3625,10,5.97,90.2,2.7740005439216753,11.503943432145771,204,98.46342126733751,49.292901822137615,0.4868098993744901
31097,"Johnson County, Nebraska",5167,3085,2082,22398,3737,437,126,12,24,4045,170,208,378,505,218,287,2054,10,8.09,88.8,3.1352815947358237,9.773562995935746,162,78.28527191794078,39.75227404683569,0.5970582543061738
31099,"Kearney County, Nebraska",6548,3228,3320,31234,4513,754,262,49,12,6469,267,255,522,443,182,261,3397,0,7.93,88.6,4.932803909590715,6.765424557116677,323,98.79352474037874,51.87843616371411,0.49297495418448384
31101,"Keith County, Nebraska",8103,4090,4013,27890,5923,921,223,70,68,8041,518,491,1009,1023,543,480,3892,113,4.23,87.4,4.455140071578428,12.624953720844132,361,99.2348512896458,48.03159323707269,0.5047513266691349
31103,"Keya Paha County, Nebraska",736,387,349,28981,549,70,15,12,6,736,26,25,51,77,37,40,424,0,5.27,87.7,4.483695652173913,10.46195652173913,33,100,57.608695652173914,0.5258152173913043
31105,"Kimball County, Nebraska",3713,1869,1844,24011,2672,297,112,4,4,3652,265,288,553,377,154,223,1667,7,2.56,87.8,3.2318879612173443,10.153514678157824,120,98.35712361971451,44.896310261244274,0.5033665499596014
31107,"Knox County, Nebraska",8551,4175,4376,27283,5922,873,247,50,25,8321,439,479,918,1036,395,641,4180,19,6.19,86.3,3.7656414454449774,12.115542041866448,322,97.31025611039645,48.883171558882005,0.4882469886562975
31109,"Lancaster County, Nebraska",301707,151180,150527,29901,186219,44728,16269,3956,4511,297490,15428,12216,27644,41105,18658,22447,161913,766,6.67,89.4,8.198682828041775,13.624145280023335,24736,98.60228632414892,53.66564249420796,0.501082175753297
31111,"Lincoln County, Nebraska",35777,17588,18189,29687,24326,3670,1191,230,183,35369,1830,1883,3713,4200,1627,2573,17508,79,5.74,87.1,4.4833272773010595,11.739385638818236,1604,98.85960253794337,48.93646756295944,0.49160074908460744
31113,"Logan County, Nebraska",830,417,413,24624,549,101,9,4,0,830,59,37,96,95,41,54,422,0,5.32,85.7,1.5662650602409638,11.44578313253012,13,100,50.8433734939759,0.5024096385542168
31115,"Loup County, Nebraska",542,258,284,29248,402,68,16,4,0,542,31,19,50,54,21,33,272,2,6.87,86.5,3.690036900369004,9.96309963099631,20,100,50.18450184501845,0.47601476014760147
31117,"McPherson County, Nebraska",425,219,206,27241,322,59,18,0,2,425,3,6,9,78,35,43,210,11,4.73,85.7,4.705882352941177,18.352941176470587,20,100,49.411764705882355,0.5152941176470588
31119,"Madison County, Nebraska",35125,17405,17720,26093,22768,3167,938,279,91,34492,1879,1695,3574,5071,2153,2918,18049,299,6.35,86.3,3.723843416370107,14.437010676156584,1308,98.19786476868327,51.38505338078292,0.49551601423487546
31121,"Merrick County, Nebraska",7793,3854,3939,27223,5439,676,145,33,14,7678,345,341,686,753,352,401,3911,3,5.43,87.9,2.463749518798922,9.662517644039523,192,98.52431669446939,50.18606441678429,0.49454638778390864
31123,"Morrill County, Nebraska",4843,2428,2415,25120,3339,489,131,11,3,4678,364,243,607,576,247,329,2379,25,3.27,88.9,2.9940119760479043,11.893454470369605,145,96.59302085484204,49.122444765641134,0.5013421432996077
31125,"Nance County, Nebraska",3607,1781,1826,26852,2549,278,125,29,10,3510,171,158,329,436,223,213,1798,15,5.53,87.4,4.546714721375104,12.087607429997227,164,97.31078458552814,49.84751871361242,0.49376212919323537
31127,"Nemaha County, Nebraska",7101,3491,3610,28572,4606,955,295,32,45,6989,237,176,413,713,387,326,3482,4,8.11,89.3,5.238698774820448,10.040839318405858,372,98.42275735811857,49.03534713420645,0.49162089846500495
31129,"Nuckolls County, Nebraska",4352,2150,2202,24426,3196,358,114,35,24,4269,265,174,439,538,204,334,2221,4,5.07,89.6,3.9751838235294117,12.362132352941176,173,98.09283088235294,51.034007352941174,0.49402573529411764
31131,"Otoe County, Nebraska",15890,7809,8081,28567,10846,1649,477,68,54,15616,696,598,1294,1676,771,905,7947,74,9.57,88.9,3.7696664568911267,10.547514159848962,599,98.27564505978603,50.012586532410324,0.49144115796098176
31133,"Pawnee County, Nebraska",2695,1339,1356,27196,1948,219,67,21,8,2654,261,170,431,538,247,291,1206,4,6.39,88.8,3.562152133580705,19.962894248608535,96,98.4786641929499,44.749536178107604,0.49684601113172544
31135,"Perkins County, Nebraska",2911,1468,1443,30923,2063,284,133,50,10,2871,81,81,162,194,50,144,1440,5,4.9,88.2,6.63002404671934,6.664376502919959,193,98.62590175197526,49.46753692889042,0.5042940570250773
31137,"Phelps County, Nebraska",9236,4632,4604,30166,6301,1125,222,66,54,9013,284,274,558,740,240,500,4616,13,8.36,87.8,3.702901689042876,8.01212646167172,342,97.58553486357731,49.978345604157646,0.5015158077089649
31139,"Pierce County, Nebraska",7179,3614,3565,28766,4878,801,208,28,6,7043,194,149,343,460,200,260,3624,35,5.81,85.5,3.3709430282769186,6.4075776570553,242,98.10558573617496,50.48056832427915,0.5034127315782142
31141,"Platte County, Nebraska",32703,16488,16215,28187,21282,3113,1000,274,166,32406,1555,1335,2890,2803,1286,1517,17167,58,5.59,87.8,4.403265755435281,8.571079105892426,1440,99.09182643794148,52.493655016359355,0.5041739289973397
31143,"Polk County, Nebraska",5242,2584,2658,32424,3655,575,175,25,11,5139,289,181,470,418,201,217,2726,15,6.07,88.4,4.025181228538726,7.974055703929798,211,98.03510110644793,52.003052270125906,0.49294162533384206
31145,"Red Willow County, Nebraska",10884,5533,5351,25006,7299,893,290,112,34,10637,673,353,1026,1234,683,551,5414,114,6.08,91,4.005880191106211,11.337743476662991,436,97.73061374494671,49.74274163910327,0.5083608967291438
31147,"Richardson County, Nebraska",8149,4026,4123,28109,5931,867,205,40,21,7998,317,233,550,1439,679,760,3931,29,6.39,89.7,3.2642041968339672,17.658608418210825,266,98.14701190330102,48.23904773591852,0.49404834949073506
31149,"Rock County, Nebraska",1407,688,719,33867,1047,153,24,4,2,1371,91,115,206,141,44,97,775,2,5.83,86,2.1321961620469083,10.021321961620469,30,97.44136460554371,55.0817341862118,0.48898365316275766
31151,"Saline County, Nebraska",14356,7231,7125,22324,8778,789,355,99,36,14066,847,722,1569,1586,673,913,6882,39,6.97,89.3,3.4132070214544443,11.047645583728057,490,97.97993870158818,47.93814432989691,0.503691836166063
31153,"Sarpy County, Nebraska",172460,86211,86249,33103,108936,27425,11557,1849,983,168330,5308,4737,10045,10597,4669,5928,92198,659,8.84,88.6,8.34338397309521,6.144613243650702,14389,97.60524179519889,53.46051258262786,0.4998898295256871
31155,"Saunders County, Nebraska",20946,10530,10416,31163,14169,2412,1050,122,116,20665,607,456,1063,1897,781,1116,10654,85,7.17,88.2,6.149145421560203,9.056621789363124,1288,98.65845507495465,50.864126802253416,0.5027212832999141
31157,"Scotts Bluff County, Nebraska",36599,17667,18932,26532,24466,3424,1260,329,218,35999,2562,2384,4946,4791,2093,2698,17723,117,3.52,90.2,4.937293368671275,13.09052159895079,1807,98.36061094565426,48.42482035028279,0.48271810705210527
31159,"Seward County, Nebraska",17113,8696,8417,29398,10867,1969,648,158,179,16833,593,412,1005,1413,732,681,8475,25,6.82,88.3,5.755858119558231,8.256880733944953,985,98.36381698124234,49.523753871325894,0.508151697539882
31161,"Sheridan County, Nebraska",5259,2586,2673,25817,3728,652,209,58,15,5176,416,357,773,870,418,452,2527,16,4.08,86.8,5.362236166571591,16.543069024529377,282,98.42175318501616,48.0509602586043,0.4917284654877353
31163,"Sherman County, Nebraska",3090,1522,1568,27983,2245,236,108,12,0,3031,138,95,233,402,125,277,1509,0,7.86,88.3,3.883495145631068,13.009708737864077,120,98.09061488673139,48.83495145631068,0.4925566343042071
31165,"Sioux County, Nebraska",1274,636,638,26852,898,205,50,6,0,1274,63,72,135,140,62,78,665,2,3.18,88.1,4.395604395604396,10.989010989010989,56,100,52.1978021978022,0.49921507064364207
31167,"Stanton County, Nebraska",6022,3022,3000,29517,4023,620,114,22,16,5996,278,322,600,570,254,316,3099,15,5.55,87.1,2.524078379275988,9.465293922284955,152,99.56824975091332,51.46130853537031,0.5018266356692129
31169,"Thayer County, Nebraska",5163,2558,2605,31129,3742,538,144,15,36,5013,152,132,284,603,288,315,2442,4,6.36,89.7,3.7768739105171414,11.679256246368391,195,97.09471237652528,47.298082510168506,0.49544838272322295
31171,"Thomas County, Nebraska",675,357,318,29243,467,85,14,12,0,675,34,16,50,65,33,32,369,0,5.26,86.2,3.8518518518518516,9.62962962962963,26,100,54.666666666666664,0.5288888888888889
31173,"Thurston County, Nebraska",6989,3457,3532,19380,3799,405,136,46,16,6935,1097,993,2090,2168,1011,1157,2425,33,6.1,87,2.8330233223637142,31.020174560022895,198,99.22735727571899,34.6973815996566,0.4946344255258263
31175,"Valley County, Nebraska",4240,2128,2112,27271,3025,463,120,25,16,4196,239,177,416,533,233,300,2212,0,8.37,87.3,3.797169811320755,12.570754716981131,161,98.9622641509434,52.16981132075472,0.5018867924528302
31177,"Washington County, Nebraska",20338,10064,10274,33136,13668,3098,796,182,104,20152,502,630,1132,1834,601,1233,10636,35,6.94,88.2,5.320090471039434,9.01760251745501,1082,99.08545579703019,52.29619431605861,0.4948372504671059
31179,"Wayne County, Nebraska",9414,4813,4601,27292,5254,1415,321,91,82,9375,262,313,575,990,642,348,4913,18,5.31,85.5,5.247503717867007,10.516252390057362,494,99.58572339069471,52.18823029530486,0.5112598257913745
31181,"Webster County, Nebraska",3665,1784,1881,26136,2586,350,161,22,4,3583,169,210,379,367,166,201,1663,2,5.63,90.4,5.102319236016371,10.013642564802183,187,97.76261937244202,45.375170532060025,0.48676671214188266
31183,"Wheeler County, Nebraska",805,411,394,28257,616,74,25,3,0,805,20,20,40,41,18,23,464,7,6.59,85.9,3.4782608695652173,5.093167701863354,28,100,57.63975155279503,0.5105590062111801
31185,"York County, Nebraska",13842,6799,7043,28298,9383,1891,539,130,100,13252,520,505,1025,1218,448,770,7067,25,6.66,88.6,5.555555555555555,8.799306458604248,769,95.73761017194047,51.054760872706254,0.4911862447623176
32001,"Churchill County, Nevada",24148,12285,11863,25211,16346,1918,680,84,29,23277,1858,1832,3690,3851,1822,2029,9717,75,1.24,93.4,3.2839158522444922,15.94749047540169,793,96.39307603114129,40.23935729667053,0.5087377836673844
32003,"Clark County, Nevada",2070153,1035722,1034431,27719,1391680,212135,73276,21699,10525,2046634,182956,163845,346801,307146,142299,164847,939569,12115,1.96,101,5.0962416787551454,14.836874375951922,105500,98.86390039770008,45.38645211247671,0.5003118127017665
32005,"Douglas County, Nevada",47426,23909,23517,35727,35742,6067,2450,589,302,47119,3074,2610,5684,5148,2479,2669,20115,105,3.84,85.3,7.044659047779699,10.854805381014634,3341,99.35267574748029,42.4134441023911,0.5041327541854679
32007,"Elko County, Nevada",52029,27082,24947,32498,32601,3904,1656,268,79,51382,3197,3177,6374,5401,2629,2772,26092,201,2.69,85.7,3.8497760864133466,10.380749197562897,2003,98.75646274193238,50.148955390263126,0.5205174037555979
32009,"Esmeralda County, Nevada",1069,500,569,23755,785,111,10,3,8,1064,98,117,215,126,26,100,417,0,0.84,94.4,1.9644527595884003,11.786716557530402,21,99.53227315247895,39.008419083255376,0.4677268475210477
32011,"Eureka County, Nevada",1730,845,885,35606,1319,152,47,0,20,1725,173,114,287,186,95,91,897,0,2.84,88.6,3.8728323699421967,10.751445086705202,67,99.71098265895954,51.84971098265896,0.4884393063583815
32013,"Humboldt County, Nevada",17091,8899,8192,29215,10793,893,419,133,61,16864,1218,1579,2797,1997,879,1118,8246,82,3.04,88.4,3.586683049558247,11.684512316423849,613,98.67181557544907,48.247615704171785,0.5206834006202095
32015,"Lander County, Nevada",5907,3255,2652,30256,3751,274,192,25,38,5866,392,453,845,757,401,356,2702,24,2.24,88.9,4.316912138141189,12.81530387675639,255,99.30590824445574,45.7423395970882,0.5510411376333164
32017,"Lincoln County, Nevada",5155,2821,2334,27218,3535,577,215,0,12,4681,350,244,594,595,360,235,1766,0,2.24,93.5,4.40349175557711,11.54219204655674,227,90.80504364694471,34.25800193986421,0.5472356935014548
32019,"Lyon County, Nevada",51897,26220,25677,25063,36600,3531,1471,158,143,51580,4164,3570,7734,7876,3661,4215,19814,148,1.89,91.4,3.4144555561978533,15.176214424725899,1772,99.38917471144768,38.17947087500241,0.5052315162726169
32021,"Mineral County, Nevada",4519,2276,2243,22791,3368,251,131,0,15,4440,348,328,676,941,401,540,1823,0,1.18,91.4,3.230803275060854,20.82319097145386,146,98.25182562513831,40.34078335915025,0.5036512502766098
32023,"Nye County, Nevada",43198,21547,21651,23740,32804,2776,1032,101,68,42783,3241,2804,6045,7346,3440,3906,14097,142,1.52,92.4,2.7802213065419696,17.00541691744988,1201,99.03930737534145,32.63345525255799,0.4987962405666929
32027,"Pershing County, Nevada",6690,4364,2326,19201,5013,323,178,43,8,4670,428,387,815,767,311,456,2040,0,2.27,91.5,3.423019431988042,11.464872944693573,229,69.80568011958147,30.493273542600896,0.6523168908819134
32029,"Storey County, Nevada",3941,1887,2054,36388,3217,508,115,57,64,3918,330,156,486,284,138,146,1804,0,3.48,87.6,5.988327835574728,7.206292819081451,236,99.41639177873635,45.77518396346105,0.47881248414108096
32031,"Washoe County, Nevada",439914,221166,218748,31879,299065,54621,21366,5936,4752,437176,33890,27910,61800,65024,30678,34346,209468,2238,2.87,87.6,7.286424164723105,14.781070845665289,32054,99.3776056229172,47.61567033556559,0.502748264433503
32033,"White Pine County, Nevada",9893,5759,4134,25350,6966,613,350,12,3,8449,552,706,1258,1068,495,573,3424,63,2.57,86.9,3.6894774082684725,10.795511978166381,365,85.40382088345295,34.61033053674315,0.5821287779237845
32510,"Carson City, Nevada",54412,27785,26627,28044,38540,4925,2167,594,398,52488,4081,3213,7294,8744,4021,4723,23440,102,4.03,86.8,5.805704623980004,16.06998456222892,3159,96.46401529074468,43.07873263250754,0.5106410350657943
33001,"Belknap County, New Hampshire",60392,29571,30821,33849,44280,8507,3582,1044,357,59647,3378,2996,6374,6124,2790,3334,30319,502,4.9,82.3,8.251092859981455,10.140415949132336,4983,98.76639289972182,50.20366936018016,0.48965094714531726
33003,"Carroll County, New Hampshire",47416,23653,23763,35646,36385,7938,3245,667,362,46963,3456,2534,5990,4716,2037,2679,22372,197,5.19,80.2,9.013834992407626,9.946009785726337,4274,99.04462628648558,47.182385692593215,0.49884005399021425
33005,"Cheshire County, New Hampshire",76320,37271,39049,32072,52514,10059,4595,970,886,75531,4286,2979,7265,7813,3436,4377,39237,304,5.43,82.8,8.452568134171909,10.23715932914046,6451,98.96619496855345,51.41116352201258,0.488351677148847
33007,"Coos County, New Hampshire",32219,17090,15129,25895,24695,2895,1131,211,148,30369,1925,1574,3499,4042,1967,2075,14548,157,5.38,76.5,4.6246003910735904,12.545392470281511,1490,94.25804649430461,45.153480865327914,0.5304323535801856
33009,"Grafton County, New Hampshire",89164,43911,45253,35255,61876,12125,6987,2462,2471,88248,4673,4210,8883,9687,4272,5415,44106,632,5.17,79,13.36862410838455,10.864250145798753,11920,98.9726795567718,49.46615225875914,0.4924745412946929
33011,"Hillsborough County, New Hampshire",404948,200979,203969,37622,281112,65589,28905,4130,3280,400673,18289,14433,32722,34231,15475,18756,213524,981,5.27,84.3,8.96781809022393,8.453184112528028,36315,98.94430889892035,52.72874541916493,0.49630816796230626
33013,"Merrimack County, New Hampshire",147715,72732,74983,34475,103791,22150,10458,2313,1349,144313,6060,4993,11053,12150,5164,6986,75456,646,5.24,83.3,9.55894797413939,8.225298717124192,14120,97.69691635920523,51.0821514402735,0.492380597772738
33015,"Rockingham County, New Hampshire",300365,148646,151719,43474,215076,53790,24751,4054,2582,298124,10169,9104,19273,15240,6972,8268,165135,1131,6.66,84.5,10.449619629450835,5.073826844006459,31387,99.25390774557621,54.97810996620778,0.49488455712216806
33017,"Strafford County, New Hampshire",125913,61524,64389,32540,81175,17584,8138,925,1613,124504,5996,5550,11546,11875,4930,6945,64349,685,6.47,83.1,8.478870331101634,9.431115135053568,10676,98.88097337050185,51.10592234320523,0.48862309690024064
33019,"Sullivan County, New Hampshire",43051,21130,21921,31301,31440,5424,2251,428,320,42577,2274,1773,4047,3812,1753,2059,20949,299,4.52,80.7,6.966156419130798,8.854614294673759,2999,98.89898027920374,48.66089057164758,0.4908132215279552
34001,"Atlantic County, New Jersey",274026,132741,141285,29941,187290,33037,10859,3174,1416,271249,17917,14961,32878,41469,18563,22906,124514,2426,7.58,87.5,5.637786195470503,15.133235532394735,15449,98.98659251311919,45.43875398684796,0.4844102384445272
34003,"Bergen County, New Jersey",930310,450329,479981,46601,653207,194268,82657,22694,11096,924248,49760,43608,93368,69119,29556,39563,456128,4823,6.01,88,12.517010458879298,7.429673979641195,116447,99.34838924659522,49.02967827928325,0.4840633767238877
34005,"Burlington County, New Jersey",450236,221808,228428,39528,312858,74124,29087,6798,3757,435857,14560,11043,25603,28440,12359,16081,220922,1246,8.48,88.6,8.80471574907382,6.316687248465249,39642,96.80634156309135,49.06804431453727,0.4926483000026653
34007,"Camden County, New Jersey",511145,247229,263916,32931,347104,68238,26451,7935,3743,505436,28437,21209,49646,66882,28405,38477,239141,2148,7.93,88.9,7.459527140048323,13.084741120425711,38129,98.88309579473535,46.78535444932456,0.4836768431658336
34009,"Cape May County, New Jersey",95404,46594,48810,36256,70266,14237,5407,1263,526,93279,4081,2960,7041,9695,4329,5366,42674,460,8.22,87.3,7.542660685086579,10.162047712884156,7196,97.77263007840342,44.72978072198231,0.48838623118527524
34011,"Cumberland County, New Jersey",155744,79905,75839,23012,104849,10614,3094,881,374,143910,10024,8019,18043,26448,12004,14444,60412,1198,6.5,88.2,2.792402917608383,16.98171358126156,4349,92.40163344976372,38.78929525374974,0.5130534723649065
34013,"Essex County, New Jersey",792586,380718,411868,35133,526945,105847,47508,14474,7794,781004,63007,53939,116946,132940,57301,75639,353854,2986,5.86,87.9,8.803587244791101,16.772943251584056,69776,98.53870747149205,44.64550219156028,0.4803491356143056
34015,"Gloucester County, New Jersey",291286,141585,149701,36205,197574,40076,13994,3060,2019,289960,10462,8195,18657,23257,10096,13161,141661,1137,6.33,88.9,6.547860178656029,7.9842491571857215,19073,99.54477729791338,48.6329586729194,0.4860686747732469
34017,"Hudson County, New Jersey",668526,332210,336316,35910,470945,113760,50631,11201,5968,664616,64676,54738,119414,115156,50479,64677,338986,3734,6.08,88.1,10.141714757541218,17.225358475212634,67800,99.41513119908575,50.70647962831662,0.49692906483816635
34019,"Hunterdon County, New Jersey",125708,62725,62983,54200,88335,25921,12556,3019,2330,121613,2882,1976,4858,5499,2400,3099,64524,249,7.37,87,14.24332580265377,4.374423266617876,17905,96.74245075890158,51.328475514684825,0.49897381232697996
34021,"Mercer County, New Jersey",371101,181642,189459,40064,247879,51947,32532,6467,9291,364680,20423,15071,35494,39606,17513,22093,175094,1583,8.3,88.5,13.012629984828928,10.67256622860084,48290,98.2697432774366,47.18230346994484,0.4894678268180361
34023,"Middlesex County, New Jersey",831852,409221,422631,36558,566559,140178,72092,12618,10055,822360,45976,38692,84668,71749,32022,39727,395050,6319,7.54,88.8,11.392050508984772,8.62521217716613,94765,98.85893163687771,47.49041896875887,0.4919396719608777
34025,"Monmouth County, New Jersey",627532,305359,322173,46736,434984,113820,54097,13366,7002,623449,28309,23046,51355,47318,20047,27271,303317,1901,7.67,88.4,11.866327135508627,7.540332604552437,74465,99.34935588942078,48.33490563031049,0.4866030736281178
34027,"Morris County, New Jersey",498215,244099,254116,53491,346314,105914,53665,12956,7126,494402,17829,15208,33037,22483,9877,12606,254869,1158,6.57,85.7,14.802244011119697,4.512710376042472,73747,99.23466776391719,51.15642844956495,0.48994711118693735
34029,"Ocean County, New Jersey",586166,282068,304098,33312,404208,74063,29022,5397,2602,580846,25075,21568,46643,64770,28989,35781,243336,2008,8,87.5,6.315787677893293,11.04977088401579,37021,99.09240727029544,41.5131549765766,0.4812083948915495
34031,"Passaic County, New Jersey",507204,246848,260356,29393,332386,58809,22383,5016,2574,503399,41870,34063,75933,83738,37060,46678,229862,3241,5.98,86,5.909456550027208,16.509727841263082,29973,99.24980875545145,45.31943754386795,0.48668385896010286
34033,"Salem County, New Jersey",64504,31407,33097,31681,44731,6265,2286,260,255,63330,3143,2483,5626,8692,3928,4764,28641,313,6.34,88.8,4.342366364876597,13.475133325065112,2801,98.17995783207243,44.401897556740664,0.48690003720699493
34035,"Somerset County, New Jersey",331686,161900,169786,51923,228768,66798,38376,8456,7538,328828,12589,10868,23457,16924,7618,9306,168915,1286,7.65,88.1,16.39200931001007,5.102416140566681,54370,99.13834168460532,50.926177167562095,0.48811225074317277
34037,"Sussex County, New Jersey",144694,71759,72935,41272,101456,23609,8268,1499,863,143484,5850,4456,10306,8358,3929,4429,73922,495,6.39,85.1,7.346538211674292,5.776327974898752,10630,99.16375247073134,51.08850401537037,0.4959362516759506
34039,"Union County, New Jersey",550436,268169,282267,38163,371007,75296,34525,9031,5042,545797,41917,35406,77323,58464,24391,34073,264913,12913,6.49,88.2,8.82900101010835,10.621398309703581,48598,99.15721355434601,48.12784774251684,0.48719378819699294
34041,"Warren County, New Jersey",107095,52215,54880,37001,74882,15158,5955,1116,565,106152,4726,3944,8670,8334,3650,4684,52857,211,5.31,85.8,7.130118119426677,7.781875904570708,7636,99.1194733647696,49.35524534291984,0.4875577758065269
35001,"Bernalillo County, New Mexico",674777,330751,344026,28340,455336,82208,46150,10118,10799,667383,44784,39054,83838,124678,56821,67857,309193,2807,2.23,93.3,9.939135447710873,18.476919041401825,67067,98.9042305828444,45.82150843908432,0.4901634169510816
35003,"Catron County, New Mexico",3547,1860,1687,22487,2920,458,245,0,20,3538,333,263,596,809,283,526,1024,27,3.17,84.6,7.471102340005639,22.808006766281366,265,99.74626444882999,28.869467155342544,0.5243868057513391
35005,"Chaves County, New Mexico",65610,32534,33076,21177,41113,5333,2071,312,214,64624,5225,4341,9566,14196,6223,7973,26217,266,3.33,100.2,3.9582380734644107,21.63694558756287,2597,98.4971803078799,39.958847736625515,0.49586953208352386
35006,"Cibola County, New Mexico",27373,13884,13489,17768,18094,1583,558,63,48,25721,2745,2151,4896,7005,3345,3660,9370,403,2.36,88.1,2.4440141745515653,25.590910751470428,669,93.96485587988164,34.230811383480074,0.5072151390055895
35007,"Colfax County, New Mexico",12716,6431,6285,21785,9362,1429,486,54,103,12230,742,635,1377,2620,1266,1354,4629,0,3.49,86.3,5.056621579112929,20.603963510537906,643,96.17804340987732,36.40295690468701,0.5057407989933942
35009,"Curry County, New Mexico",50544,26213,24331,22628,30721,3684,2084,217,77,48070,4075,2923,6998,10676,4584,6092,22006,450,3.28,96.8,4.704811649256094,21.122190566635012,2378,95.10525482747705,43.53830326052548,0.5186174422285533
35011,"De Baca County, New Mexico",1977,915,1062,24571,1488,83,59,0,0,1949,168,92,260,389,170,219,641,27,2.54,99.5,2.9843196762771877,19.67627718765807,59,98.58371269600404,32.42286292362165,0.4628224582701062
35013,"Doña Ana County, New Mexico",213825,105129,108696,21050,127632,20459,10726,1830,2122,210440,16794,15887,32681,57626,27063,30563,89484,409,2.3,99,6.864491991114229,26.950075996726294,14678,98.41692973225769,41.8491757278148,0.49165906699403716
35015,"Eddy County, New Mexico",56369,28463,27906,28419,36493,3657,2114,189,233,55782,3385,3391,6776,7638,3204,4434,26214,139,5.97,101,4.498926715038408,13.550000887012365,2536,98.95864748354592,46.50428426972272,0.5049406588727847
35017,"Grant County, New Mexico",28879,14257,14622,23898,20511,2847,1977,299,496,28483,975,930,1905,6086,2686,3400,10448,29,3.91,90.7,9.598670314069047,21.074136916098205,2772,98.62876138370441,36.178538038020704,0.49368052910419336
35019,"Guadalupe County, New Mexico",4469,2602,1867,18086,3284,271,165,19,0,3828,166,115,281,542,249,293,1245,2,3.4,96.4,4.117252181696129,12.127992839561424,184,85.65674647572163,27.85858133810696,0.5822331617811591
35021,"Harding County, New Mexico",565,290,275,30782,454,98,14,0,5,565,14,23,37,81,32,49,202,2,2.88,96.1,3.3628318584070795,14.336283185840708,19,100,35.75221238938053,0.5132743362831859
35023,"Hidalgo County, New Mexico",4531,2227,2304,18338,3069,292,165,14,3,4421,301,332,633,1075,427,648,1745,15,2.55,95.4,4.016773339218716,23.725446921209446,182,97.57227984992275,38.51246965349812,0.49150297947472965
35025,"Lea County, New Mexico",68930,35420,33510,24507,41228,3351,1646,172,220,67277,5978,5974,11952,10549,4346,6203,28587,228,5.72,99.9,2.956622660670245,15.303931524735239,2038,97.6019149862179,41.47250834179602,0.5138546351370956
35027,"Lincoln County, New Mexico",19726,9736,9990,26820,14974,3034,944,139,162,19580,1119,998,2117,3515,1480,2035,7506,109,2.33,93.7,6.31146709925986,17.819121971002737,1245,99.259860083139,38.051302849031735,0.4935617966136064
35028,"Los Alamos County, New Mexico",17895,9187,8708,52125,12720,3103,2430,197,2486,17792,490,449,939,904,394,510,8971,118,4.25,85.6,28.572226879016483,5.051690416317407,5113,99.42442022911428,50.13132159821179,0.5133836267113719
35029,"Luna County, New Mexico",24627,12225,12402,16622,15743,1135,752,27,59,24252,2285,1766,4051,7153,3083,4070,7860,64,3.71,97.5,3.402769318227961,29.045356722296667,838,98.47728103301255,31.916189548057012,0.4964063832379096
35031,"McKinley County, New Mexico",74346,35924,38422,14077,43490,2854,1442,305,183,73990,10642,9421,20063,28089,13419,14670,22608,243,2.32,89.2,2.5959701934199555,37.781454281333225,1930,99.52115782960752,30.40916794447583,0.4832001721679714
35033,"Mora County, New Mexico",4598,2374,2224,16019,3012,286,66,0,45,4598,391,267,658,1036,592,444,1128,0,5.15,86.8,2.414093083949543,22.531535450195737,111,100,24.532405393649412,0.5163114397564158
35035,"Otero County, New Mexico",65333,33491,31842,21876,42385,4084,2800,334,253,60281,4411,4017,8428,15439,7353,8086,24795,99,3.2,94.7,5.184210123521038,23.631243016546,3387,92.26730748626268,37.951724243491036,0.5126199623467467
35037,"Quay County, New Mexico",8555,4260,4295,18220,5943,510,325,46,21,8514,466,192,658,1638,728,910,2976,18,2.9,98.9,4.5821157218001165,19.146697837521916,392,99.520748100526,34.78667445938048,0.4979544126241964
35039,"Rio Arriba County, New Mexico",39924,19608,20316,19602,26836,3178,1239,332,111,39667,3807,3129,6936,9275,4541,4734,14424,223,3.87,84.2,4.2130047089469995,23.23164011622082,1682,99.35627692615971,36.128644424406374,0.4911331529906823
35041,"Roosevelt County, New Mexico",19618,9843,9775,18954,11118,1394,845,52,229,19056,1514,1244,2758,4755,2198,2557,7779,161,3.25,98,5.739626873279641,24.237944744622286,1126,97.13528392292793,39.65236007747986,0.5017331022530329
35043,"Sandoval County, New Mexico",138117,67822,70295,27406,92821,15962,8628,1396,1628,137348,8217,7279,15496,19739,9272,10467,58130,617,2.97,90.5,8.43632572384283,14.291506476393202,11652,99.4432256709891,42.08750552068174,0.4910474452818987
35045,"San Juan County, New Mexico",122537,60845,61692,22665,78121,7051,3812,791,431,121183,12785,10248,23033,24871,11777,13094,49278,300,2.11,92.2,4.108146927050605,20.296726702955027,5034,98.89502762430939,40.21479226682553,0.4965439010258126
35047,"San Miguel County, New Mexico",28350,14268,14082,18012,19311,1984,1231,211,304,27772,2284,2007,4291,8093,3646,4447,9247,38,3.99,93.2,6.158730158730159,28.54673721340388,1746,97.96119929453263,32.617283950617285,0.5032804232804233
35049,"Santa Fe County, New Mexico",147320,71604,75716,35801,107601,22509,14251,3930,3381,145574,11988,10892,22880,22507,10198,12309,68321,523,3.75,89.5,14.636166168884062,15.277626934564214,21562,98.81482487102905,46.3759163725224,0.4860439858810752
35051,"Sierra County, New Mexico",11442,5663,5779,22749,8948,1027,448,60,46,11200,646,549,1195,2471,1387,1084,3885,0,3.36,94.8,4.841810872225135,21.59587484705471,554,97.88498514245761,33.95385422128999,0.4949309561265513
35053,"Socorro County, New Mexico",17324,8856,8468,17017,10697,1300,538,88,168,17225,1431,1179,2610,3796,1639,2157,5667,161,1.82,92,4.5832371276841375,21.911798660817364,794,99.42853844377741,32.71184483952898,0.5111983375663819
35055,"Taos County, New Mexico",32961,16084,16877,23229,24193,3909,2035,376,465,32777,2548,2148,4696,7168,3397,3771,13848,159,2.9,80.2,8.725463426473711,21.746913018415704,2876,99.44176450957193,42.01328843178302,0.4879706319589818
35057,"Torrance County, New Mexico",15599,8098,7501,19129,10890,1211,548,102,66,14925,1074,738,1812,4604,2175,2429,5419,18,3.5,91.1,4.590037822937368,29.514712481569333,716,95.67921020578243,34.73940637220335,0.5191358420411565
35059,"Union County, New Mexico",4292,2398,1894,23180,3065,303,170,9,6,3661,372,304,676,614,215,399,1531,16,4.26,93,4.310344827586207,14.305684995340167,185,85.2982292637465,35.671015843429636,0.5587138863000932
35061,"Valencia County, New Mexico",75993,38178,37815,20572,50347,5660,2462,227,272,74387,5203,3891,9094,17177,8046,9131,27702,445,1.43,95.6,3.8964115115865936,22.60339768136539,2961,97.8866474543708,36.45335754608977,0.5023883778769097
36001,"Albany County, New York",307891,148964,158927,35278,204003,42048,27676,6298,5025,304048,10087,6236,16323,37749,16940,20809,153524,1261,4.12,83.4,12.666495610459545,12.260507777102935,38999,98.75183100512844,49.86310090259215,0.4838205728650724
36003,"Allegany County, New York",47700,24124,23576,22377,30449,3085,2412,302,437,47207,2299,1856,4155,7284,3334,3950,19888,199,7.39,83.2,6.60587002096436,15.270440251572326,3151,98.9664570230608,41.693920335429766,0.5057442348008385
36005,"Bronx County, New York",1436785,676440,760345,19721,905151,113265,44840,9131,5933,1414859,101564,72479,174043,427715,182123,245592,560324,3258,5.81,87.8,4.169308560431797,29.76889374541076,59904,98.47395400146856,38.998458363638264,0.4708011289093358
36007,"Broome County, New York",197381,96991,100390,26790,130537,20084,12087,2179,1884,194413,6873,4357,11230,32624,14889,17735,86807,419,5.57,83,8.182145191279808,16.528439920762384,16150,98.49630916856232,43.97941037891185,0.49138974876001235
36009,"Cattaraugus County, New York",78506,38795,39711,23984,53233,5525,3462,395,268,77748,3830,3238,7068,13265,6161,7104,33359,256,7.13,82.3,5.254375461748147,16.896797696991314,4125,99.03446870302906,42.4922935826561,0.49416605100247113
36011,"Cayuga County, New York",78783,40388,38395,27957,55396,7079,3920,636,343,75490,3340,2163,5503,8494,3893,4601,36006,268,8.1,82.9,6.218346597616237,10.781513778353197,4899,95.82016424863232,45.70275313202087,0.5126486678598174
36013,"Chautauqua County, New York",131748,65093,66655,23962,90235,10220,6920,1009,657,129115,5199,3896,9095,24410,11132,13278,55259,200,6.36,81.9,6.516986975134348,18.52779548835656,8586,98.00148768861766,41.942951695661414,0.49407201627349184
36015,"Chemung County, New York",87742,43482,44260,27209,60379,8040,5460,801,458,84179,2838,2504,5342,13179,5690,7489,37386,111,7.36,84.6,7.657678192883682,15.02017277928472,6719,95.93923092703608,42.6090127874906,0.4955665473775387
36017,"Chenango County, New York",49286,24601,24685,25233,34728,3224,2368,262,201,48706,2003,1352,3355,7468,3237,4231,20846,115,6.14,80.7,5.74402467232074,15.152375928255488,2831,98.82319522785374,42.295986689932235,0.4991478310270665
36019,"Clinton County, New York",81505,41893,39612,25833,55217,6420,4501,778,582,76963,2645,1634,4279,11865,5166,6699,34648,672,4.38,79.6,7.190969879148518,14.557389117232072,5861,94.42733574627323,42.510275443224344,0.5139930065640145
36021,"Columbia County, New York",61860,31058,30802,34737,45731,6901,5078,1050,471,60143,2056,1597,3653,7605,3587,4018,29416,127,4.4,85.3,10.66763659877142,12.293889427740059,6599,97.22437762689945,47.55253798900743,0.502069188490139
36023,"Cortland County, New York",48713,23778,24935,26271,30566,4320,2526,309,420,48238,1818,1009,2827,6209,2350,3859,23749,77,7.02,80.9,6.681994539445323,12.746084207501077,3255,99.02490095046497,48.7528996366473,0.48812431999671546
36025,"Delaware County, New York",46480,23356,23124,26016,32976,4045,2504,242,234,45975,1817,1865,3682,6987,3218,3769,19380,175,5.48,79.7,6.411359724612737,15.032271944922547,2980,98.91351118760757,41.695352839931154,0.5024956970740103
36027,"Dutchess County, New York",295905,147197,148708,36704,202687,37842,23663,3866,3483,288137,11278,7854,19132,25562,11910,13652,140507,606,5.48,86.8,10.480390665923185,8.638583329109004,31012,97.37483313901421,47.483820820871564,0.4974468157009851
36029,"Erie County, New York",922129,446259,475870,31083,637800,113511,68330,14213,9313,910418,25857,18138,43995,132072,57904,74168,434029,2318,4.58,84.2,9.961296087640667,14.32250802219646,91856,98.73000415343189,47.06814339425395,0.48394422038565105
36031,"Essex County, New York",38598,20158,18440,29008,29016,3956,2432,383,367,36349,1466,1011,2477,3638,1569,2069,16975,523,5.27,78.2,8.243950463754599,9.425358826882222,3182,94.17327322659204,43.97896264055132,0.522255039121198
36033,"Franklin County, New York",51007,27788,23219,24294,35796,3291,2632,392,272,46172,2258,1782,4040,8706,4098,4608,19643,244,6.02,79.3,6.4618581763287395,17.06824553492658,3296,90.52090889485757,38.51040053326014,0.5447879702785892
36035,"Fulton County, New York",54297,27062,27235,26298,38699,3695,2512,281,92,53503,2672,1909,4581,8861,4026,4835,23674,334,6.16,81.1,5.313369062747482,16.31950199826878,2885,98.53767243125772,43.60093559496841,0.49840691014236516
36037,"Genesee County, New York",59053,29325,29728,27499,41449,5199,2961,374,266,58542,2113,1499,3612,7245,3258,3987,29209,201,4.95,84.1,6.097912045112018,12.268640035222596,3601,99.13467563036595,49.46234738285946,0.49658781094948606
36039,"Greene County, New York",48069,24956,23113,27402,35014,4147,2323,437,192,45128,1664,1345,3009,5826,2463,3363,19234,221,5.15,81.8,6.141172065156338,12.120077388753666,2952,93.88171170608916,40.0133141941792,0.5191703592752086
36041,"Hamilton County, New York",4697,2382,2315,24891,3575,387,330,34,22,4669,325,122,447,526,280,246,1830,126,6.5,77.5,8.218011496700022,11.198637428145625,386,99.40387481371089,38.96103896103896,0.5071322120502448
36043,"Herkimer County, New York",63558,31375,32183,24932,44238,5583,3292,427,222,62918,3045,1795,4840,8738,3993,4745,28266,129,7.33,79.5,6.2006356398879765,13.748072626577299,3941,98.99304572201768,44.472765033512694,0.49364360112023664
36045,"Jefferson County, New York",117966,61754,56212,24717,73692,8648,5272,948,426,105638,4710,3523,8233,16236,7638,8598,54184,558,6.78,82.5,5.6338266958276115,13.763287726972179,6646,89.54953122086025,45.931878676906905,0.5234898191004188
36047,"Kings County, New York",2606852,1234959,1371893,29928,1753695,362659,175664,41278,18084,2596190,157069,121476,278545,587518,260957,326561,1165434,5485,6.15,87.3,9.015701696912599,22.53745130141642,235026,99.59100094673576,44.70656562014261,0.4737357548491437
36049,"Lewis County, New York",27107,13671,13436,25779,18490,1562,1066,157,83,26714,1352,1049,2401,3750,1684,2066,11593,112,8.29,79.2,4.817943704578154,13.834065001660088,1306,98.55018998782602,42.767550817132104,0.5043346737005202
36051,"Livingston County, New York",64622,32439,32183,25882,42621,5666,3614,630,522,62084,1799,1407,3206,8720,4026,4694,29090,270,6.08,84.5,7.375197301228684,13.493856581350004,4766,96.07254495373093,45.015629352232985,0.5019807495899229
36053,"Madison County, New York",72089,35429,36660,28010,47606,7135,4151,734,696,71502,2348,1474,3822,7932,3703,4229,32625,205,7.15,80.6,7.741819140229438,11.003065654954293,5581,99.18572875195939,45.25655786597123,0.49146194287616696
36055,"Monroe County, New York",749236,361925,387311,31291,507237,103720,60943,11757,9557,742076,22947,15638,38585,107724,47629,60095,355665,1896,5.69,85.1,10.978783721017143,14.377846232695706,82257,99.04435985457185,47.47035646979056,0.48305874250569913
36057,"Montgomery County, New York",49667,24468,25199,25307,34243,3323,1697,314,133,48884,2601,1684,4285,10014,4361,5653,21140,184,5.55,83.5,4.31674955201643,20.16228079006181,2144,98.42350051341937,42.563472728370954,0.4926409889866511
36059,"Nassau County, New York",1356801,658161,698640,46839,934765,223888,128614,41380,13151,1346876,49685,38737,88422,80282,35043,45239,660186,3798,5.38,86.6,13.498294886280302,5.917006252206477,183145,99.2684999495136,48.657540788958734,0.48508292667826747
36061,"New York County, New York",1634989,773232,861757,69529,1237623,393504,220929,90250,43270,1624084,71048,51694,122742,279847,121555,158292,875398,6812,6.04,87.7,21.678983772979514,17.11613961928796,354449,99.33302303562898,53.54152229770353,0.472927952420475
36063,"Niagara County, New York",213374,103798,109576,28395,150231,20581,12226,1465,1024,211319,6681,4823,11504,28523,12647,15876,98585,697,3.7,84.9,6.896341634875852,13.367608049715523,14715,99.03690234049134,46.20291132002962,0.4864603934874914
36065,"Oneida County, New York",232858,116027,116831,27283,159946,22943,11423,2273,1408,225239,7493,5100,12593,36789,17108,19681,100764,415,7.49,81.6,6.4863564919392935,15.798898899758651,15104,96.7280488538079,43.27272414948166,0.4982736259866528
36067,"Onondaga County, New York",468050,226022,242028,31436,315056,60720,34310,7776,5322,462864,15633,11165,26798,68285,30645,37640,219060,1491,8.34,83,10.128832389701955,14.589253284905459,47408,98.89199871808567,46.80269202008333,0.48290139942313853
36069,"Ontario County, New York",109450,53705,55745,33685,76016,13224,8656,1225,1280,108522,3712,2593,6305,10898,4720,6178,52951,278,7.54,84.1,10.197350388305162,9.957058017359525,11161,99.15212425765189,48.37916857012334,0.4906806761078118
36071,"Orange County, New York",376242,188285,187957,32616,238224,39527,22722,3783,2332,367037,14535,10484,25019,46342,20718,25624,171898,994,7.03,85.7,7.664481902605238,12.31707252247224,28837,97.55343635213507,45.68814752207356,0.500435889666757
36073,"Orleans County, New York",41938,20887,21051,23929,29695,2891,1529,193,99,39187,1622,1377,2999,6089,2705,3384,17496,229,4.26,84.5,4.3421240879393395,14.519051933807049,1821,93.4403166579236,41.71872764557204,0.49804473270065336
36075,"Oswego County, New York",120513,60384,60129,25791,80149,8349,5061,563,480,119812,5047,3407,8454,21100,9714,11386,50895,205,8.2,82.8,5.06501373295827,17.508484561831505,6104,99.41832001526807,42.23195837793433,0.5010579771476936
36077,"Otsego County, New York",60979,29517,31462,26688,39869,6067,3618,940,739,60310,2554,1814,4368,9106,4143,4963,27541,147,6.56,79.7,8.6865970252054,14.933009724659309,5297,98.90290099870447,45.16472884107644,0.48405188671509863
36079,"Putnam County, New York",99408,49388,50020,44063,69769,15744,8964,1369,1086,98778,3571,2868,6439,5061,2603,2458,49848,154,6.28,86.1,11.487003058103976,5.091139546112989,11419,99.36624818928054,50.14485755673588,0.4968211813938516
36081,"Queens County, New York",2310011,1120010,1190001,28814,1630963,316435,137606,30028,14937,2294929,177935,140943,318878,334149,145569,188580,1090910,5334,5.86,87.2,7.903468857940504,14.465255793154231,182571,99.34710267613444,47.22531624308282,0.48485050504088506
36083,"Rensselaer County, New York",159959,78890,81069,33067,110059,18613,10039,1942,1665,158204,5064,3298,8362,19064,8664,10400,78576,290,4.8,83,8.530936052363419,11.918054001337843,13646,98.90284385373752,49.122587663088666,0.4931888796504104
36085,"Richmond County, New York",473324,229095,244229,33922,324340,60675,31186,7010,2841,469465,17984,13103,31087,60530,26762,33768,206773,1279,6.59,87.8,8.669959689345987,12.788280332288242,41037,99.18470223356518,43.68529801996096,0.48401306504635305
36087,"Rockland County, New York",322642,158136,164506,36898,202987,45139,27694,6045,3175,320199,13980,11228,25208,46128,21952,24176,144060,679,6.73,87.5,11.441163890628003,14.296960718071423,36914,99.242814016774,44.650107549544074,0.4901283775825838
36089,"St. Lawrence County, New York",111529,56822,54707,23554,72141,8189,6108,1019,1112,107906,5483,3829,9312,19107,9279,9828,43218,358,6.51,81.5,7.387316303382977,17.13186704803235,8239,96.75151754252258,38.75045952173874,0.5094818388042572
36091,"Saratoga County, New York",224929,111025,113904,39653,158211,36963,19676,3071,3020,221645,5582,4113,9695,14193,6148,8045,114143,502,4.94,83,11.45561488291861,6.309991152763761,25767,98.53998372819868,50.746235478751075,0.4936002027306394
36093,"Schenectady County, New York",154845,75383,79462,29981,106136,17769,11219,1747,1723,153116,5108,3892,9000,18055,7943,10112,72215,517,4.4,83.2,9.48626045400239,11.660047143918112,14689,98.88339952856082,46.636959540185345,0.4868287642481191
36095,"Schoharie County, New York",31667,15789,15878,26953,22026,2632,1504,207,169,31594,1232,660,1892,4273,2061,2212,13586,27,4.45,80.8,5.9367796128461805,13.493542173240282,1880,99.76947611077779,42.90270628730224,0.4985947516341933
36097,"Schuyler County, New York",18336,9183,9153,25285,13277,1481,956,185,145,18062,963,579,1542,2617,1121,1496,8135,44,7.73,83.3,7.0135253054101225,14.272469458987784,1286,98.50567190226876,44.3662739965096,0.5008180628272252
36099,"Seneca County, New York",35036,18470,16566,26541,24924,2842,1687,231,222,32261,1761,1361,3122,3952,1672,2280,15113,154,7.93,84.1,6.1080031967119535,11.279826464208243,2140,92.07957529398332,43.13563192145222,0.5271720516040644
36101,"Steuben County, New York",98151,48750,49401,27731,68291,7941,5820,841,660,96973,4496,3288,7784,14558,6474,8084,42245,406,7.69,83.2,7.458915344723946,14.832248270521951,7321,98.79980845839573,43.04082485150431,0.4966836812666198
36103,"Suffolk County, New York",1498130,737351,760779,40277,1024860,192708,119081,25880,14727,1483117,65239,47323,112562,106499,46853,59646,723743,4104,3.74,84.8,10.659155079999733,7.108795631887753,159688,98.99788402875585,48.30975950017689,0.492180918878869
36105,"Sullivan County, New York",75818,38803,37015,28224,53020,6514,4150,664,525,73437,4219,2748,6967,12479,5735,6744,31731,251,5.39,82,7.041863409744388,16.459152180221057,5339,96.85958479516738,41.85153921232425,0.5117913951832018
36107,"Tioga County, New York",49649,24549,25100,30252,34981,5464,2717,350,227,49274,1813,1242,3055,5405,2239,3166,22446,174,6.28,84.4,6.63457471449576,10.886422687264597,3294,99.2446977784044,45.2093697758263,0.4944510463453443
36109,"Tompkins County, New York",104268,51285,52983,29759,59666,13254,10156,2150,5229,103385,3323,2126,5449,18133,8161,9972,48415,135,6.87,83.2,16.81724018874439,17.39076226646718,17535,99.15314382169026,46.433229754095215,0.4918575210035677
36111,"Ulster County, New York",180505,89631,90874,32453,129015,21827,13977,2217,1936,176129,8453,6269,14722,22480,10269,12211,83526,468,6.32,82.8,10.044043101299133,12.453948644081882,18130,97.57569042408798,46.27351042907399,0.49655688208082877
36113,"Warren County, New York",64911,31835,33076,33127,47419,7369,4789,850,467,64348,2731,1653,4384,7079,3100,3979,31466,155,5.42,80.8,9.40672613270478,10.905701653032613,6106,99.13265856326355,48.47560505923495,0.49044075734467196
36115,"Washington County, New York",62465,32308,30157,26064,44794,5322,3082,435,230,59457,2889,1931,4820,7627,3608,4019,28175,92,4.34,83.8,5.9985591931481625,12.210037621067798,3747,95.18450332186025,45.105258945009204,0.5172176418794525
36117,"Wayne County, New York",91874,45514,46360,27318,63894,8175,4494,581,306,90882,3684,2654,6338,10761,5120,5641,42287,383,6.99,83.3,5.856934497246229,11.712780547271263,5381,98.92026035657531,46.02716764264101,0.49539586825434834
36119,"Westchester County, New York",969229,468336,500893,52049,661283,157929,104595,35635,14652,956762,48863,36206,85069,92600,41150,51450,459790,3442,5.71,87.6,15.979918058580584,9.553985693783408,154882,98.71371987425056,47.438737388171425,0.48320469156411955
36121,"Wyoming County, New York",41239,22339,18900,25635,29560,2789,1385,178,81,37655,1321,883,2204,4312,2007,2305,18049,146,5.55,82.4,3.9865176168190306,10.456121632435316,1644,91.3091976042096,43.76682266786295,0.541695967409491
36123,"Yates County, New York",25106,12110,12996,26608,16434,2155,1359,131,161,24747,2605,2627,5232,3319,1549,1770,10980,116,8.01,84,6.576117262805703,13.21994742292679,1651,98.57006293316338,43.7345654425237,0.4823548155819326
37001,"Alamance County, North Carolina",156372,74352,82020,25157,105035,15755,5251,1205,973,155264,10606,11418,22024,28123,12060,16063,71314,607,7.2,90.3,4.750850535901568,17.98467756375822,7429,99.29143324891925,45.605351341672424,0.47548154401043663
37003,"Alexander County, North Carolina",37211,18974,18237,22655,26287,2394,910,174,24,35980,2286,1837,4123,6240,2909,3331,15281,256,5.8,89.7,2.9776141463545724,16.76923490365752,1108,96.69183843487141,41.06581387224208,0.5099029856762786
37005,"Alleghany County, North Carolina",10868,5391,5477,21153,8022,961,405,89,38,10738,926,772,1698,2089,874,1215,4334,22,7.91,82.9,4.895104895104895,19.221567905778432,532,98.80382775119617,39.878542510121456,0.4960434302539566
37007,"Anson County, North Carolina",25883,13575,12308,19105,18180,1204,342,69,117,24129,2304,1657,3961,5484,2475,3009,9920,23,6.42,94.3,2.039949001274968,21.187652126878646,528,93.22335123440095,38.326314569408495,0.5244755244755245
37009,"Ashe County, North Carolina",26992,13302,13690,23650,20231,2799,946,105,101,26750,2595,1720,4315,5290,2611,2679,11415,155,7.74,82,4.267931238885596,19.598399525785418,1152,99.10343805572022,42.290308239478364,0.49281268524007116
37011,"Avery County, North Carolina",17633,9639,7994,21704,13135,1526,804,179,92,15633,1556,1276,2832,2509,1366,1143,6396,33,6.64,80.1,6.096523563772472,14.229002438609426,1075,88.65763057902795,36.272897408268584,0.5466454942437475
37013,"Beaufort County, North Carolina",47513,22714,24799,24657,33861,4039,1724,275,248,47150,3227,2697,5924,8215,3445,4770,18773,73,13.02,91.4,4.72923199966325,17.29000484078042,2247,99.23599856881275,39.51129164649675,0.4780586365836718
37015,"Bertie County, North Carolina",20324,10389,9935,18319,14946,1152,444,101,28,19081,1630,963,2593,3992,1838,2154,6998,130,15.7,90.3,2.819326904152726,19.641802794725447,573,93.88407793741389,34.43219838614446,0.5111690612084235
37017,"Bladen County, North Carolina",34454,16361,18093,20839,24247,2461,826,158,148,34088,2364,2501,4865,9549,4132,5417,12503,92,11.79,93.2,3.285540140477158,27.715214488883728,1132,98.93771405352064,36.28896499680734,0.474865037441226
37019,"Brunswick County, North Carolina",119167,57790,61377,29707,91995,16111,6721,1124,875,118194,9058,7642,16700,17992,7317,10675,45376,455,13.67,91.9,7.317462049057205,15.098139585623537,8720,99.18349878741599,38.07765572683713,0.48494969244841274
37021,"Buncombe County, North Carolina",250112,120043,130069,29590,181217,40737,18313,4265,2964,246270,17314,14931,32245,35996,16154,19842,116999,421,6.07,85.2,10.212224923234391,14.391952405322415,25542,98.46388817809621,46.7786431678608,0.47995697927328557
37023,"Burke County, North Carolina",89082,44089,44993,21885,63189,7018,2603,704,333,86692,6806,5198,12004,17135,7818,9317,35924,220,5.65,90.1,4.086122898004086,19.23508677398352,3640,97.31707864664017,40.326889831840326,0.49492602321456636
37025,"Cabarrus County, North Carolina",192296,93508,98788,29143,126364,24764,8586,1603,1207,190935,10246,9791,20037,22324,9662,12662,90790,478,6.25,93.2,5.926280317843325,11.60918583849898,11396,99.29223696800766,47.21367059117194,0.48627116528684944
37027,"Caldwell County, North Carolina",81623,40166,41457,21991,57994,5561,1829,420,189,80778,6052,5670,11722,14137,6291,7846,33236,449,5.81,89.8,2.986903201303554,17.31987307499112,2438,98.96475258199283,40.71891501170013,0.4920916898423239
37029,"Camden County, North Carolina",10228,5133,5095,27468,7029,913,320,72,126,10034,582,455,1037,1060,492,568,4458,56,11.65,90.3,5.064528744622605,10.363707469691045,518,98.10324599139616,43.586233867813846,0.5018576456785295
37031,"Carteret County, North Carolina",68537,33660,34877,30903,51177,7934,3807,898,636,66913,4907,4243,9150,8869,3800,5069,30151,480,14.85,90,7.79287100398325,12.940455520375856,5341,97.63047696864467,43.992296132016286,0.49112158396194755
37033,"Caswell County, North Carolina",23094,11640,11454,21692,16896,1568,457,141,63,22234,1413,1448,2861,4888,2234,2654,8948,48,6.9,89.7,2.8622152940157615,21.165670736987963,661,96.27608902745301,38.74599463063999,0.5040270200051962
37035,"Catawba County, North Carolina",155461,76086,79375,25960,106667,15711,5576,1178,587,153975,10419,9158,19577,24269,10999,13270,69477,627,5.52,90.9,4.72208463859103,15.610989251323483,7341,99.04413325528589,44.69095142833251,0.4894217842417069
37037,"Chatham County, North Carolina",68778,33303,35475,36933,50607,10310,5650,1743,1936,68048,4676,4014,8690,9185,4484,4701,28976,234,7.5,91.6,13.56393032655791,13.354561051499026,9329,98.93861409171538,42.12975079240455,0.4842100671726424
37039,"Cherokee County, North Carolina",27226,13308,13918,21152,20675,2453,1151,257,116,26946,2618,2344,4962,5247,2370,2877,9364,151,5.42,86.7,5.597590538455888,19.272019393227062,1524,98.97157129214722,34.39359435833394,0.48879747300374643
37041,"Chowan County, North Carolina",14556,6925,7631,23542,10580,1250,708,114,57,14290,1176,913,2089,3491,1538,1953,5399,69,16.26,90.3,6.038746908491344,23.983237153064028,879,98.17257488320968,37.091233855454796,0.47574883209672986
37043,"Clay County, North Carolina",10730,5059,5671,25433,8070,1067,401,92,134,10680,897,980,1877,1731,751,980,4063,56,7.26,85.2,5.8434296365330844,16.132339235787512,627,99.53401677539608,37.86579683131407,0.47148182665424043
37045,"Cleveland County, North Carolina",97113,46731,50382,21664,66196,6380,3308,569,535,96868,7589,6278,13867,19866,8310,11556,39452,125,5.51,92.2,4.5431610597963195,20.45658150814,4412,99.74771657759517,40.6248391049602,0.4812023107102036
37047,"Columbus County, North Carolina",57015,28027,28988,21849,39320,3236,1163,213,98,54225,4447,4146,8593,12443,5386,7057,20127,155,11.53,92.9,2.5852845742348505,21.82408138209243,1474,95.10655090765589,35.30123651670613,0.4915723932298518
37049,"Craven County, North Carolina",104190,52791,51399,26830,67479,9770,4020,764,604,96561,7176,5955,13131,15205,6410,8795,46375,517,12.71,91.5,5.171321623956234,14.593531049045014,5388,92.6778001727613,44.51002975333525,0.5066801036567808
37051,"Cumberland County, North Carolina",325841,159259,166582,23627,201229,31694,13368,1939,1522,298408,18581,17778,36359,55235,22754,32481,143280,1096,11.47,93.6,5.164788961487351,16.951519299290144,16829,91.58086305897662,43.972366890600014,0.48876292424832973
37053,"Currituck County, North Carolina",24864,12299,12565,29340,17586,2803,848,110,84,24549,1977,1474,3451,2468,914,1554,11985,87,11.45,89.6,4.190797940797941,9.925997425997426,1042,98.73310810810811,48.202220077220076,0.4946509009009009
37055,"Dare County, North Carolina",35187,17290,17897,30898,26002,5028,1784,387,353,35027,3541,2711,6252,2885,1320,1565,18056,225,9.66,89.2,7.173103703072157,8.199050785801575,2524,99.54528661153267,51.31440588853838,0.4913746554125103
37057,"Davidson County, North Carolina",164058,80049,84009,24231,114042,15053,4507,759,429,162188,10580,9452,20032,26221,11446,14775,69950,456,6.85,91.4,3.471333308951712,15.98276219385827,5695,98.860159211986,42.63735995806361,0.48793109753867536
37059,"Davie County, North Carolina",41568,20263,21305,29234,29431,4498,1726,471,242,41188,3071,2296,5367,5735,2785,2950,18349,316,7.16,90.9,5.867494226327945,13.79667051578137,2439,99.08583525789068,44.142128560431104,0.48746632024634334
37061,"Duplin County, North Carolina",59121,28969,30152,18529,39458,2844,953,148,104,58551,6633,5642,12275,16106,7313,8793,24059,264,12.31,92.4,2.038192858713486,27.24243500617378,1205,99.03587557720607,40.69450787368279,0.48999509480556824
37063,"Durham County, North Carolina",294618,140813,153805,33151,198989,50313,26268,7671,9130,289003,21741,18481,40222,48907,22191,26716,146585,1069,6.94,91,14.618590853240468,16.600139842100617,43069,98.09414224521244,49.7542580561948,0.47795110957239545
37065,"Edgecombe County, North Carolina",54669,25396,29273,18946,37030,2496,1089,176,86,53769,4383,3459,7842,13750,5909,7841,20840,899,10.38,90.5,2.4712359838299585,25.15136549049736,1351,98.35372880425835,38.12032413250654,0.46454114763394244
37067,"Forsyth County, North Carolina",364691,173059,191632,28640,242327,51269,20404,5719,4040,361541,24671,22304,46975,69253,31017,38236,161825,1238,6.59,90,8.270837503530386,18.989500700593105,30163,99.1362550762152,44.37318167983307,0.4745359770326112
37069,"Franklin County, North Carolina",62989,31235,31754,23862,43150,6141,2251,298,115,61965,4582,4006,8588,9967,4415,5552,26686,259,7.42,91.2,4.22930987950277,15.823397736112655,2664,98.37431932559653,42.36612741907317,0.4958802330565654
37071,"Gaston County, North Carolina",211753,102235,109518,24937,144794,20501,6255,1194,767,209643,15201,13975,29176,35812,15062,20750,91608,575,5.56,92.6,3.879992255127436,16.912157088683514,8216,99.00355602990277,43.26172474534009,0.4828030771700991
37073,"Gates County, North Carolina",11615,5762,5853,24335,8245,788,268,101,36,11510,678,533,1211,1391,581,810,4989,80,13.75,90.5,3.486870426173052,11.975893241498063,405,99.09599655617735,42.9530779164873,0.4960826517434352
37075,"Graham County, North Carolina",8651,4326,4325,19095,6004,557,231,52,0,8536,802,813,1615,1650,802,848,2959,0,6.9,83.8,3.2712981158247603,19.072939544561322,283,98.67067391053058,34.204138249913306,0.5000577967864986
37077,"Granville County, North Carolina",58341,29722,28619,24859,40513,5498,1732,416,222,55352,3688,2807,6495,9109,4169,4940,23936,163,6.08,90,4.062323237517355,15.613376527656365,2370,94.87667335150238,41.02775063848751,0.5094530433143073
37079,"Greene County, North Carolina",21241,11452,9789,18662,14865,1010,220,35,107,19109,1744,1362,3106,4646,1968,2678,7983,53,11.36,91.9,1.7042512122781412,21.87279318299515,362,89.96280777741161,37.582976319382325,0.5391459912433502
37081,"Guilford County, North Carolina",511815,242827,268988,28582,339288,76052,29389,6180,5296,507863,34311,30695,65006,87165,37656,49509,236026,1252,7.21,90.6,7.984330275587859,17.03056768558952,40865,99.22784599904263,46.11549094887801,0.47444291394351473
37083,"Halifax County, North Carolina",52849,25436,27413,20406,36756,3333,1261,179,151,51454,3741,2788,6529,13782,6341,7441,19092,139,9.3,90.2,3.0104637741489904,26.07807148668849,1591,97.36040417037219,36.125565289787886,0.4812957671857556
37085,"Harnett County, North Carolina",126620,62640,63980,22351,80278,10485,3979,643,357,120300,8360,7485,15845,22461,10008,12453,51265,342,9.46,92.7,3.9322381930184807,17.738903806665615,4979,95.00868741115147,40.487284789132836,0.49470857684410047
37087,"Haywood County, North Carolina",59577,28798,30779,27166,44393,6451,3136,549,415,59127,3978,3734,7712,9851,4662,5189,24548,227,6.13,80.6,6.88185037850177,16.53490440941974,4100,99.24467495845713,41.203820266210116,0.48337445658559514
37089,"Henderson County, North Carolina",110905,53523,57382,28290,81797,15743,6316,1181,1072,109798,8303,6755,15058,14559,6677,7882,46669,209,6.54,85.6,7.726432532347505,13.12745142238853,8569,99.00184842883549,42.08015869437807,0.4826022271313286
37091,"Hertford County, North Carolina",24285,11991,12294,18383,16827,1658,605,134,119,22165,1423,1481,2904,5217,2135,3082,8725,86,16.22,90,3.533045089561458,21.48239654107474,858,91.27033148033766,35.92752728021412,0.49376158122297714
37093,"Hoke County, North Carolina",51853,25654,26199,19654,32562,4315,1170,96,199,47833,3468,3579,7047,11545,5128,6417,20223,265,9.53,93.7,2.8252945827628104,22.264864135151292,1465,92.24731452374984,39.000636414479395,0.4947447592231886
37095,"Hyde County, North Carolina",5629,2977,2652,19181,4069,266,77,13,0,4951,420,477,897,1108,431,677,2080,51,13.43,90.6,1.5988630307337004,19.683780422810447,90,87.95523183513946,36.95150115473441,0.5288683602771362
37097,"Iredell County, North Carolina",167493,82362,85131,30393,113529,20177,6809,1369,804,166284,9766,10320,20086,22114,9216,12898,76677,867,7.15,90.9,5.362612168866758,13.202939824350869,8982,99.27817878956135,45.77922659454425,0.49173398291271875
37099,"Jackson County, North Carolina",41227,20392,20835,23674,26312,4338,2145,472,772,40951,3353,2420,5773,8646,4138,4508,17218,79,7.3,82.2,8.220341038639726,20.971693307783735,3389,99.33053581390836,41.76389259465884,0.4946273073471269
37101,"Johnston County, North Carolina",182155,89432,92723,24872,119442,18482,5367,927,555,180447,14254,12031,26285,26272,12217,14055,81508,367,8.93,92.8,3.7599846284757485,14.422881611814114,6849,99.0623370206692,44.74650709560539,0.490966484587302
37103,"Jones County, North Carolina",10074,4878,5196,21058,7453,687,247,41,71,9985,933,686,1619,2285,1007,1278,3815,60,13.23,92,3.5636291443319434,22.682152074647608,359,99.11653762160016,37.869763748262855,0.48421679571173315
37105,"Lee County, North Carolina",59540,29003,30537,23613,39503,5692,2073,233,227,58347,4978,4441,9419,10673,4462,6211,25486,99,8.04,92.2,4.254282835068861,17.925764192139738,2533,97.99630500503864,42.804837084313064,0.487117903930131
37107,"Lenoir County, North Carolina",58343,27863,30480,21594,40257,3638,1474,192,204,57185,5219,4085,9304,12614,5631,6983,23819,148,12.86,92.4,3.205183141079478,21.620417188008844,1870,98.01518605488234,40.82580600928989,0.4775722880208423
37109,"Lincoln County, North Carolina",79783,39547,40236,27359,55973,7801,2462,375,395,79193,4965,4929,9894,11907,5667,6240,36071,317,5.84,91.6,4.050988305779427,14.924231979243698,3232,99.26049409021972,45.21138588421092,0.4956820375267914
37111,"McDowell County, North Carolina",45013,22731,22282,20439,32087,3307,1007,251,134,44107,3517,2758,6275,8814,4184,4630,17198,136,6.6,89.2,3.0924399617888167,19.581009930464532,1392,97.98724812831848,38.206740275031656,0.5049874480705574
37113,"Macon County, North Carolina",33991,16429,17562,27282,25339,3866,1394,357,164,33774,3190,2832,6022,6183,2829,3354,13501,360,8.38,83.6,5.633844252890471,18.19010914653879,1915,99.3615957165132,39.71933747168368,0.4833338236592039
37115,"Madison County, North Carolina",21130,10447,10683,22653,14943,2132,1156,229,175,20899,1511,978,2489,3337,1436,1901,9044,61,4.92,86.7,7.382867960246096,15.79271178419309,1560,98.90676762896356,42.801703738760054,0.49441552295314717
37117,"Martin County, North Carolina",23510,10951,12559,22161,16797,1786,551,159,155,23338,1777,1695,3472,4721,2004,2717,9066,31,14.29,91,3.6792854104636326,20.080816673755848,865,99.26839642705232,38.56231390897491,0.4658017864738409
37119,"Mecklenburg County, North Carolina",1011774,486037,525737,35669,669789,191987,72577,16329,7772,1006217,75023,65334,140357,141024,61267,79757,508464,4793,6.09,93.5,9.555295945537244,13.938290566865723,96678,99.45076667318986,50.254701148675494,0.4803809941745884
37121,"Mitchell County, North Carolina",15263,7465,7798,22302,11286,1268,482,181,40,15134,1104,958,2062,2688,1148,1540,5924,45,5.95,82.4,4.60590971630741,17.611216667758633,703,99.15481884295355,38.81281530498591,0.4890912664613772
37123,"Montgomery County, North Carolina",27475,13437,14038,20900,19275,2067,549,112,69,26635,2255,2332,4587,5821,2486,3335,10571,62,8.41,93.7,2.656960873521383,21.186533212010918,730,96.94267515923566,38.47497725204732,0.48906278434940853
37125,"Moore County, North Carolina",93070,44833,48237,31554,67105,13816,6231,1780,1107,90500,5087,4769,9856,13478,5850,7628,38342,263,9.92,93.4,9.79692704416031,14.481573009562695,9118,97.23863758461373,41.19694853336198,0.4817126893735898
37127,"Nash County, North Carolina",94385,45309,49076,25232,64449,8474,3121,552,468,92985,6134,6063,12197,16057,6109,9948,40446,144,9.5,90.6,4.3873496848016105,17.012237113948192,4141,98.51671346082534,42.85214811675584,0.48004449859617526
37129,"New Hanover County, North Carolina",216430,104029,112401,31708,146747,36940,12865,3352,2498,213925,14549,11882,26431,37167,16154,21013,104263,1058,14.87,91.9,8.647137642655824,17.172757935591186,18715,98.84258189714919,48.17400545210923,0.4806588735387885
37131,"Northampton County, North Carolina",20628,10017,10611,19126,15083,1024,499,99,79,19846,1536,1523,3059,5616,2380,3236,6837,34,11.99,90.1,3.2819468683343027,27.225130890052355,677,96.20903626139228,33.14426992437463,0.4856020942408377
37133,"Onslow County, North Carolina",185755,100854,84901,23141,99874,13534,4533,966,458,154944,9672,8541,18213,23890,10250,13640,90037,795,13.42,91.6,3.2069123307582568,12.861026621086916,5957,83.41309789776857,48.470835239966625,0.5429409706333611
37135,"Orange County, North Carolina",139807,66666,73141,38348,85572,22331,14807,4650,7581,139108,6174,5487,11661,18713,8072,10641,69700,723,7.03,90.1,19.339518049883054,13.384880585378415,27038,99.50002503451186,49.85444219531211,0.4768430765269264
37137,"Pamlico County, North Carolina",12892,6599,6293,25461,9832,1200,506,58,125,12233,964,977,1941,1773,710,1063,4766,62,11.61,90.8,5.344399627676078,13.75271486192988,689,94.88830282345641,36.968662736580825,0.5118678250077567
37139,"Pasquotank County, North Carolina",39909,19548,20361,23714,26667,3177,1512,157,188,38471,2768,2701,5469,6521,2798,3723,16737,192,12.45,90.4,4.653085770127039,16.339672755518805,1857,96.39680272620211,41.937908742388935,0.48981432759527926
37141,"Pender County, North Carolina",56358,28042,28316,25997,39475,5942,2289,533,357,54928,4368,3997,8365,10304,4441,5863,23313,132,12.89,92,5.640725362858866,18.28311863444409,3179,97.46264949075552,41.36591078462685,0.49756911174988466
37143,"Perquimans County, North Carolina",13470,6439,7031,25848,10020,1295,316,93,40,13373,939,1044,1983,2208,938,1270,5314,10,14.38,90.4,3.3333333333333335,16.391982182628063,449,99.27988121752041,39.45063103192279,0.47802524127691165
37145,"Person County, North Carolina",39196,19019,20177,24477,27539,3119,801,83,101,38770,2636,1988,4624,7127,3305,3822,16185,121,6.79,88.8,2.513011531788958,18.182977854883152,985,98.91315440351056,41.29247882436983,0.4852280844984182
37147,"Pitt County, North Carolina",175150,82515,92635,25462,103759,19154,7920,1755,1737,173917,12136,11661,23797,41412,17525,23887,80774,495,12.77,91.5,6.515558093063089,23.643733942335142,11412,99.29603197259492,46.117042534970025,0.4711104767342278
37149,"Polk County, North Carolina",20324,9732,10592,29728,15498,3159,1265,329,174,20042,1157,1395,2552,2902,1389,1513,8327,187,5.68,92.3,8.699074985239125,14.278685298169652,1768,98.61247785868923,40.97126549891754,0.4788427474906514
37151,"Randolph County, North Carolina",142588,70281,72307,22349,97483,10502,3220,489,527,141369,11557,9968,21525,23757,10985,12772,62644,413,8.31,92.3,2.9707969815131707,16.661289870115297,4236,99.14508934833226,43.933570847476645,0.49289561533929926
37153,"Richmond County, North Carolina",45710,22113,23597,19966,30690,2818,1150,171,99,44428,3504,3117,6621,11443,5010,6433,17032,121,8.51,93.9,3.106541238241085,25.03390942900897,1420,97.1953620651936,37.2609932181142,0.4837672281776417
37155,"Robeson County, North Carolina",134576,64911,69665,17161,85168,7545,2371,542,298,132630,12732,11008,23740,40313,18242,22071,47527,448,9.34,93.6,2.3860123647604325,29.955564142194746,3211,98.55397693496612,35.3161039115444,0.48233711805968377
37157,"Rockingham County, North Carolina",91898,44313,47585,22521,65420,6372,2055,318,303,90850,5640,5437,11077,17517,7651,9866,37356,194,6.26,90.4,2.911924089751681,19.06135062787003,2676,98.85960521447691,40.64941565648871,0.48219765392065117
37159,"Rowan County, North Carolina",138694,68575,70119,23838,94810,12060,3688,555,407,136184,10326,8929,19255,24142,10589,13553,56970,422,6.14,91.9,3.3527045149754136,17.406665032373425,4650,98.19026057363693,41.07603789637619,0.49443378949341715
37161,"Rutherford County, North Carolina",66701,32392,34309,21092,47393,5212,1928,497,291,65822,4710,4525,9235,12668,5699,6969,25029,257,4.84,92.3,4.071902969970465,18.992219007211286,2716,98.68217867798084,37.524175049849326,0.4856299006011904
37163,"Sampson County, North Carolina",63713,31190,32523,20872,42520,3712,1024,182,152,63135,5963,5233,11196,15207,6960,8247,26236,130,11.52,93.1,2.131433145511905,23.867970429896566,1358,99.09280680551849,41.1784094297867,0.4895390265722851
37165,"Scotland County, North Carolina",35711,17684,18027,17103,23654,2193,906,203,172,33796,2376,2181,4557,10480,4384,6096,11106,36,7.35,93.7,3.5871300159614683,29.34669989639047,1281,94.63750665061185,31.09966116882753,0.49519755817535216
37167,"Stanly County, North Carolina",60610,30158,30452,23398,41814,4824,1487,236,187,59238,3566,3740,7306,10047,4379,5668,26204,162,5.3,93.7,3.151295165814222,16.576472529285596,1910,97.73634713743607,43.23378980366276,0.49757465764725295
37169,"Stokes County, North Carolina",46453,22749,23704,23500,33618,3744,850,53,166,46011,3031,2782,5813,7052,3178,3874,19887,68,6.84,89.1,2.301250726540805,15.180935569285085,1069,99.04850063505049,42.811013282242264,0.4897207930596517
37171,"Surry County, North Carolina",72767,35422,37345,22533,50839,5078,2099,371,221,71976,5793,5068,10861,12801,5872,6929,29195,223,7.53,88.6,3.698104910192807,17.591765498096663,2691,98.91296879079803,40.12120878969863,0.4867865928236701
37173,"Swain County, North Carolina",14234,6940,7294,20918,9749,979,392,71,53,14055,1783,1299,3082,3277,1544,1733,5359,35,7.76,81.6,3.625122945061121,23.02234087396375,516,98.74244766053113,37.64929043136153,0.48756498524659264
37175,"Transylvania County, North Carolina",33062,15910,17152,26037,24839,4448,2044,423,451,32587,2938,2695,5633,4598,1926,2672,13088,65,9.87,83.3,8.825842356784223,13.90720464581695,2918,98.5633053051842,39.58623192789305,0.48121710725303973
37177,"Tyrrell County, North Carolina",4128,2325,1803,17736,3118,134,104,10,9,3582,312,290,602,905,382,523,1391,0,14.36,90.5,2.979651162790698,21.9234496124031,123,86.77325581395348,33.69670542635659,0.5632267441860465
37179,"Union County, North Carolina",217614,107221,110393,32754,137190,32883,10024,2067,1162,216646,12801,11256,24057,20772,9373,11399,101446,688,5.58,94.4,6.090141259293979,9.545341751909344,13253,99.55517567803543,46.617405130184636,0.49271186596450595
37181,"Vance County, North Carolina",44508,20766,23742,21188,29683,2448,678,183,93,44051,3425,3032,6457,11177,4944,6233,16664,24,6.32,90.4,2.1434348881100025,25.112339354722746,954,98.9732182978341,37.440460141996944,0.46656780803451064
37183,"Wake County, North Carolina",998576,485068,513508,37315,656256,209531,86957,15793,16312,989818,55394,48037,103431,105133,47986,57147,510506,3854,7.71,91.5,11.923178606335421,10.528292288218424,119062,99.12295108234126,51.12339972120299,0.4857597218439057
37185,"Warren County, North Carolina",20324,10196,10128,21543,14437,1280,635,84,114,19335,1800,1330,3130,4662,2187,2475,6845,50,7.26,90.6,4.098602637276127,22.938397953158827,833,95.13383192284984,33.67939382011415,0.501672899035623
37187,"Washington County, North Carolina",12503,5815,6688,21117,8641,559,212,50,15,12321,885,1001,1886,2916,923,1993,4400,15,16.19,91,2.2154682876109733,23.32240262337039,277,98.54434935615453,35.19155402703351,0.4650883787890906
37189,"Watauga County, North Carolina",52745,26315,26430,24545,29439,6690,2942,540,1284,52442,2762,2710,5472,14797,7663,7134,22859,108,6.43,81.6,9.035927576073561,28.053843966252725,4766,99.42553796568396,43.338705090529906,0.4989098492748128
37191,"Wayne County, North Carolina",124447,61002,63445,23163,81949,10571,3544,616,564,120095,8901,8620,17521,26475,11601,14874,51725,338,10.39,92.7,3.7959934751339928,21.274116692246498,4724,96.5029289577089,41.563878598921626,0.4901845765667312
37193,"Wilkes County, North Carolina",68888,33902,34986,21798,48877,4747,1524,257,198,68019,5208,3964,9172,14278,6552,7726,27311,86,6.97,88.8,2.8727790036000465,20.726396469631865,1979,98.73853211009174,39.645511554987806,0.4921321565439554
37195,"Wilson County, North Carolina",81617,38626,42991,23383,55015,7035,2479,407,292,80492,6393,5753,12146,18043,7891,10152,34322,1601,9.62,91.4,3.893796635504858,22.106914000759645,3178,98.62161069385054,42.05251356947695,0.4732592474607006
37197,"Yadkin County, North Carolina",37819,18602,19217,23038,26459,2198,827,107,79,37547,2883,2499,5382,7112,3349,3763,15200,103,7.05,89.5,2.678547819878897,18.805362383986886,1013,99.28078479071367,40.19143816600122,0.4918691662920754
37199,"Yancey County, North Carolina",17599,8609,8990,21947,12972,1731,534,173,175,17418,1263,1142,2405,3713,1692,2021,6623,64,6.73,82.1,5.0116483891130175,21.09778964713904,882,98.97153247343599,37.63282004659356,0.48917552133643954
38001,"Adams County, North Dakota",2348,1187,1161,35933,1682,319,79,30,35,2297,77,80,157,241,89,152,1233,14,2.89,86.9,6.132879045996593,10.264054514480408,144,97.82793867120954,52.512776831345825,0.5055366269165247
38003,"Barnes County, North Dakota",11033,5427,5606,32517,7712,1390,289,50,97,10838,512,221,733,1025,451,574,5703,35,4.4,80.4,3.9517810205746398,9.290310885525242,436,98.23257500226593,51.69038339526874,0.49188797244629745
38005,"Benson County, North Dakota",6802,3492,3310,21658,3861,423,126,10,20,6789,707,454,1161,2270,1106,1164,2384,21,5.59,79.9,2.2934431049691266,33.37253748897383,156,99.80887974125257,35.04851514260512,0.5133784181123199
38007,"Billings County, North Dakota",936,533,403,44683,687,130,20,6,15,936,42,39,81,103,46,57,510,4,3.41,84.1,4.380341880341881,11.004273504273504,41,100,54.48717948717949,0.5694444444444444
38009,"Bottineau County, North Dakota",6650,3488,3162,35698,4653,764,162,32,32,6482,219,228,447,569,237,332,3281,17,4.41,81.3,3.398496240601504,8.556390977443609,226,97.47368421052632,49.338345864661655,0.5245112781954887
38011,"Bowman County, North Dakota",3238,1571,1667,36318,2215,361,109,13,3,3176,113,115,228,242,88,154,1669,12,3.12,86.3,3.8604076590487955,7.473749227918468,125,98.0852378011118,51.54416306361952,0.4851760345892526
38013,"Burke County, North Dakota",2239,1208,1031,35674,1519,228,84,2,3,2235,135,107,242,265,101,164,1101,5,3.48,81.4,3.974988834301027,11.835640911121036,89,99.82134881643591,49.17373827601608,0.5395265743635551
38015,"Burleigh County, North Dakota",90560,45126,45434,36483,60830,14754,4023,1230,813,88605,3243,2828,6071,6745,2983,3762,49723,137,5.01,82,6.698321554770318,7.448100706713781,6066,97.84121024734982,54.90613957597173,0.4982994699646643
38017,"Cass County, North Dakota",166852,84300,82552,34193,103797,27277,7564,1998,1944,165567,7220,5451,12671,19089,9236,9853,95471,567,5.1,81.8,6.895931723922998,11.440677966101696,11506,99.22985639968356,57.21897250257713,0.5052381751492341
38019,"Cavalier County, North Dakota",3867,1957,1910,43144,2822,431,67,8,21,3772,103,58,161,198,62,136,1907,10,6.28,77.9,2.482544608223429,5.120248254460822,96,97.54331523144556,49.31471424877166,0.5060770623222136
38021,"Dickey County, North Dakota",5160,2590,2570,30510,3531,754,127,75,31,5016,148,204,352,417,150,267,2737,0,5.76,81.3,4.515503875968992,8.081395348837209,233,97.20930232558139,53.042635658914726,0.501937984496124
38023,"Divide County, North Dakota",2369,1190,1179,39171,1781,388,17,0,6,2294,73,72,145,215,100,115,1239,2,3.67,82.1,0.970873786407767,9.07555930772478,23,96.83410721823554,52.30054875474884,0.5023216547066273
38025,"Dunn County, North Dakota",4284,2266,2018,42438,2957,463,104,33,5,4230,431,354,785,490,229,261,2025,25,3.92,83.8,3.3146591970121384,11.437908496732026,142,98.73949579831933,47.26890756302521,0.5289449112978525
38027,"Eddy County, North Dakota",2370,1144,1226,35444,1693,278,69,22,6,2300,116,67,183,306,151,155,1189,36,4.99,79,4.0928270042194095,12.91139240506329,97,97.0464135021097,50.16877637130802,0.48270042194092827
38029,"Emmons County, North Dakota",3426,1713,1713,29622,2473,340,22,7,9,3371,103,91,194,403,171,232,1456,21,5.73,82.7,1.1091652072387623,11.762988908347928,38,98.39462930531232,42.49854057209574,0.5
38031,"Foster County, North Dakota",3345,1663,1682,32665,2390,404,98,3,12,3275,140,104,244,306,115,191,1731,12,4.75,79.6,3.3781763826606874,9.147982062780269,113,97.90732436472346,51.74887892376682,0.49715994020926757
38033,"Golden Valley County, North Dakota",1895,931,964,28840,1237,213,58,3,2,1843,182,136,318,175,72,103,1003,14,3.96,84.2,3.3245382585751977,9.234828496042216,63,97.25593667546174,52.928759894459105,0.49129287598944593
38035,"Grand Forks County, North Dakota",69793,36093,33700,30465,40330,8827,2996,725,799,67702,2862,2297,5159,11507,5385,6122,38663,244,5.6,80.4,6.47629418423051,16.48732680927887,4520,97.00399753556947,55.39667301878412,0.517143553078389
38037,"Grant County, North Dakota",2369,1176,1193,33537,1816,248,54,21,5,2325,98,89,187,315,140,175,1167,15,5.42,84.7,3.376952300548755,13.296749683410722,80,98.14267623469819,49.26129168425496,0.49641198818066695
38039,"Griggs County, North Dakota",2311,1165,1146,33416,1732,315,27,0,9,2214,71,81,152,161,75,86,1197,0,5.25,78.5,1.5577672003461704,6.96668109043704,36,95.80268282128948,51.79575941151017,0.504110774556469
38041,"Hettinger County, North Dakota",2639,1252,1387,32544,1951,223,35,8,3,2480,102,92,194,207,61,146,1179,2,3.53,84.8,1.7430845017051915,7.843880257673361,46,93.97499052671466,44.676013641530886,0.4744221295945434
38043,"Kidder County, North Dakota",2419,1284,1135,34455,1782,289,54,5,3,2417,146,54,200,170,79,91,1337,16,5.68,80.8,2.563042579578338,7.0276973956180235,62,99.91732120711038,55.270773046713515,0.5307978503513848
38045,"LaMoure County, North Dakota",4111,2112,1999,36653,2952,518,121,15,11,4042,174,74,248,384,158,226,1995,9,4.87,81,3.5757723181707615,9.340792994405254,147,98.3215762588178,48.52833860374605,0.513743614692289
38047,"Logan County, North Dakota",1939,986,953,31952,1456,176,21,0,4,1863,50,33,83,130,54,76,980,5,6.69,80,1.2893243940175347,6.704486848891181,25,96.0804538421867,50.541516245487365,0.5085095410005157
38049,"McHenry County, North Dakota",5912,3079,2833,36874,4101,701,123,16,11,5825,246,167,413,583,257,326,2928,21,3.48,82.8,2.537212449255751,9.861299052774019,150,98.52841677943167,49.52638700947226,0.5208051420838972
38051,"McIntosh County, North Dakota",2737,1367,1370,31133,2123,299,59,30,0,2630,52,43,95,253,86,167,1367,0,5.54,80.1,3.2517354767994155,9.243697478991596,89,96.09061015710633,49.94519546949214,0.49945195469492143
38053,"McKenzie County, North Dakota",10718,5610,5108,38324,6485,1185,307,66,36,10642,991,926,1917,1361,654,707,5197,60,4.43,83.8,3.8160104497107667,12.698264601604777,409,99.29091248367233,48.48852397835417,0.5234185482366113
38055,"McLean County, North Dakota",9576,4917,4659,36953,6972,998,233,31,12,9403,383,362,745,923,395,528,4536,23,3.92,82.9,2.882205513784461,9.638680033416875,276,98.19340016708438,47.36842105263158,0.5134711779448622
38057,"Mercer County, North Dakota",8671,4477,4194,36720,6137,940,241,52,35,8552,510,533,1043,634,136,498,4284,75,3.65,83.7,3.7827240226040826,7.3117287510091105,328,98.62760927228693,49.4060661976704,0.5163187636950756
38059,"Morton County, North Dakota",29633,15295,14338,37335,20665,3868,932,267,161,29084,864,759,1623,2521,1432,1089,16717,31,4.83,83.6,4.589477946883542,8.507407282421624,1360,98.14733574055951,56.413457969156006,0.5161475382175278
38061,"Mountrail County, North Dakota",9675,5241,4434,40113,6137,1134,228,51,38,9580,1053,799,1852,1122,538,584,4709,39,3.62,83,3.2764857881136953,11.5968992248062,317,99.01808785529715,48.671834625322994,0.5417054263565891
38063,"Nelson County, North Dakota",3032,1525,1507,33599,2312,378,63,5,3,2950,101,98,199,253,103,150,1506,71,5.41,78.4,2.341688654353562,8.344327176781002,71,97.29551451187335,49.67018469656992,0.5029683377308707
38065,"Oliver County, North Dakota",1768,931,837,38604,1282,176,24,19,4,1768,120,83,203,72,27,45,886,13,3.95,83.1,2.658371040723982,4.072398190045249,47,100,50.113122171945705,0.5265837104072398
38067,"Pembina County, North Dakota",7136,3689,3447,34824,5189,816,171,56,7,6959,369,227,596,415,199,216,3519,15,7.11,79.6,3.2791479820627805,5.815582959641255,234,97.51961883408072,49.31334080717489,0.5169562780269058
38069,"Pierce County, North Dakota",4373,2216,2157,26619,3169,319,95,30,0,4188,278,129,407,766,305,461,2045,2,4.31,81.5,2.8584495769494627,17.51657900754631,125,95.76949462611479,46.76423507889321,0.5067459410016008
38071,"Ramsey County, North Dakota",11578,5891,5687,33884,7948,1305,246,124,64,11069,566,513,1079,1217,587,630,6218,100,6.61,78.9,3.7484885126964933,10.511314562100535,434,95.60373121437209,53.705303161167734,0.5088098117118673
38073,"Ransom County, North Dakota",5457,2780,2677,33574,3852,549,63,25,26,5305,143,113,256,487,197,290,2823,0,5.12,82.3,2.0890599230346343,8.924317390507605,114,97.21458676928715,51.73172072567345,0.5094374198277442
38075,"Renville County, North Dakota",2573,1282,1291,30888,1722,231,53,7,5,2496,62,62,124,169,66,103,1280,0,3.96,82.3,2.5262339681305868,6.568208317139526,65,97.00738437621453,49.74737660318694,0.4982510687912942
38077,"Richland County, North Dakota",16329,8454,7875,29818,10478,1767,376,107,41,16153,394,387,781,1501,625,876,8667,35,4.89,82.3,3.209014636536224,9.192234674505482,524,98.9221630228428,53.0773470512585,0.5177291934594892
38079,"Rolette County, North Dakota",14607,7215,7392,18075,8240,1474,296,42,41,14484,2410,1815,4225,4523,2042,2481,5156,17,4.46,78.2,2.5946464024098037,30.96460601081673,379,99.15793797494352,35.298144725131785,0.49394126103922775
38081,"Sargent County, North Dakota",3889,2053,1836,36207,2780,448,72,3,4,3851,113,75,188,221,80,141,2080,5,5.4,82.2,2.0313705322705067,5.682694780149139,79,99.02288506042684,53.48418616610954,0.5278992028799178
38083,"Sheridan County, North Dakota",1395,707,688,34172,1088,124,38,6,0,1395,54,42,96,235,79,156,613,0,4.48,82.2,3.154121863799283,16.845878136200717,44,100,43.9426523297491,0.5068100358422939
38085,"Sioux County, North Dakota",4431,2223,2208,15944,2306,304,48,11,20,4387,732,521,1253,1646,774,872,1289,18,5.18,85.5,1.7828932520875649,37.1473707966599,79,99.00699616339426,29.090498758745206,0.5016926201760324
38087,"Slope County, North Dakota",665,361,304,35118,508,132,14,3,0,665,33,18,51,67,35,32,320,3,2.91,85.4,2.556390977443609,10.075187969924812,17,100,48.1203007518797,0.5428571428571428
38089,"Stark County, North Dakota",29837,15538,14299,37978,19510,3456,899,173,290,29408,1526,1331,2857,1961,815,1146,16485,97,3.42,83.9,4.564802091363073,6.57237657941482,1362,98.5621878875222,55.25019271374468,0.5207628112745919
38091,"Steele County, North Dakota",1969,1028,941,40479,1451,291,42,0,3,1969,49,48,97,119,59,60,992,3,4.87,79.1,2.28542407313357,6.043676993397664,45,100,50.38090401218893,0.5220924327069578
38093,"Stutsman County, North Dakota",21108,10801,10307,31182,14564,2869,494,151,59,20195,958,684,1642,2108,914,1194,10776,123,5.57,79.9,3.3352283494409702,9.986734887246541,704,95.67462573431874,51.05173393973849,0.511701724464658
38095,"Towner County, North Dakota",2292,1142,1150,36099,1630,240,60,3,0,2258,113,105,218,317,139,178,920,7,4.9,78.6,2.74869109947644,13.830715532286213,63,98.51657940663176,40.139616055846425,0.49825479930191974
38097,"Traill County, North Dakota",8075,4071,4004,31774,5462,1087,340,26,31,7893,200,150,350,637,328,309,4131,33,5.34,80.2,4.91640866873065,7.8885448916408665,397,97.74613003095975,51.1578947368421,0.5041486068111455
38099,"Walsh County, North Dakota",10995,5638,5357,30693,7686,946,228,74,37,10804,478,333,811,1134,496,638,5468,9,7.19,79.7,3.083219645293315,10.313778990450205,339,98.26284674852205,49.73169622555707,0.5127785356980445
38101,"Ward County, North Dakota",68954,36151,32803,33414,42320,8389,2070,441,263,64969,3046,2254,5300,4889,1906,2983,39373,164,3.03,83,4.022971836296661,7.090234069089538,2774,94.22078487107346,57.10038576442266,0.5242770542680628
38103,"Wells County, North Dakota",4179,2083,2096,33580,3137,542,98,10,17,4099,130,117,247,214,92,122,2004,18,4.26,80.4,2.9911462072266093,5.120842306771955,125,98.08566642737497,47.954055994257,0.49844460397224216
38105,"Williams County, North Dakota",31643,17360,14283,44474,20494,3409,793,247,164,31262,1443,1526,2969,3033,1670,1363,16686,78,3.67,84,3.8049489618557026,9.585058306734506,1204,98.79594223050911,52.73204184179755,0.5486205479884967
39001,"Adams County, Ohio",28111,13972,14139,20248,19106,1277,640,124,39,27848,1956,1570,3526,6770,2831,3939,10050,118,6.56,87.2,2.856533029774821,24.083099142684357,803,99.06442317953825,35.751129451104546,0.4970296325281918
39003,"Allen County, Ohio",104664,52851,51813,24551,69294,7063,3567,926,492,102085,5561,3698,9259,16228,7679,8549,47134,246,4.81,85.3,4.76286020025988,15.504853626843996,4985,97.53592448215241,45.03363143010013,0.5049587250630589
39005,"Ashland County, Ohio",53343,26055,27288,24612,35233,4447,1814,196,462,52783,2937,2934,5871,7859,3664,4195,23772,128,3.97,85.4,4.634160058489399,14.732954651969331,2472,98.95019027801212,44.56442269838592,0.488442719757044
39007,"Ashtabula County, Ohio",99175,49847,49328,21936,68800,5866,2541,329,290,96088,5853,4720,10573,18735,8383,10352,39685,242,5.27,83.8,3.186286866649861,18.890849508444667,3160,96.88732039324427,40.0151247794303,0.502616586841442
39009,"Athens County, Ohio",65103,32492,32611,20062,35638,4949,3510,395,1526,64403,2778,2148,4926,17301,8629,8672,26482,63,4.29,87.5,8.34216549160561,26.574812220634993,5431,98.92478073207072,40.67708093329033,0.4990860636222601
39011,"Auglaize County, Ohio",45871,22865,23006,28340,30993,3633,1525,239,111,45361,1259,1235,2494,3973,1489,2484,22748,213,4.6,85.1,4.087549868108391,8.66124566719714,1875,98.88818643587452,49.59124501318916,0.49846308124959127
39013,"Belmont County, Ohio",69228,35300,33928,25326,50793,5304,2509,291,230,65433,3002,2560,5562,9839,4330,5509,29044,292,4.73,85.5,4.37684174033628,14.212457387184376,3030,94.51811405789564,41.954122609348815,0.5099092852602993
39015,"Brown County, Ohio",44059,21855,22204,24525,30392,2607,976,96,101,43513,2692,1740,4432,7179,2962,4217,18689,125,5.87,86.8,2.6623391361583333,16.294060237408928,1173,98.76075262715904,42.41812115572301,0.4960394017113416
39017,"Butler County, Ohio",373638,183146,190492,29745,237812,44722,18748,2431,3384,370330,15749,13238,28987,49134,21035,28099,175014,987,6.89,87.3,6.574010138155113,13.150161386154513,24563,99.114651079387,46.84052478602283,0.4901696294274137
39019,"Carroll County, Ohio",28108,14029,14079,26908,20017,1403,614,122,148,27828,1821,1410,3231,3873,1748,2125,12217,24,4.08,86.2,3.14501209620037,13.778995303828092,884,99.00384232247048,43.46449409420806,0.4991105735022058
39021,"Champaign County, Ohio",39175,19599,19576,25528,26605,2931,1283,102,75,38687,1604,1073,2677,4279,1969,2310,17673,55,6.33,84.9,3.7268666241225272,10.922782386726228,1460,98.7543075941289,45.112954690491385,0.500293554562859
39023,"Clark County, Ohio",136175,65897,70278,25270,92888,10432,4858,809,590,134417,6287,5193,11480,23792,10593,13199,58685,368,6,85.1,4.594822838259592,17.471635762805214,6257,98.70901413622177,43.09528180649899,0.4839140811455847
39025,"Clermont County, Ohio",201092,99198,101894,31812,136065,25022,10064,1617,876,199788,7931,6753,14684,20968,9214,11754,96917,508,5.99,87,6.244405545720367,10.427068207586577,12557,99.35154058838741,48.19535337059654,0.49329660056093727
39027,"Clinton County, Ohio",41854,20761,21093,25238,27753,3012,1216,189,160,41537,2056,1504,3560,6169,2804,3365,18401,153,5.5,85.8,3.7391886080183494,14.73933196349214,1565,99.24260524681034,43.9647345534477,0.4960338318918144
39029,"Columbiana County, Ohio",105230,52906,52324,24758,75173,7046,2757,420,253,101691,5550,4415,9965,15946,6929,9017,45624,342,4.37,85.8,3.259526750926542,15.153473344103393,3430,96.63689062054547,43.356457284044474,0.5027653710918939
39031,"Coshocton County, Ohio",36665,18231,18434,21520,25192,2105,791,91,50,36273,2348,2337,4685,5058,2159,2899,15545,110,4.71,86.2,2.541933724260194,13.795172507841265,932,98.9308604936588,42.39738169916814,0.49723169234965225
39033,"Crawford County, Ohio",42485,20785,21700,24386,29720,2478,1055,198,35,41907,1882,1588,3470,6566,2836,3730,17953,122,4.63,85.7,3.0316582323172883,15.454866423443569,1288,98.63951983052843,42.25726727080146,0.48923149346828293
39035,"Cuyahoga County, Ohio",1258710,599319,659391,30441,871903,158303,74555,24522,11962,1243379,57597,44635,102232,227740,100599,127141,570474,3808,5.1,85.4,8.821650737659985,18.093127090433857,111039,98.78200697539545,45.322115499201566,0.47613747408060636
39037,"Darke County, Ohio",52185,25632,26553,24768,35498,2991,1463,128,66,51572,2143,1811,3954,6344,2775,3569,23683,156,6.41,85.3,3.175241927757018,12.156750023953244,1657,98.82533295008145,45.38277282744084,0.4911756251796493
39039,"Defiance County, Ohio",38488,19165,19323,26941,25881,2717,1104,139,117,38187,1943,1526,3469,5129,2258,2871,17912,72,4.82,86,3.5335689045936394,13.326231552691748,1360,99.21793805861567,46.53918104344211,0.4979474121804199
39041,"Delaware County, Ohio",188996,93421,95575,45116,122837,41266,16989,3849,2331,188101,4476,3325,7801,9034,4083,4951,95558,691,5.99,86.6,12.258989608245678,4.7799953438168,23169,99.52644500412707,50.56085843086626,0.4943014666977079
39043,"Erie County, Ohio",75808,37092,38716,30223,53707,7236,3149,865,347,74861,3601,2516,6117,9584,4334,5250,34822,72,4.07,84.9,5.7526910088645,12.642465175179401,4361,98.75079147319543,45.93446601941748,0.48928872942169693
39045,"Fairfield County, Ohio",150163,74713,75450,29582,100589,18030,6770,1135,631,147508,5527,4260,9787,15010,6532,8478,68717,300,4.4,86.5,5.68448952138676,9.995804559045837,8536,98.23192131217411,45.76160572178233,0.49754600001331883
39047,"Fayette County, Ohio",28719,14101,14618,24013,19699,2199,524,89,46,28258,1581,1279,2860,5207,2433,2774,12224,37,5.11,86,2.2946481423447893,18.13085413837529,659,98.3947909049758,42.56415613357011,0.4909989902155368
39049,"Franklin County, Ohio",1232118,600802,631316,31199,812175,197863,78418,20498,14714,1224220,70109,54787,124896,205186,93858,111328,619892,4860,5.71,86.8,9.222330978039441,16.65311277004313,113630,99.35898996687006,50.31109033388036,0.4876172574380051
39051,"Fulton County, Ohio",42466,21055,21411,27922,28535,3126,1300,334,97,42077,1362,835,2197,4688,2218,2470,20063,94,4.54,85.8,4.0762021381811335,11.039419771111007,1731,99.08397306080158,47.24485470729525,0.49580841143503035
39053,"Gallia County, Ohio",30376,14839,15537,22293,20590,1862,1090,113,116,29998,2114,1508,3622,6334,2599,3735,11360,96,5.69,87.4,4.342243876744798,20.851988411904134,1319,98.75559652357124,37.39794574664209,0.48851066631551227
39055,"Geauga County, Ohio",94020,46372,47648,39513,63739,15428,6249,1289,789,93367,5545,4438,9983,6399,3045,3354,45678,252,5.42,84.7,8.856626249734099,6.805998723675813,8327,99.3054669219315,48.5832801531589,0.49321420974260793
39057,"Greene County, Ohio",164325,80712,83613,33138,109074,21775,14430,2079,2780,160467,6023,4282,10305,19929,8553,11376,77282,287,6.78,85.4,11.738323444393732,12.12779552715655,19289,97.6522136010954,47.02997109386886,0.49117298037425833
39059,"Guernsey County, Ohio",39478,19497,19981,22864,27290,2373,1054,195,103,38985,2160,1617,3777,7722,3463,4259,16146,168,4.41,86.5,3.4246922336491212,19.560261411419017,1352,98.75120320178327,40.898728405694314,0.4938700035462789
39061,"Hamilton County, Ohio",805965,387906,418059,32638,539750,116797,52669,13852,8809,798045,38396,27997,66393,140334,62937,77397,381996,2318,6.83,87.4,9.346559714131507,17.411922353948373,75330,99.01732705514507,47.39610280843461,0.48129385271072567
39063,"Hancock County, Ohio",75672,37160,38512,29608,51192,8523,3728,541,435,74856,2800,2548,5348,9877,4320,5557,36599,156,3.98,86.2,6.216301934665398,13.052383972935829,4704,98.92166190929274,48.36531345808225,0.49106670895443494
39065,"Hardin County, Ohio",31652,15787,15865,21099,19340,1565,942,123,155,31452,1584,1751,3335,4574,2238,2336,13545,159,4,85.5,3.854416782509794,14.450903576393276,1220,99.36812839630987,42.79350435991407,0.49876785037280424
39067,"Harrison County, Ohio",15521,7678,7843,22965,11153,719,276,49,34,15265,747,819,1566,2756,1188,1568,6585,44,4.19,86,2.3129952966948006,17.756587848721086,359,98.35062173829006,42.42639005218736,0.49468462083628634
39069,"Henry County, Ohio",27890,13745,14145,27325,19062,1956,905,118,78,27492,1042,730,1772,2783,1150,1633,13193,80,4.51,86.2,3.9476514879885265,9.978486912871997,1101,98.57296522050915,47.30369307995697,0.49282897095733236
39071,"Highland County, Ohio",43109,21245,21864,22079,29250,2043,1097,208,163,42690,2603,2239,4842,8822,3930,4892,16838,107,6,86.4,3.4053213946043748,20.464404184741007,1468,99.02804518777981,39.05912918416108,0.4928205247164165
39073,"Hocking County, Ohio",28690,14246,14444,23192,19914,1908,721,155,31,28056,1697,1305,3002,4655,1960,2695,11960,46,4.42,86.7,3.161380271871732,16.225165562913908,907,97.79017079121645,41.686998954339494,0.49654932032066923
39075,"Holmes County, Ohio",43702,21854,21848,21143,24892,1278,491,111,43,42916,8504,8942,17446,5504,2542,2962,19008,490,4.38,85.9,1.4759049929065031,12.594389272802161,645,98.20145531096975,43.49457690723537,0.5000686467438561
39077,"Huron County, Ohio",58704,29041,29663,24193,39230,3527,1435,253,73,58184,3100,2332,5432,7467,3382,4085,26659,145,4.23,85.4,2.999795584627964,12.719746524938675,1761,99.11420005451076,45.41257835922595,0.4947022349414009
39079,"Jackson County, Ohio",32717,15979,16738,21730,22233,2550,1110,82,11,32385,1762,1396,3158,7409,3225,4184,12832,61,6.75,87.2,3.6769874988538067,22.645719350796224,1203,98.98523703273527,39.22119998777394,0.4884005257205734
39081,"Jefferson County, Ohio",67607,32771,34836,24028,47810,4770,1840,391,376,66863,2922,2465,5387,11208,4766,6442,27043,223,4.94,85.6,3.8561095744523497,16.578164982915972,2607,98.89952223882142,40.00029582735515,0.4847279127900957
39083,"Knox County, Ohio",60878,29853,31025,24523,39526,5796,1879,267,711,60294,3404,3178,6582,8958,3992,4966,27285,279,4.22,85.3,4.692992542461973,14.714675252143632,2857,99.04070435953875,44.819146489700714,0.49037419100496077
39085,"Lake County, Ohio",229266,111975,117291,32125,163400,28368,12405,2172,1238,227172,8332,6826,15158,19231,8984,10247,115685,294,5.18,84.8,6.8981008959025765,8.388073242434553,15815,99.08665044097249,50.45885565238631,0.48840647980947893
39087,"Lawrence County, Ohio",61503,30191,31312,22844,42820,3806,1707,380,163,60918,3306,2317,5623,11183,5128,6055,24142,274,5.16,88.1,3.6583581288717624,18.182852868965742,2250,99.04882688649334,39.25336975432093,0.4908866234167439
39089,"Licking County, Ohio",169762,83232,86530,29093,113951,17279,6703,1465,1137,168423,7321,6454,13775,20814,8913,11901,80941,710,4.83,85.6,5.481203096099245,12.26069438390217,9305,99.21124868934155,47.67910368633734,0.4902864009613459
39091,"Logan County, Ohio",45388,22470,22918,26525,31017,3143,1339,211,132,45073,2742,2017,4759,6258,2585,3673,20586,105,6.01,84.7,3.7058253282806026,13.78778531770512,1682,99.3059839605182,45.355600599277345,0.49506477483035166
39093,"Lorain County, Ohio",304091,149762,154329,28555,207879,30342,14272,2542,1672,297506,11555,8880,20435,41156,16700,24456,136657,2226,3.99,84.4,6.07910132164385,13.534106566784285,18486,97.83452979535731,44.939508239309944,0.4924907346813947
39095,"Lucas County, Ohio",434800,211033,223767,27111,290221,44900,19428,5199,3290,429550,21367,15323,36690,87717,40787,46930,192054,1514,5.14,86.1,6.4206531738730455,20.174103035878566,27917,98.79254829806808,44.17065317387304,0.4853564857405704
39097,"Madison County, Ohio",43537,23807,19730,27798,30727,3587,1115,204,118,38607,2032,1199,3231,4061,1850,2211,18011,152,5.39,85.9,3.300640834232951,9.327698279624228,1437,88.67629832096837,41.36940992718837,0.546822243149505
39099,"Mahoning County, Ohio",233015,113472,119543,25901,164692,24386,9637,2265,1245,227859,9904,7845,17749,40823,17826,22997,100590,1082,4.82,86.6,5.642126043387765,17.51947299530073,13147,97.78726691414715,43.16889470634938,0.48697294165611654
39101,"Marion County, Ohio",65620,35004,30616,22579,46162,3558,1727,320,71,59587,2779,2170,4949,10299,4572,5727,25325,239,4.89,86.5,3.227674489484913,15.694910088387687,2118,90.80615665955501,38.59341664126791,0.5334349283754952
39103,"Medina County, Ohio",175543,86786,88757,34174,120879,25845,9471,1781,926,174446,5626,4694,10320,11532,5001,6531,88642,555,3.96,85.5,6.9373315939684295,6.569330591365079,12178,99.375081888768,50.495889895922936,0.4943859908968173
39105,"Meigs County, Ohio",23345,11465,11880,22396,16515,1367,733,61,58,23138,1323,1197,2520,5247,2409,2838,8672,57,5.89,86.7,3.6496037695437997,22.475904904690513,852,99.11330049261083,37.147140715356606,0.4911115870636111
39107,"Mercer County, Ohio",40886,20558,20328,27540,27115,2957,1477,75,55,40499,1295,968,2263,3347,1352,1995,20286,96,5.28,85.2,3.930440737660813,8.186176197231326,1607,99.05346573399207,49.61600547864795,0.5028126987232794
39109,"Miami County, Ohio",103864,51232,52632,28051,71649,9739,4508,593,252,102984,4391,3727,8118,11374,4675,6699,49364,273,5.21,86,5.153855041207733,10.95085881537395,5353,99.15273819610259,47.52753600862667,0.4932604174689979
39111,"Monroe County, Ohio",14442,7220,7222,23154,10470,711,332,53,24,14288,784,688,1472,2679,1271,1408,5370,14,5.2,86.4,2.8320177260767205,18.55006231823847,409,98.93366569727185,37.18321562110511,0.49993075751280985
39113,"Montgomery County, Ohio",532761,256454,276307,27602,362549,56864,29054,5258,3606,524589,27401,20542,47943,95684,42761,52923,235180,1568,6.58,86.3,7.117262712548404,17.96002335005753,37918,98.46610393778823,44.143621623955205,0.48136781783951904
39115,"Morgan County, Ohio",14857,7392,7465,22122,10417,877,336,34,21,14677,899,732,1631,2936,1312,1624,5341,57,4.56,87.4,2.6317560745776403,19.761728478158442,391,98.78844988894124,35.949384128693545,0.49754324560813085
39117,"Morrow County, Ohio",35032,17580,17452,24864,23736,2237,821,134,14,34768,1701,1386,3087,3816,1963,1853,16351,155,4.74,85.6,2.766042475451016,10.892897921899976,969,99.24640328842202,46.6744690568623,0.501826901118977
39119,"Muskingum County, Ohio",85991,41858,44133,22877,58097,5687,2494,430,142,85127,4161,3294,7455,14564,6566,7998,37262,147,4.52,86.7,3.565489411682618,16.93665616169134,3066,98.99524368829296,43.33244176716168,0.4867718714749218
39121,"Noble County, Ohio",14429,8821,5608,23119,10719,585,386,21,21,11845,480,373,853,1409,656,753,3894,0,4.73,87.1,2.966248527271467,9.765056483470788,428,82.09162104095918,26.98731720839975,0.6113382770808787
39123,"Ottawa County, Ohio",40981,20201,20780,31574,30239,4008,1836,404,193,40574,1393,1438,2831,4464,1838,2626,18944,108,4.79,86.5,5.936897586686514,10.892852785437153,2433,99.00685683609477,46.226299992679536,0.4929357507137454
39125,"Paulding County, Ohio",19057,9493,9564,24319,13115,1101,527,56,27,18955,799,713,1512,2083,1010,1073,8743,81,4.33,86.4,3.2009235451540117,10.93036679435378,610,99.46476360392506,45.87815500865823,0.49813716744503334
39127,"Perry County, Ohio",35947,17953,17994,21557,24171,1978,752,109,52,35690,1713,1766,3479,7322,3262,4060,14079,59,4.45,86.4,2.5398503352157342,20.36887640136868,913,99.28505855843325,39.165994380615906,0.4994297159707347
39129,"Pickaway County, Ohio",56804,30071,26733,25460,38985,4337,1983,304,123,52461,2242,1733,3975,6324,2993,3331,24327,137,4.25,87.2,4.242658967678333,11.133018801492852,2410,92.35441166115062,42.8262094218717,0.5293817336807267
39131,"Pike County, Ohio",28298,14069,14229,21983,19226,1333,883,99,45,27938,2089,1147,3236,5735,2714,3021,9818,22,6.01,87.4,3.6292317478267013,20.266449925789807,1027,98.72782528800622,34.69503145098594,0.49717294508445825
39133,"Portage County, Ohio",161796,79194,82602,27985,103493,17432,8208,982,1611,160730,6350,5680,12030,23293,9606,13687,78982,372,5.22,86.6,6.675690375534624,14.396524017899083,10801,99.34114564018888,48.81579272664343,0.48946821923904177
39135,"Preble County, Ohio",41561,20594,20967,25374,28699,2695,937,152,86,41226,1756,1876,3632,5536,2475,3061,19102,172,6.28,85.3,2.827169702365198,13.320179976420201,1175,99.19395587209162,45.961358003897885,0.495512620004331
39137,"Putnam County, Ohio",34116,17025,17091,28568,22548,2711,1501,89,71,33851,632,722,1354,2648,1110,1538,17278,45,4.66,86,4.868683315746277,7.761754015711103,1661,99.22323836323133,50.64485871731739,0.49903271192402393
39139,"Richland County, Ohio",121888,61816,60072,23439,84981,9388,3554,675,316,115234,5876,5637,11513,18849,8280,10569,49371,264,4.23,85.3,3.728833027041218,15.464196639537937,4545,94.54088999737463,40.50521790496193,0.5071541086899448
39141,"Ross County, Ohio",77193,40501,36692,22714,54241,5302,2304,488,207,71506,3649,2739,6388,13419,5743,7676,29459,200,4.69,87.2,3.885067298848341,17.3837005946135,2999,92.63275167437462,38.16278678118482,0.5246719262109258
39143,"Sandusky County, Ohio",59870,29557,30313,25219,41173,4135,1606,245,114,59009,1971,2122,4093,7757,3292,4465,27814,119,4.39,86.9,3.2821112410222146,12.956405545348254,1965,98.56188408217805,46.45732420243862,0.4936863203607817
39145,"Scioto County, Ohio",77366,38260,39106,22586,53122,4815,2471,392,287,74512,4048,3345,7393,17569,8059,9510,27661,142,5.85,87.8,4.071555980663341,22.70894191246801,3150,96.31104102577359,35.753431740040845,0.4945324819688235
39147,"Seneca County, Ohio",55711,27858,27853,25004,37039,3492,1638,181,138,54740,2076,1620,3696,8209,3775,4434,25032,141,4.12,86.4,3.5127712659977384,14.734971549604207,1957,98.25707669939509,44.93188059808655,0.5000448744413132
39149,"Shelby County, Ohio",48949,24679,24270,28410,32301,3277,1884,193,166,48603,1632,1156,2788,4600,1927,2673,23702,142,4.81,85.4,4.582320374267094,9.397536211158553,2243,99.29314184150851,48.42182679932174,0.5041778177286563
39151,"Stark County, Ohio",374762,181928,192834,27401,258785,37497,15989,3105,1976,370006,15015,12284,27299,51534,22655,28879,173773,660,5,87.1,5.622234911757329,13.751127382178556,21070,98.73092789557106,46.36889545898464,0.4854494319061164
39153,"Summit County, Ohio",541372,262454,278918,30803,375132,73796,29612,7179,4630,536315,23593,18888,42481,75894,33204,42690,255806,882,4.79,87.3,7.6511160532868345,14.018826241475363,41421,99.06589184516378,47.25142785367547,0.48479418957759174
39155,"Trumbull County, Ohio",204908,99872,105036,25542,145249,18210,5848,1185,843,201249,11202,9198,20400,35115,15029,20086,86679,272,5.22,85.9,3.8436761863860855,17.13695902551389,7876,98.21432057313525,42.30142307767388,0.4873992230659613
39157,"Tuscarawas County, Ohio",92579,45527,47052,25054,64053,6528,2573,325,169,91621,5493,4618,10111,12379,5626,6753,42142,310,3.94,87,3.3128463258406335,13.371282904330355,3067,98.96520809254798,45.52004234221584,0.4917637909245077
39159,"Union County, Ohio",53955,25813,28142,33066,35863,7181,2353,544,355,50780,1825,1405,3230,3965,1777,2188,25432,44,6.27,85.8,6.027244926327495,7.3487165230284495,3252,94.11546659253081,47.135575942915395,0.47841719951811695
39161,"Van Wert County, Ohio",28501,13966,14535,26130,19492,2019,1110,152,64,28221,1297,1004,2301,3449,1495,1954,13096,202,5.05,85.8,4.652468334444405,12.10132977790253,1326,99.0175783305849,45.949264938072346,0.4900178941089786
39163,"Vinton County, Ohio",13128,6617,6511,19876,9018,557,235,40,30,13053,749,552,1301,2767,1105,1662,5111,12,5.38,86.8,2.323278488726386,21.077087141986592,305,99.42870201096892,38.9320536258379,0.5040371724558196
39165,"Warren County, Ohio",222184,111615,110569,37479,147940,38132,17098,3221,2140,215732,5744,5323,11067,11581,4990,6591,105093,227,6.75,87,10.108288625643612,5.21234652360206,22459,97.09610052929104,47.29998559752278,0.5023539048716379
39167,"Washington County, Ohio",61154,30212,30942,26608,43337,5362,1927,328,361,60468,2941,2279,5220,9275,4258,5017,26256,168,4.64,88.3,4.277725087484057,15.166628511626385,2616,98.87824181574386,42.93423161199595,0.4940314615560716
39169,"Wayne County, Ohio",115747,57359,58388,25762,75672,10057,4503,890,795,114650,7855,7018,14873,14207,6067,8140,53984,601,4.01,85.8,5.346142880593018,12.27418421211781,6188,99.05224325468478,46.639653727526415,0.4955549603877422
39171,"Williams County, Ohio",37270,18437,18833,24160,25769,2418,966,171,104,36106,1471,929,2400,5176,2179,2997,16852,197,4.49,85,3.329755835792863,13.887845452106252,1241,96.8768446471693,45.215991414005906,0.4946874161524014
39173,"Wood County, Ohio",129418,63646,65772,30042,79630,14516,7846,1368,1499,128147,4229,3037,7266,16797,7596,9201,64252,322,5.1,86.3,8.277828431902826,12.978874654221206,10713,99.01791095519943,49.64688065029594,0.4917863048416758
39175,"Wyandot County, Ohio",22359,11090,11269,25431,15415,1582,553,89,31,22096,978,664,1642,2440,1025,1415,10667,109,3.98,86.3,3.0099736124155823,10.9128315219822,673,98.82373988103225,47.707858133190214,0.49599713761796144
40001,"Adair County, Oklahoma",22161,10997,11164,16576,14239,1416,384,39,73,22035,3062,2784,5846,6595,3134,3461,8065,20,6.01,90.9,2.2381661477370156,29.75948738775326,496,99.4314335995668,36.39276205947385,0.4962321194891927
40003,"Alfalfa County, Oklahoma",5784,3473,2311,28007,4286,650,213,10,23,4751,329,259,588,589,305,284,2177,27,6.09,96.2,4.253112033195021,10.18326417704011,246,82.14038727524205,37.638312586445366,0.6004495159059474
40005,"Atoka County, Oklahoma",13847,7266,6581,19439,9575,979,384,28,18,12268,1151,1386,2537,2690,1083,1607,4403,29,7.03,95.3,3.1053657832021377,19.42659059724128,430,88.59680797284611,31.797501263811657,0.5247345995522495
40007,"Beaver County, Oklahoma",5479,2707,2772,25935,3636,613,126,17,27,5398,321,440,761,547,242,305,2550,26,4.08,95,3.102755977368133,9.983573644825698,170,98.52162803431283,46.54133966052199,0.4940682606315021
40009,"Beckham County, Oklahoma",23290,12339,10951,23883,15315,1835,617,283,67,21719,1658,1595,3253,3030,1157,1873,9375,36,4.95,97.2,4.1519965650493775,13.00987548303993,967,93.2546157148991,40.25332760841563,0.5297981966509231
40011,"Blaine County, Oklahoma",9777,5358,4419,22823,6965,864,265,32,21,8118,461,500,961,1144,478,666,3376,21,5.26,95.7,3.2525314513654497,11.700930755855579,318,83.0316047867444,34.53001943336402,0.548020865296103
40013,"Bryan County, Oklahoma",44529,21641,22888,22171,29488,4200,1840,238,232,44080,3827,3885,7712,7551,3461,4090,17904,261,7.43,96.3,5.187630532911137,16.95748837836017,2310,98.9916683509623,40.207505221316445,0.48599788901614677
40015,"Caddo County, Oklahoma",29510,15389,14121,21071,19473,2269,767,38,56,28457,3319,3184,6503,5883,2940,2943,11215,133,6.89,95.6,2.917655032192477,19.935615045747205,861,96.431718061674,38.00406641816333,0.5214842426296171
40017,"Canadian County, Oklahoma",129571,64268,65303,29852,85210,16196,4486,756,529,127742,6870,6010,12880,10237,4674,5563,63929,693,6.22,95.2,4.453928734053145,7.900687653873166,5771,98.58841870480278,49.33897245525619,0.49600605073666176
40019,"Carter County, Oklahoma",48530,23448,25082,24965,32200,4056,1601,387,225,47870,3574,3394,6968,7395,3185,4210,20500,122,9.22,95.4,4.560065938594684,15.237997115186483,2213,98.64001648464867,42.241912219245826,0.4831650525448176
40021,"Cherokee County, Oklahoma",48267,23872,24395,19799,29926,4409,2087,301,415,47758,5609,5731,11340,10380,4829,5551,19135,91,6.94,92.6,5.807280336461765,21.50537634408602,2803,98.94544927175917,39.64406323160752,0.49458221973605154
40023,"Choctaw County, Oklahoma",15051,7277,7774,19446,10267,941,308,55,26,14878,2060,1817,3877,4230,1880,2350,5004,61,8.52,96.6,2.584545877350342,28.104444887382897,389,98.85057471264368,33.24696033486147,0.48348946913826324
40025,"Cimarron County, Oklahoma",2269,1128,1141,28461,1598,251,49,1,15,2243,190,172,362,351,126,225,1056,24,4.74,95.8,2.864698104892023,15.469369766416923,65,98.8541207580432,46.540326134861175,0.49713530189510796
40027,"Cleveland County, Oklahoma",271818,135801,136017,29231,170573,33573,14242,2893,3483,266197,15077,13053,28130,32583,14974,17609,134672,1063,7.54,94.1,7.585222465031749,11.987064874290885,20618,97.93207219536602,49.54491608355591,0.49960267531951524
40029,"Coal County, Oklahoma",5755,2816,2939,24004,3880,401,194,28,35,5687,753,652,1405,1112,507,605,2182,11,7.04,94.9,4.465682015638575,19.322328410078192,257,98.81841876629018,37.91485664639444,0.4893136403127715
40031,"Comanche County, Oklahoma",124583,64689,59894,25186,77549,10404,4186,772,667,111780,8463,8331,16794,19294,8464,10830,56886,724,7.79,95.9,4.515062247658188,15.486864178900813,5625,89.72331698546351,45.6611255147171,0.5192441986466854
40033,"Cotton County, Oklahoma",6062,2988,3074,21887,4163,491,157,14,20,5933,508,515,1023,956,410,546,2498,17,7.25,97.4,3.1507753216760146,15.770372814252722,191,97.87198944242824,41.20752226987793,0.4929066314747608
40035,"Craig County, Oklahoma",14683,7494,7189,20666,10264,1027,317,77,50,13934,1250,1219,2469,2458,1084,1374,5664,119,6.11,92.5,3.0239051964857318,16.74044813730164,444,94.89886263025268,38.57522304706123,0.510386160866308
40037,"Creek County, Oklahoma",70931,35091,35840,24056,47999,5287,1609,372,222,70129,5329,4927,10256,10491,4591,5900,29743,103,5.49,92.2,3.105835248339936,14.790430136329672,2203,98.86932370895659,41.93230040461857,0.49472022105990326
40039,"Custer County, Oklahoma",29248,14597,14651,24621,17003,3211,1259,83,166,28805,2480,2114,4594,4459,2031,2428,14053,23,4.97,96.3,5.155908096280087,15.245486870897155,1508,98.48536652078775,48.047729759299784,0.4990768599562363
40041,"Delaware County, Oklahoma",41433,20505,20928,22175,29661,3317,1131,234,278,41050,3872,3756,7628,8086,3661,4425,15359,214,6.65,92.1,3.9654381772982887,19.515844857963458,1643,99.07561605483552,37.06948567566915,0.494895373253204
40043,"Dewey County, Oklahoma",4862,2461,2401,25821,3219,547,139,5,18,4759,390,296,686,855,398,457,2055,4,4.51,94.8,3.331962155491567,17.585355820649937,162,97.88153023447141,42.266556972439325,0.5061703002879473
40045,"Ellis County, Oklahoma",4123,2002,2121,27272,2849,466,125,16,16,4088,259,203,462,627,288,339,1781,10,3.87,95,3.8079068639340288,15.2073732718894,157,99.15110356536502,43.196701430996846,0.4855687606112054
40047,"Garfield County, Oklahoma",62481,30941,31540,25787,40732,5667,2240,578,214,60353,4267,3723,7990,7980,3623,4357,28368,225,4.99,94.6,4.852675213264832,12.771882652326306,3032,96.59416462604632,45.402602391126905,0.49520654278900783
40049,"Garvin County, Oklahoma",27570,13672,13898,22433,18421,1946,683,127,75,27337,2220,2200,4420,5070,2317,2753,10605,79,8.53,94.9,3.2100108813928183,18.389553862894452,885,99.15487849111354,38.46572361262242,0.4959013420384476
40051,"Grady County, Oklahoma",53955,26854,27101,27334,36156,4727,1270,236,198,53388,3883,3538,7421,6759,2914,3845,24096,220,7,95.5,3.1581873783708647,12.527105921601335,1704,98.94912427022518,44.65943842090631,0.4977110555092206
40053,"Grant County, Oklahoma",4497,2276,2221,29002,3155,605,129,16,16,4422,181,187,368,401,171,230,2062,5,4.33,95,3.5801645541472094,8.91705581498777,161,98.33222148098733,45.85279074938848,0.5061151879030464
40055,"Greer County, Oklahoma",6081,3546,2535,20073,4311,450,138,29,4,5035,398,426,824,957,432,525,2180,21,5.34,97.3,2.8120374938332513,15.73754316724223,171,82.79888176286795,35.84936688044729,0.5831277750370005
40057,"Harmon County, Oklahoma",2813,1395,1418,21620,1917,273,136,4,0,2709,279,135,414,433,163,270,1146,0,5.22,98,4.976892996800569,15.39281905439033,140,96.30287948809101,40.7394241023818,0.49591183789548526
40059,"Harper County, Oklahoma",3785,1869,1916,23536,2516,380,175,11,41,3774,301,258,559,522,234,288,1699,17,4.76,95.2,5.997357992073976,13.791281373844122,227,99.70937912813739,44.88771466314399,0.49379128137384415
40061,"Haskell County, Oklahoma",12835,6388,6447,20009,8735,776,256,4,17,12770,1414,1368,2782,2574,1164,1410,4455,41,7.33,94,2.1581612777561356,20.054538371640046,277,99.49357226334243,34.709777950915466,0.49770159719516943
40063,"Hughes County, Oklahoma",13727,7368,6359,18004,9639,712,260,28,48,12038,1215,1248,2463,2373,1094,1279,4193,38,7.76,93.1,2.4477307496175422,17.28709841917389,336,87.69578203540468,30.545639979602242,0.5367523858089895
40065,"Jackson County, Oklahoma",25864,12867,12997,22988,16474,2092,1077,109,118,24326,1641,1894,3535,4206,1668,2538,11641,85,5.75,97.7,5.041756882152799,16.261985771729044,1304,94.05351067120321,45.00850603154964,0.4974868543148778
40067,"Jefferson County, Oklahoma",6280,3166,3114,19130,4282,415,117,30,8,6132,667,610,1277,1195,519,676,2318,5,9.81,96.3,2.468152866242038,19.028662420382165,155,97.64331210191082,36.910828025477706,0.5041401273885351
40069,"Johnston County, Oklahoma",11027,5422,5605,21022,7468,707,402,39,33,10905,1046,1226,2272,2272,899,1373,3828,20,6.99,95,4.2985399474018315,20.603972068558992,474,98.89362473927632,34.71479096762492,0.4917021855445724
40071,"Kay County, Oklahoma",45398,22517,22881,24057,29914,4196,1191,260,178,44735,3827,3298,7125,7919,3436,4483,19218,218,6.02,93.5,3.5882638001674083,17.443499713643774,1629,98.53958324155249,42.33226133309837,0.495991012819948
40073,"Kingfisher County, Oklahoma",15392,7692,7700,31885,10026,1501,515,81,111,15232,801,1137,1938,1279,634,645,7272,56,5.31,95.8,4.593295218295219,8.309511434511435,707,98.96049896049897,47.24532224532224,0.49974012474012475
40075,"Kiowa County, Oklahoma",9239,4611,4628,23076,6414,792,281,46,8,9045,691,850,1541,1938,842,1096,3938,32,6.74,96.2,3.6259335425911896,20.97629613594545,335,97.90020564996212,42.623660569325686,0.49907998701158135
40077,"Latimer County, Oklahoma",10643,5393,5250,24233,7103,700,334,26,67,10449,1117,1026,2143,1957,796,1161,3827,36,7.68,93.4,4.012026684205581,18.38767264868928,427,98.17720567509161,35.95790660528046,0.5067180306304614
40079,"Le Flore County, Oklahoma",49885,25002,24883,20264,33529,3119,1466,135,151,48741,5512,4832,10344,11061,4989,6072,18284,217,7.51,93.3,3.51207777889145,22.172997895158865,1752,97.70672546857773,36.652300290668535,0.501192743309612
40081,"Lincoln County, Oklahoma",34640,17194,17446,23911,23440,2397,739,127,96,34262,2577,2571,5148,5125,2297,2828,14281,170,6.47,93.5,2.777136258660508,14.795034642032332,962,98.90877598152424,41.22690531177829,0.4963625866050808
40083,"Logan County, Oklahoma",45171,22366,22805,28265,30101,5474,1836,391,291,44809,3237,2854,6091,5382,2407,2975,20570,170,7.25,94.9,5.574372938389675,11.914724048615263,2518,99.19860087224104,45.53806645856855,0.49514068760930685
40085,"Love County, Oklahoma",9768,4830,4938,20965,6456,616,226,16,10,9681,729,563,1292,1219,604,615,4051,59,7.23,95.7,2.57985257985258,12.47952497952498,252,99.10933660933661,41.472153972153976,0.49447174447174447
40087,"McClain County, Oklahoma",37222,18563,18659,28353,24583,4073,1113,281,174,36937,2504,2393,4897,3530,1703,1827,16736,84,7.89,94.7,4.212562463059481,9.483638708290796,1568,99.23432378700768,44.962656493471606,0.49871044006232873
40089,"McCurtain County, Oklahoma",33071,16264,16807,19040,21731,2119,687,126,58,32662,3463,3603,7066,7705,3460,4245,12133,119,12.15,94.6,2.6337274349127635,23.298358078074447,871,98.76326691058631,36.687732454416256,0.49179039037222944
40091,"McIntosh County, Oklahoma",20161,9950,10211,22241,14666,1352,542,57,67,19858,1768,1722,3490,3757,1732,2025,6888,51,7.29,94,3.3034075690689946,18.634988343832152,666,98.49709835821636,34.16497197559645,0.4935271067903378
40093,"Major County, Oklahoma",7721,3861,3860,28294,5210,656,199,19,5,7642,461,484,945,1031,423,608,3371,91,5.15,95.8,2.8882269136122263,13.353192591633208,223,98.97681647454993,43.66014764926823,0.5000647584509779
40095,"Marshall County, Oklahoma",16079,8021,8058,22431,10999,991,381,104,18,15821,1323,1376,2699,2613,1141,1472,6142,85,6.35,95.4,3.1283039990049133,16.25101063498974,503,98.39542260090802,38.19889296598047,0.49884943093475964
40097,"Mayes County, Oklahoma",40923,20382,20541,22575,27504,2949,1079,114,71,40484,3743,3243,6986,8454,3826,4628,16629,98,6.27,94.1,3.088727610390245,20.65830950810058,1264,98.92725362265719,40.63485081738875,0.498057327175427
40099,"Murray County, Oklahoma",13792,6801,6991,24804,9514,1307,491,52,69,13379,1111,1227,2338,1925,732,1193,6093,9,7.96,94.4,4.437354988399072,13.957366589327146,612,97.00551044083527,44.17778422273782,0.4931119489559165
40101,"Muskogee County, Oklahoma",69939,34194,35745,21800,46411,6362,1930,372,232,67049,6613,6628,13241,14085,6040,8045,26715,322,7.53,94.1,3.623157322809877,20.13897825247716,2534,95.86782767840546,38.19757217003389,0.488911765967486
40103,"Noble County, Oklahoma",11470,5662,5808,28054,7834,1292,363,87,39,11373,665,492,1157,1449,675,774,5175,27,6.01,93.7,4.263295553618134,12.632955536181342,489,99.1543156059285,45.11769834350479,0.4936355710549259
40105,"Nowata County, Oklahoma",10510,5179,5331,21491,7228,663,188,29,28,10309,915,907,1822,1941,864,1077,4182,15,7.3,92,2.331113225499524,18.46812559467174,245,98.08753568030447,39.790675547098004,0.49276879162702186
40107,"Okfuskee County, Oklahoma",12212,6542,5670,17656,8270,662,283,33,25,11330,1227,1222,2449,2957,1477,1480,3844,100,6.98,92.3,2.792335407795611,24.21388797903701,341,92.77759580740255,31.477235506059614,0.5357025876187357
40109,"Oklahoma County, Oklahoma",764698,374134,390564,29127,495713,98585,37315,11157,5647,751872,65182,58839,124021,132442,57485,74957,357338,2269,6.89,94.6,7.07717294932117,17.319516985790468,54119,98.32273655743836,46.72929705583119,0.48925719695879943
40111,"Okmulgee County, Oklahoma",39322,19447,19875,21436,25923,2861,955,147,69,38674,3484,3177,6661,7656,3259,4397,14622,116,6.71,92.9,2.977976705152332,19.47001678449723,1171,98.35206754488581,37.185290676974724,0.49455775392909823
40113,"Osage County, Oklahoma",47923,24031,23892,24195,33387,3902,1443,149,140,46530,3201,3215,6416,6948,2871,4077,19073,166,5.94,92.3,3.6141310018154122,14.498257621601319,1732,97.093253761242,39.799261315026186,0.5014502430983035
40115,"Ottawa County, Oklahoma",32022,15720,16302,19415,20815,1891,719,187,95,31578,2898,2721,5619,6957,3298,3659,12653,99,6.86,92,3.1259758915745426,21.725688589094997,1001,98.61345325089002,39.51345949659609,0.4909124976578602
40117,"Pawnee County, Oklahoma",16444,8212,8232,22965,11225,1287,410,96,58,16289,1363,1284,2647,2360,1075,1285,6537,63,8.7,93,3.4298224276331792,14.351739236195574,564,99.05740695694479,39.753101435173924,0.4993918754560934
40119,"Payne County, Oklahoma",79953,40872,39081,22785,42694,8643,4329,843,2012,78862,5431,4579,10010,18943,9317,9626,35327,268,5.89,93.3,8.985278851325154,23.692669443297937,7184,98.63544832589146,44.1847085162533,0.5112003301939889
40121,"Pittsburg County, Oklahoma",44643,22693,21950,24408,31143,3265,1387,227,150,42781,4014,3660,7674,7450,3420,4030,17959,93,7.56,94,3.951347355688462,16.687946598570885,1764,95.82913334677329,40.22803127029994,0.5083215733709652
40123,"Pontotoc County, Oklahoma",38213,18664,19549,23862,24576,4166,1967,222,275,37782,3684,3169,6853,6661,3110,3551,17218,128,7.68,93.6,6.448067411613849,17.43124067725643,2464,98.87211158506267,45.057964567032165,0.4884201711459451
40125,"Pottawatomie County, Oklahoma",71551,34082,37469,22284,46853,5769,1869,381,290,69230,5691,5427,11118,12334,5691,6643,28805,735,7.18,93.2,3.5499154449273944,17.238053975486018,2540,96.75615994185965,40.25799779178488,0.47633156769297424
40127,"Pushmataha County, Oklahoma",11149,5462,5687,22596,7896,716,354,46,23,11019,1159,1045,2204,2414,1081,1333,4065,18,7.81,94,3.794062247735223,21.652166113552784,423,98.83397614135797,36.460669118306576,0.4899094089155978
40129,"Roger Mills County, Oklahoma",3732,1823,1909,27797,2491,373,137,12,5,3709,178,245,423,473,196,277,1715,3,4.55,96.4,4.126473740621651,12.67416934619507,154,99.38370846730976,45.953912111468384,0.4884780278670954
40131,"Rogers County, Oklahoma",89970,44799,45171,29824,59768,9954,2936,550,418,88947,5550,5201,10751,8297,3364,4933,42326,452,6.82,93.8,4.339224185839725,9.221962876514393,3904,98.86295431810603,47.044570412359676,0.49793264421473826
40133,"Seminole County, Oklahoma",25403,12396,13007,19605,16627,1534,664,86,25,24951,2667,2647,5314,5615,2387,3228,9208,95,7.73,93,3.050820769200488,22.103688540723535,775,98.22068259654371,36.2476872810298,0.48797386135495807
40135,"Sequoyah County, Oklahoma",41344,20456,20888,19253,28049,2789,794,226,145,40963,4721,4375,9096,10157,4977,5180,15372,196,6.89,93.3,2.8178212074303404,24.567047213622292,1165,99.07846362229103,37.18072755417957,0.49477554179566563
40137,"Stephens County, Oklahoma",44631,21698,22933,25177,30468,4077,944,268,200,44042,3300,3330,6630,6798,2969,3829,18402,265,8,95.8,3.163720284107459,15.231565503797809,1412,98.68028948488718,41.23143106809169,0.48616432524478503
40139,"Texas County, Oklahoma",21499,11359,10140,23324,13083,2031,339,164,97,21373,1910,1576,3486,2814,1145,1669,11128,106,3.88,95.7,2.790827480347923,13.088980882831759,600,99.41392622912694,51.76054700218615,0.528350155821201
40141,"Tillman County, Oklahoma",7611,3902,3709,21422,5137,614,154,36,24,7247,642,563,1205,1581,729,852,3085,17,7.92,97.5,2.811719879122323,20.772566022861646,214,95.21744842990408,40.533438444356854,0.5126790172119301
40143,"Tulsa County, Oklahoma",629823,307129,322694,29797,410633,85476,28069,8311,4137,624912,51589,46415,98004,98682,43059,55623,300004,3331,6.42,93.4,6.433077229634358,15.668211545148399,40517,99.22025711985748,47.633065162752075,0.48764335376764584
40145,"Wagoner County, Oklahoma",76190,37685,38505,27337,50989,8032,2351,387,333,75899,5247,4782,10029,8206,3565,4641,34773,361,7.07,93.9,4.030712691954324,10.77044231526447,3071,99.61806011287571,45.63984774904843,0.4946187163669773
40147,"Washington County, Oklahoma",51892,25164,26728,28913,35459,6416,2157,214,534,51498,3900,3878,7778,7325,3134,4191,22791,138,6.46,92.3,5.598165420488708,14.115856008633315,2905,99.2407307484776,43.920064749865105,0.4849302397286672
40149,"Washita County, Oklahoma",11626,5797,5829,26409,7735,1212,346,48,53,11387,649,600,1249,1803,658,1145,4849,6,6.16,96.4,3.8448305522105626,15.508343368312403,447,97.94426285910889,41.70824015138483,0.498623774298985
40151,"Woods County, Oklahoma",9125,4922,4203,28322,5713,895,354,83,194,8489,616,404,1020,1059,518,541,4407,23,4.79,95.7,6.9150684931506845,11.605479452054794,631,93.03013698630137,48.295890410958904,0.5393972602739726
40153,"Woodward County, Oklahoma",21111,11153,9958,27413,13824,1956,776,109,44,20115,877,991,1868,2568,1045,1523,9396,103,3.76,94.6,4.4005494765761926,12.164274548813415,929,95.28208043200227,44.507602671593006,0.5283027805409503
41001,"Baker County, Oregon",16030,8127,7903,25820,11808,1774,677,138,126,15520,796,847,1643,2339,1066,1273,6143,69,3.66,83.1,5.87024329382408,14.591391141609483,941,96.81846537741734,38.32189644416719,0.5069868995633188
41003,"Benton County, Oregon",87455,44079,43376,30873,52728,15360,8149,1690,3113,87187,3650,3125,6775,17665,9323,8342,39765,217,17.72,85.4,14.809902235435366,20.198959464867645,12952,99.6935566862958,45.4690983934595,0.5040192098793665
41005,"Clackamas County, Oregon",394967,194409,200558,37551,275392,60596,23059,6727,3427,393403,16965,14809,31774,36160,16149,20011,188117,1187,16.69,78.3,8.409056959188996,9.15519524415964,33213,99.60401755083336,47.62853605491092,0.4922158053710816
41007,"Clatsop County, Oregon",37660,18744,18916,28115,27112,3990,1889,363,288,36914,2291,1843,4134,5187,2341,2846,16796,189,20.16,74.5,6.744556558682953,13.773234200743495,2540,98.01911842804036,44.599044078597984,0.49771640998406796
41009,"Columbia County, Oregon",49645,24908,24737,28460,35024,4634,1755,220,110,49355,2525,2234,4759,6598,3074,3524,20051,93,13.55,80.6,4.199818712861315,13.290361567126599,2085,99.41585255312721,40.38876019740155,0.5017222278175043
41011,"Coos County, Oregon",62944,30893,32051,26007,46614,5112,2435,611,398,62096,4059,3679,7738,11213,5196,6017,23131,186,17.38,76.9,5.47153024911032,17.81424758515506,3444,98.65277071682766,36.74853838332486,0.49080134722928315
41013,"Crook County, Oregon",21334,10471,10863,24239,15879,1647,614,231,69,21255,1148,1080,2228,3757,1785,1972,8009,88,2.68,83.2,4.284241117465079,17.610387175400767,914,99.629699071904,37.541014343301775,0.4908127871004031
41015,"Curry County, Oregon",22364,10915,11449,26925,17756,2596,1075,323,192,22224,1217,1006,2223,3382,1424,1958,7472,97,25.72,80.6,7.1096404936505095,15.122518333035234,1590,99.37399391879806,33.41083884814881,0.48806116973707747
41017,"Deschutes County, Oregon",170813,84267,86546,31575,122101,25564,10807,2854,1450,170198,11706,10532,22238,23622,11161,12461,76910,626,5.04,80.8,8.846516365850375,13.82915820224456,15111,99.63995714611886,45.025846978859924,0.4933289620813404
41019,"Douglas County, Oregon",107375,53026,54349,25002,78692,7867,3796,739,445,106713,5505,4826,10331,19701,8785,10916,38652,420,14.1,84,4.6379511059371366,18.347846332945284,4980,99.38346915017462,35.99720605355064,0.4938393480791618
41021,"Gilliam County, Oregon",1913,969,944,24178,1337,168,57,3,0,1905,169,114,283,213,124,89,701,11,2.29,86.8,3.1364349189754313,11.134343962362781,60,99.58180867746994,36.64401463669629,0.5065342394145321
41023,"Grant County, Oregon",7227,3608,3619,25154,5491,658,422,83,30,7095,422,325,747,1059,503,556,2928,7,3.41,81.2,7.402795074027951,14.653383146533832,535,98.17351598173516,40.51473640514737,0.4992389649923896
41025,"Harney County, Oregon",7214,3645,3569,24398,5155,554,281,12,46,7110,283,351,634,1166,507,659,2816,41,2.33,84.9,4.6991960077626835,16.16301635708345,339,98.55835874688107,39.035209315220406,0.5052675353479346
41027,"Hood River County, Oregon",22842,11495,11347,29595,15336,2945,1123,326,222,22758,1648,1325,2973,3006,1369,1637,10788,179,12.02,76.2,7.315471499868663,13.159968479117415,1671,99.63225636984502,47.228789072760705,0.503239646265651
41029,"Jackson County, Oregon",210916,102814,108102,27081,149411,24040,10133,2930,1835,209779,12694,11488,24182,37595,17334,20261,87916,764,10.03,86.9,7.063475506836845,17.824631606895636,14898,99.46092283183826,41.6829448690474,0.48746420375884236
41031,"Jefferson County, Oregon",22305,11467,10838,22957,15059,1707,537,97,86,21582,1930,1521,3451,4355,2144,2211,7842,129,3.89,84.3,3.2279757901815738,19.524770230889935,720,96.75857431069267,35.15803631472764,0.5140999775835015
41033,"Josephine County, Oregon",84063,41141,42922,24349,61626,6499,3181,696,267,83403,5106,3954,9060,16177,8077,8100,28755,417,16.59,86.4,4.929636106253643,19.24390040802731,4144,99.21487455836694,34.206487991149494,0.48940675445796605
41035,"Klamath County, Oregon",65946,33005,32941,23793,45833,5293,2344,568,459,65412,3945,3667,7612,12117,5312,6805,25303,274,5.91,82.7,5.111758105116308,18.374124283504685,3371,99.19024656537167,38.36927182846571,0.5004852455038972
41037,"Lake County, Oregon",7799,4196,3603,21005,5837,721,205,70,15,7286,407,386,793,1280,616,664,2862,28,2.62,83.9,3.7184254391588665,16.412360559046032,290,93.42223361969484,36.697012437491985,0.5380176945762277
41039,"Lane County, Oregon",360273,177392,182881,27032,244078,42348,18797,4481,4376,358711,21496,16317,37813,69588,33565,36023,158322,1192,16.15,81.4,7.675845816922167,19.31535252433571,27654,99.56643989419135,43.945008368653774,0.4923821657465311
41041,"Lincoln County, Oregon",46685,22631,24054,25782,35587,4842,2290,636,433,46366,3287,3300,6587,8576,3954,4622,18671,140,25.68,76.8,7.195030523722823,18.369926100460532,3359,99.31669701188818,39.99357395308986,0.48475955874477883
41043,"Linn County, Oregon",119862,59243,60619,24448,82255,10218,3428,758,508,119186,6252,5192,11444,20561,9375,11186,48485,465,17.71,81,3.9161702624685053,17.153893644357677,4694,99.43601808746726,40.450684954364185,0.49426006574227027
41045,"Malheur County, Oregon",30474,16638,13836,17567,19837,1859,573,107,94,27105,2055,1885,3940,6651,2862,3789,10483,72,2.44,87.2,2.539870053160071,21.825162433549913,774,88.94467414845442,34.39981623679202,0.5459736168537114
41047,"Marion County, Oregon",326527,162353,164174,24791,212044,31364,11411,3040,1710,320437,21670,16399,38069,54411,24426,29985,138582,841,17.09,80.9,4.949361002306088,16.663553090556064,16161,98.13491686751784,42.441207005852505,0.49721156290291463
41049,"Morrow County, Oregon",11207,5711,5496,21743,7030,527,159,0,14,11198,748,695,1443,1694,784,910,4731,47,2.51,84.8,1.5436780583563845,15.115552779512804,173,99.91969304898724,42.21468724904078,0.5095922191487463
41051,"Multnomah County, Oregon",778193,385176,393017,34848,557727,144518,63821,19111,10591,772975,45535,34681,80216,130564,61392,69172,396494,3127,14.22,81.2,12.017969835246527,16.777843028657415,93523,99.32947225174217,50.95059965843949,0.49496204669021693
41053,"Polk County, Oregon",78470,38065,40405,25928,50046,8998,4474,835,583,78109,3590,3086,6676,11916,5490,6426,32916,214,17.66,83.5,7.508602013508347,15.185421180068817,5892,99.53995157384988,41.94724098381547,0.4850898432521983
41055,"Sherman County, Oregon",1705,856,849,34226,1308,162,52,4,4,1705,165,130,295,301,130,171,730,1,2.79,87.6,3.5190615835777126,17.653958944281523,60,100,42.81524926686217,0.5020527859237537
41057,"Tillamook County, Oregon",25552,12929,12623,25458,18934,2451,1087,223,189,24883,1421,1277,2698,3821,1751,2070,9715,127,25.65,73.8,5.8664683782091425,14.953819661866,1499,97.38180964308077,38.02050720100188,0.5059877896055104
41059,"Umatilla County, Oregon",76582,39827,36755,22153,49500,4745,2303,355,302,72041,5030,4373,9403,12918,5349,7569,31015,225,3.73,83.8,3.8651380219895013,16.868193570290668,2960,94.07040818991408,40.49907288919067,0.520056932438432
41061,"Union County, Oregon",25758,12706,13052,26586,17088,2649,838,290,197,25492,1490,1292,2782,4655,1954,2701,10940,73,4.79,79.6,5.1440329218107,18.072055283795326,1325,98.96731112664027,42.47224163366721,0.49328364003416414
41063,"Wallowa County, Oregon",6836,3337,3499,26898,5316,759,374,127,77,6738,377,230,607,980,440,540,2803,27,4.52,79.5,8.455236980690461,14.335868929198362,578,98.56641310708017,41.00351082504388,0.4881509654768871
41065,"Wasco County, Oregon",25657,12789,12868,24727,17800,2067,904,213,118,25232,1436,1287,2723,3651,1708,1943,10932,45,4.14,84,4.813501188759403,14.230034688389134,1235,98.34353197957672,42.60825505709943,0.49846045913395953
41067,"Washington County, Oregon",564088,278000,286088,35369,380395,98869,41198,7927,8728,560582,29284,24116,53400,61817,28334,33483,277778,1649,14.02,80.6,10.256023882798429,10.958751116847017,57853,99.3784657712981,49.24373502006779,0.4928309058161138
41069,"Wheeler County, Oregon",1369,657,712,21268,1144,137,29,12,16,1363,33,75,108,272,124,148,507,9,2.82,82.5,4.163623082542001,19.868517165814463,57,99.56172388604821,37.034331628926225,0.4799123447772096
41071,"Yamhill County, Oregon",102217,51023,51194,28540,67506,10739,4158,883,760,100045,5126,3862,8988,15255,6572,8683,44068,183,15.47,82.1,5.675181232084682,14.924131993699678,5801,97.8751088370819,43.1122024712132,0.4991635442245419
42001,"Adams County, Pennsylvania",101759,50232,51527,29685,70701,9033,4932,776,719,100483,3994,3453,7447,9117,4024,5093,49601,172,5.36,87.8,6.315903261627964,8.959404082194204,6427,98.74605685983549,48.74360007468627,0.49363692646350693
42003,"Allegheny County, Pennsylvania",1230360,593029,637331,35280,880163,201893,97630,25183,19170,1216195,42534,30836,73370,152390,65373,87017,606306,4692,5.03,85.7,11.539955785298611,12.38580578042199,141983,98.84871094638967,49.2787476836048,0.4819963262784876
42005,"Armstrong County, Pennsylvania",67512,33505,34007,25502,49477,5301,1862,290,218,66985,2505,2296,4801,8786,4056,4730,29148,272,6.25,85.8,3.5104870245289725,13.013982699371963,2370,99.2193980329423,43.17454674724493,0.49628214243393765
42007,"Beaver County, Pennsylvania",169205,82025,87180,29162,122503,19734,6945,1406,586,167807,5594,4470,10064,18036,7984,10052,80272,505,4.6,85.7,5.281758813273839,10.659259478147808,8937,99.17378328063592,47.44067846694838,0.48476699861115213
42009,"Bedford County, Pennsylvania",48852,24409,24443,24219,35306,2941,1371,360,187,48334,2379,2130,4509,6846,3158,3688,21648,218,4.33,86.2,3.9261442724965203,14.013755833947434,1918,98.93965446655203,44.31343650208794,0.49965201015311556
42011,"Berks County, Pennsylvania",414097,203542,210555,29041,278049,42415,18196,3109,1950,409330,19381,15613,34994,57329,26003,31326,194981,1857,4.85,88.4,5.615833971267602,13.844340818697068,23255,98.84882044545118,47.085827716694396,0.49153217724349607
42013,"Blair County, Pennsylvania",125917,61654,64263,25531,88815,11672,4181,921,575,124443,5130,3849,8979,18196,8111,10085,55739,531,4.33,85.4,4.508525457245646,14.450789011809366,5677,98.82938761247489,44.26646124034086,0.48964000095300875
42015,"Bradford County, Pennsylvania",61808,30540,31268,26937,43610,5187,1895,428,201,61190,3090,2345,5435,7562,3320,4242,26192,165,7.15,84.1,4.083613771680041,12.23466217965312,2524,99.0001294330831,42.37639140564328,0.4941107947191302
42017,"Bucks County, Pennsylvania",626220,307068,319152,41924,442193,102554,49864,9683,7478,620342,18228,14639,32867,36635,14836,21799,316987,1512,6.8,88,10.70310753409345,5.850180447765961,67025,99.06135224042669,50.619111494363004,0.49035163361119094
42019,"Butler County, Pennsylvania",185974,91929,94045,35101,130462,27839,12226,1834,1532,183953,5170,4296,9466,15257,6732,8525,90237,436,5.44,84.9,8.38396765139213,8.203834944669685,15592,98.91328895436996,48.521298676159034,0.4943110327250046
42021,"Cambria County, Pennsylvania",137762,67867,69895,24838,98242,12386,5265,1450,764,133557,4849,3699,8548,20274,8821,11453,56324,489,4.86,83,5.428928151449601,14.716685297832493,7479,96.94763432586635,40.88500457310434,0.4926394796823507
42023,"Cameron County, Pennsylvania",4807,2432,2375,24933,3632,425,85,38,18,4764,170,127,297,602,206,396,2109,10,6.72,83.6,2.933222384023299,12.523403370085292,141,99.10547118785105,43.873517786561266,0.5059288537549407
42025,"Carbon County, Pennsylvania",64330,31944,32386,25680,47165,4692,2251,335,257,63532,2730,2347,5077,7621,3597,4024,28509,112,6.29,83.7,4.419399968910306,11.846727809731075,2843,98.75952121871599,44.3168039794808,0.49656458883879995
42027,"Centre County, Pennsylvania",159178,83558,75620,28545,93781,20908,11917,1557,5377,155342,6020,4189,10209,27170,14238,12932,74235,739,4.58,84.6,11.842716958373645,17.068941687921697,18851,97.59011923758308,46.63646986392592,0.5249343502242773
42029,"Chester County, Pennsylvania",512028,252007,260021,46256,344791,103913,49414,10576,9295,507179,19300,15661,34961,35883,15494,20389,259516,1629,5.08,87.8,13.531486559328787,7.008015186669479,69285,99.05298147757544,50.68394697164999,0.4921742560953698
42031,"Clarion County, Pennsylvania",38939,18983,19956,23595,26119,3349,1551,254,298,38523,1971,1512,3483,6941,3100,3841,16593,160,6.09,84.6,5.400755027093659,17.825316520711883,2103,98.93166234366574,42.61280464315981,0.4875060992834947
42033,"Clearfield County, Pennsylvania",81170,42256,38914,22568,59324,5427,1805,307,303,75771,3565,2885,6450,11196,4983,6213,32965,185,5.69,84.5,2.9752371565849454,13.793273376863374,2415,93.34852778119995,40.61229518294937,0.5205864235555008
42035,"Clinton County, Pennsylvania",39536,19383,20153,22794,25045,2805,1207,181,188,38933,2023,1686,3709,6436,2759,3677,17369,181,6,85.9,3.9862403885066775,16.278834479967625,1576,98.47480777013355,43.93211250505868,0.49026203966005666
42037,"Columbia County, Pennsylvania",66772,32139,34633,24908,43723,5874,2454,469,542,66010,2187,1787,3974,9498,4365,5133,29987,124,4.38,86.2,5.1893009045707785,14.224525250104834,3465,98.85880309111603,44.90954292218295,0.48132450727849996
42039,"Crawford County, Pennsylvania",87027,42542,44485,24716,59938,7481,3552,619,715,85546,5038,4860,9898,12077,5557,6520,37077,324,5.59,83.3,5.614349569673779,13.877302446367219,4886,98.29822928516437,42.60401944224206,0.488836797775403
42041,"Cumberland County, Pennsylvania",243838,120485,123353,34246,169530,35250,16088,3467,2230,237370,8367,6684,15051,19828,8764,11064,120856,474,4.54,88.3,8.934210418392539,8.131628376216996,21785,97.34741918814952,49.56405482328431,0.4941190462520198
42043,"Dauphin County, Pennsylvania",271962,131707,140255,31152,187723,33873,14064,4759,2353,268502,12050,9772,21822,35950,16279,19671,131751,1018,4.9,86.8,7.786381921003669,13.218758503026159,21176,98.72776343753907,48.444635647627244,0.48428456916775137
42045,"Delaware County, Pennsylvania",562316,270171,292145,36747,377935,80492,40374,10388,7764,554885,21247,17765,39012,58737,25197,33540,264512,1601,6.01,88.9,10.408026803434367,10.445550188861779,58526,98.67850105634554,47.03974277808207,0.48046116418526236
42047,"Elk County, Pennsylvania",31111,15541,15570,27163,22764,2777,1011,175,83,30784,877,525,1402,2688,1166,1522,14802,15,6.65,83.2,4.078943139082639,8.64003085725306,1269,98.94892481758863,47.578027064382375,0.4995339269068818
42049,"Erie County, Pennsylvania",279133,137741,141392,26361,187749,33251,12946,2586,1839,273663,10796,8106,18902,44452,19940,24512,126154,633,6.87,82.8,6.223198260327514,15.925024988088115,17371,98.04036068827405,45.19494291251841,0.49346010683079394
42051,"Fayette County, Pennsylvania",134229,66241,67988,24247,97484,9752,3529,619,463,130847,5567,4389,9956,24277,10650,13627,52528,441,5.63,84.5,3.435174217195986,18.086255578153754,4611,97.48042524342728,39.13312324460437,0.4934924643705906
42053,"Forest County, Pennsylvania",7493,5881,1612,14989,6495,330,176,2,31,3048,104,91,195,387,175,212,992,5,6.24,83.6,2.7892699853196317,5.1648204991325235,209,40.67796610169491,13.239023088215667,0.7848658748164954
42055,"Franklin County, Pennsylvania",152707,75038,77669,28985,105687,13103,6254,1056,783,151345,9451,7745,17196,17504,7783,9721,70389,345,4.5,87.8,5.299691566201942,11.462473887902977,8093,99.1080958960624,46.094154164511124,0.4913854636657128
42057,"Fulton County, Pennsylvania",14653,7386,7267,25273,10406,838,485,33,36,14610,669,524,1193,1624,704,920,6606,31,4.49,87.3,3.780795741486385,11.083054664573808,554,99.70654473486658,45.082918173752816,0.5040606019245206
42059,"Greene County, Pennsylvania",37669,19556,18113,25574,26768,2968,1352,113,206,34686,1248,1172,2420,5141,2222,2919,14262,161,5.21,85.4,4.436008388860867,13.647827125753272,1671,92.08102152963976,37.86137141946959,0.5191536807454405
42061,"Huntingdon County, Pennsylvania",45844,24289,21555,22908,32701,3134,1236,167,274,41997,1853,1358,3211,5572,2411,3161,18126,152,4.11,86.6,3.6580577611028704,12.154262280778292,1677,91.6084983858302,39.53843469156269,0.5298185149637903
42063,"Indiana County, Pennsylvania",87491,43929,43562,25014,56145,7408,3377,474,1179,86008,4999,4429,9428,14533,6898,7635,37239,447,6.23,84.8,5.749162771027877,16.610851401858476,5030,98.30496851104685,42.56323507560778,0.5020973585854545
42065,"Jefferson County, Pennsylvania",44575,22136,22439,23895,31541,3100,1198,260,119,44043,2195,2075,4270,6364,2778,3586,19586,156,5.61,84,3.5378575434660684,14.277061132922041,1577,98.80650588895121,43.93942793045429,0.49660123387549077
42067,"Juniata County, Pennsylvania",24811,12361,12450,24068,17397,1447,772,37,60,24560,1722,1593,3315,2926,1310,1616,11059,50,4.37,87.8,3.5024787392688728,11.793156261335698,869,98.98835194067148,44.572971665793396,0.4982064406916287
42069,"Lackawanna County, Pennsylvania",213006,102979,110027,27258,149770,24636,10708,2161,1584,209168,8199,5892,14091,31288,13628,17660,95423,489,5.31,83.4,6.7852548754495174,14.688788109255139,14453,98.19817282142287,44.79826859337296,0.4834558650930021
42071,"Lancaster County, Pennsylvania",533110,260976,272134,29280,354397,59026,23687,4945,3246,526391,33540,31286,64826,55977,25457,30520,257798,1984,4.81,87.3,5.979628969631033,10.500084410346833,31878,98.73965973251299,48.35737465063495,0.4895349927782259
42073,"Lawrence County, Pennsylvania",88528,42843,45685,26918,63036,8357,3269,724,464,87500,3280,2945,6225,12374,5382,6992,38329,263,5.78,86.1,5.03456533526116,13.977498644496656,4457,98.83878546900415,43.295906379902405,0.4839485812398337
42075,"Lebanon County, Pennsylvania",136950,66914,70036,27916,93706,11395,5329,1321,564,135259,7892,6696,14588,14293,6421,7872,64417,240,4.43,87,5.267615918218328,10.436655713764148,7214,98.76524278933917,47.03687477181453,0.48860167944505295
42077,"Lehigh County, Pennsylvania",358792,174829,183963,30988,243937,43341,20083,3911,3182,353896,17634,14032,31666,45552,19855,25697,169221,1058,6.07,88.6,7.574304889741131,12.695935249392406,27176,98.63542107962273,47.1640950745836,0.4872711766148632
42079,"Luzerne County, Pennsylvania",318917,157130,161787,26809,226781,30966,14166,2932,1947,311082,13154,10401,23555,48174,21222,26952,144267,676,5.06,84,5.971773219991409,15.105497668672413,19045,97.54324792971212,45.236534897794726,0.4926987272550538
42081,"Lycoming County, Pennsylvania",116313,57104,59209,26265,80680,10629,4381,1099,531,113144,4394,3605,7999,15932,6866,9066,52939,414,5.5,86.2,5.167951991608849,13.697523062770284,6011,97.27545502222452,45.51425893924153,0.4909511404572146
42083,"McKean County, Pennsylvania",42609,22024,20585,24868,30138,3148,1553,222,199,40498,1570,1351,2921,6705,3050,3655,18136,138,7.88,82,4.632824051256777,15.736112088995283,1974,95.04564763312915,42.56377760567016,0.5168861038747682
42085,"Mercer County, Pennsylvania",114598,56473,58125,25499,79922,10914,4648,875,806,110657,4800,3892,8692,14962,6443,8519,48898,343,5.07,84.5,5.522783992739838,13.056074277037993,6329,96.56102200736487,42.66915652978237,0.49279219532627094
42087,"Mifflin County, Pennsylvania",46585,22871,23714,23568,32676,2723,955,181,84,46007,3275,2999,6274,6676,3009,3667,19693,287,3.98,86.9,2.618868734571214,14.330793173768381,1220,98.75925727165396,42.27326392615649,0.4909520231834281
42089,"Monroe County, Pennsylvania",167126,82532,84594,27439,113238,17027,7661,1118,866,166133,9103,7140,16243,20071,9525,10546,75073,377,5.63,82.8,5.771094862558788,12.009501813003363,9645,99.40583751181744,44.920000478680755,0.4938310017591518
42091,"Montgomery County, Pennsylvania",815876,396386,419490,45048,570837,152162,80971,22479,15292,802051,22625,18316,40941,52250,22853,29397,413212,1741,5.44,89.2,14.55392731248376,6.404159455603548,118742,98.30550230672308,50.64642176016944,0.4858409856399747
42093,"Montour County, Pennsylvania",18404,8836,9568,31818,13364,2095,972,493,248,17791,579,487,1066,1763,677,1086,8367,55,4.54,87.7,9.30775918278635,9.57943925233645,1713,96.6692023473158,45.462942838513364,0.4801130189089328
42095,"Northampton County, Pennsylvania",300520,147510,153010,32608,208317,37060,15338,2996,2672,297641,12124,8800,20924,26379,11811,14568,143423,1879,5.65,87.2,6.9898842007187545,8.777785172367896,21006,99.04199387727938,47.7249434313856,0.4908491947291362
42097,"Northumberland County, Pennsylvania",93590,47287,46303,24278,67943,6490,2859,559,298,89378,4114,3430,7544,12974,6239,6735,40337,293,4.73,87,3.970509669836521,13.86259215728176,3716,95.49951917939951,43.09969013783524,0.5052569718987071
42099,"Perry County, Pennsylvania",45647,22995,22652,28900,32017,3501,1405,233,94,45137,2508,2017,4525,3921,1701,2220,22733,121,4.65,87.3,3.7943347865139003,8.58983065699827,1732,98.88273051898263,49.801739435231234,0.50375709247048
42101,"Philadelphia County, Pennsylvania",1559938,737899,822039,24811,1035252,160379,73892,24010,14505,1545722,104291,80684,184975,392356,175587,216769,639442,5969,6.62,89.6,7.205863309952062,25.152025272799303,112407,99.08868172965849,40.991500944268296,0.4730309794363622
42103,"Pike County, Pennsylvania",56210,28092,28118,31156,40619,6187,3197,588,303,55807,2577,2116,4693,5672,2481,3191,23851,133,5.14,83.2,7.2727272727272725,10.090731186621598,4088,99.28304572140189,42.4319516100338,0.4997687244262587
42105,"Potter County, Pennsylvania",17239,8694,8545,23213,12320,1069,656,108,21,17007,899,790,1689,2395,1071,1324,6864,52,8.22,82.8,4.553628400719299,13.892917222576715,785,98.65421428157086,39.81669470386913,0.5043215963803005
42107,"Schuylkill County, Pennsylvania",145503,74295,71208,25224,106162,10232,4663,894,471,138710,5984,4986,10970,18029,7999,10030,61998,316,5.36,85.3,4.142869906462409,12.39080981148155,6028,95.33136773812224,42.609430733386944,0.5106080287004392
42109,"Snyder County, Pennsylvania",40246,19942,20304,24961,26610,2824,1043,322,249,39933,2838,2686,5524,4230,1797,2433,19076,149,4.77,87.4,4.01033643094966,10.510361278139442,1614,99.22228295979724,47.39849922973712,0.49550265864930676
42111,"Somerset County, Pennsylvania",76201,39529,36672,23877,56543,5746,2189,534,276,71439,3106,2767,5873,8993,3596,5397,32136,267,5.37,81.9,3.935643889187806,11.801682392619519,2999,93.75073817928899,42.172674899279535,0.5187464731433971
42113,"Sullivan County, Pennsylvania",6302,3303,2999,26720,4919,443,234,41,45,6109,384,189,573,731,419,312,2620,12,4.99,81.8,5.077753094255792,11.599492224690575,320,96.93748016502697,41.574103459219295,0.524119327197715
42115,"Susquehanna County, Pennsylvania",41832,21060,20772,27823,30528,3175,1513,186,239,41534,2425,1809,4234,5320,2411,2909,18324,67,5.64,83,4.632816982214573,12.717536813922356,1938,99.28762669726525,43.80378657487091,0.5034423407917383
42117,"Tioga County, Pennsylvania",42031,20843,21188,25353,29331,3672,1800,295,242,41616,2099,1872,3971,5509,2295,3214,18064,125,7.91,83.9,5.560181770597892,13.106992457947705,2337,99.01263353239275,42.97780209845114,0.49589588636958437
42119,"Union County, Pennsylvania",45178,24910,20268,25089,30738,3875,1719,438,774,39503,2591,1815,4406,3991,1574,2417,18052,203,4.56,87.3,6.487670990305015,8.833945725795742,2931,87.43857629819824,39.957501438753376,0.5513745628403205
42121,"Venango County, Pennsylvania",53460,26309,27151,25190,38606,4202,1793,280,99,52708,2360,2007,4367,7535,3408,4127,22585,122,5.86,84.2,4.062850729517396,14.094650205761317,2172,98.59334081556304,42.24653946876169,0.49212495323606437
42123,"Warren County, Pennsylvania",40649,20363,20286,26558,29618,3652,1383,262,161,39928,1709,1317,3026,5042,2283,2759,17899,225,7.08,82.4,4.442913724814878,12.403749169721273,1806,98.22627862924057,44.03306354399862,0.5009471327707938
42125,"Washington County, Pennsylvania",208269,101979,106290,32828,148646,27553,10884,2068,1320,206621,6822,5058,11880,20471,8937,11534,97094,442,4.7,85.3,6.852676106381651,9.829115230783266,14272,99.20871565139315,46.61951610657371,0.489650404044769
42127,"Wayne County, Pennsylvania",51307,27266,24041,25569,38551,4652,2581,364,311,47723,2141,1534,3675,6034,2621,3413,20447,94,5.38,82.6,6.346112616212213,11.760578478570176,3256,93.01459839787942,39.85226187459801,0.5314284600541836
42129,"Westmoreland County, Pennsylvania",359377,175500,183877,31827,263051,45089,19457,3487,2743,355475,10306,8507,18813,36398,15855,20543,169974,720,5.79,84.7,7.147647178311355,10.128082765452437,25687,98.91423212949076,47.29684982622705,0.4883451083402666
42131,"Wyoming County, Pennsylvania",27975,14051,13924,28046,19704,2361,1044,164,96,27729,1079,990,2069,2817,1099,1718,12807,52,4.4,84.5,4.66130473637176,10.06970509383378,1304,99.12064343163539,45.78016085790885,0.5022698838248436
42133,"York County, Pennsylvania",440604,217812,222792,30178,304525,45907,18421,4014,2050,435734,17801,13686,31487,45113,19463,25650,214133,1294,4.99,87,5.557144283755935,10.238899329102777,24485,98.89469909487885,48.59987653312271,0.4943486668300787
44001,"Bristol County, Rhode Island",49228,23746,25482,42360,34149,8376,4881,1657,934,48557,1330,1258,2588,3246,1450,1796,24206,62,5.66,84.8,15.17835378240026,6.593808401722597,7472,98.63695457869505,49.171203380190136,0.482367758186398
44003,"Kent County, Rhode Island",164886,79561,85325,37157,120588,24015,10787,2116,1464,163514,5387,3891,9278,13400,5609,7791,84324,264,5.99,84.2,8.713292820494159,8.126827019880402,14367,99.16790994990478,51.140788180925,0.48252125711097366
44005,"Newport County, Rhode Island",82714,40616,42098,43603,59418,16127,7832,1683,1398,79597,3199,2619,5818,7292,2742,4550,42658,396,5.58,84.1,13.193655245786687,8.81591991682182,10913,96.23159320066736,51.572889716372075,0.49104141983219285
44007,"Providence County, Rhode Island",631344,306301,325043,29025,425325,70136,31669,7560,6595,621405,34826,24535,59361,104178,46824,57354,295503,3807,6.75,84.4,7.258166704680808,16.500988367672775,45824,98.42573937504751,46.80538660381662,0.48515706176030815
44009,"Washington County, Rhode Island",126319,61073,65246,39568,85228,21642,11691,2349,2316,125359,3728,2657,6385,12045,5536,6509,62763,234,6.25,84,12.948170900656274,9.53538264235784,16356,99.24001931617572,49.686112144649655,0.48348229482500654
45001,"Abbeville County, South Carolina",24951,12212,12739,19234,17077,1581,554,109,103,24744,1428,1539,2967,5230,2531,2699,9339,76,4.03,95.9,3.0700172337782052,20.961083724099236,766,99.1703739329085,37.42936154863533,0.4894393010300188
45003,"Aiken County, South Carolina",165146,79827,85319,26222,114311,18076,8102,1405,1353,163350,11359,10158,21517,28253,12240,16013,68496,337,6.41,96.5,6.575999418696184,17.10789241035205,10860,98.91247744420089,41.47602727283737,0.48337228876267063
45005,"Allendale County, South Carolina",9589,5114,4475,13439,6624,526,102,0,23,8487,745,685,1430,2519,1119,1400,2676,6,8.31,96.5,1.3035770153300656,26.269684012931485,125,88.50766503285014,27.906976744186046,0.5333194285118364
45007,"Anderson County, South Carolina",192709,92748,99961,24485,131561,16779,7326,1128,1105,191356,12237,12316,24553,30879,13186,17693,81518,647,5.01,95,4.9603287858896055,16.023641864157874,9559,99.29790513157144,42.30108609354,0.4812852539320945
45009,"Bamberg County, South Carolina",15057,7262,7795,19256,9866,1269,541,60,17,14905,1060,1399,2459,3806,1993,1813,5482,54,10.07,96.8,4.104403267583184,25.27727967058511,618,98.99050275619314,36.40831506940294,0.48230059108720197
45011,"Barnwell County, South Carolina",21917,10438,11479,20018,14349,1314,509,40,34,21618,1674,1427,3101,5680,2405,3275,7931,64,8.1,96.8,2.6600355888123373,25.915955650864625,583,98.6357621937309,36.18652187799425,0.47625131176712143
45013,"Beaufort County, South Carolina",175316,86370,88946,34966,124061,29389,13810,3615,2325,167442,12824,10544,23368,21115,8892,12223,76566,1050,13.35,95.3,11.265372242122796,12.043966323666979,19750,95.50868146660886,43.67313878938602,0.4926532661023523
45015,"Berkeley County, South Carolina",199081,99053,100028,27010,130343,19834,8141,1176,795,193684,13119,12689,25808,25772,11269,14503,91953,658,10.66,95.6,5.079339565302566,12.945484501283397,10112,97.28904315328937,46.188737247652966,0.49755124798448874
45017,"Calhoun County, South Carolina",14886,7125,7761,24766,10715,1197,445,127,49,14762,1086,1138,2224,2834,1355,1479,6220,116,9.75,95.9,4.171704957678355,19.03802230283488,621,99.16700255273412,41.78422679027274,0.47863764611043935
45019,"Charleston County, South Carolina",380673,184332,196341,35587,266019,70588,25350,8564,4944,373840,26406,23308,49714,60063,25544,34519,188784,1480,9.97,94.1,10.207711080113379,15.77810877051958,38858,98.20502110735461,49.59216965742251,0.4842266196972205
45021,"Cherokee County, South Carolina",56274,27395,28879,20516,37210,3722,1593,414,213,55943,3533,3931,7464,12593,5321,7272,21084,81,4.53,93.3,3.94498347371788,22.378007605643813,2220,99.41180651810782,37.466680882823326,0.48681451469595194
45023,"Chester County, South Carolina",32435,15904,16531,20518,22206,2207,774,57,161,32242,2478,1824,4302,7554,3520,4034,12361,164,7.25,94.2,3.0584245413904734,23.28965623554802,992,99.40496377370125,38.11006628641899,0.49033451518421456
45025,"Chesterfield County, South Carolina",46083,22552,23531,19768,31421,2368,878,200,172,45648,3708,2940,6648,11158,5624,5534,18397,584,6.8,93.8,2.712497016253282,24.2128333658833,1250,99.05605103834385,39.921446086409304,0.48937786168435216
45027,"Clarendon County, South Carolina",34056,16746,17310,20616,23639,2340,949,143,108,32468,2615,2356,4971,8400,3631,4769,10996,144,10.68,94.8,3.5236081747709656,24.665257223396758,1200,95.33709184871975,32.28799624148461,0.4917195207892882
45029,"Colleton County, South Carolina",37884,18195,19689,21059,26062,2595,992,275,130,37192,3381,2664,6045,7733,3359,4374,14950,300,10.51,95.5,3.6875725900116145,20.4123112659698,1397,98.17337134410305,39.46256995037483,0.4802819132087425
45031,"Darlington County, South Carolina",67689,31953,35736,21225,45884,5260,1983,244,372,66922,4906,4901,9807,15241,6348,8893,25674,35,7.95,94.1,3.8396194359497113,22.516213860449998,2599,98.86687644964469,37.92935336613039,0.472056020919204
45033,"Dillon County, South Carolina",31273,14592,16681,15638,20376,1404,429,71,49,30921,2785,2342,5127,9431,4021,5410,11389,53,9.85,93.9,1.7555079461516323,30.15700444472868,549,98.87442842068238,36.417996354682955,0.46660058197166887
45035,"Dorchester County, South Carolina",148517,72395,76122,27317,97867,16517,7568,1060,647,145645,8773,8101,16874,17625,7098,10527,68989,420,9.97,95.9,6.245076321229219,11.86732831931698,9275,98.06621464209485,46.45192132887144,0.4874526148521718
45037,"Edgefield County, South Carolina",26388,14310,12078,23804,18936,2274,890,177,184,23728,1457,1142,2599,4002,1612,2390,10516,63,4.48,96,4.740791268758526,15.165984538426558,1251,89.91966045172047,39.85144762770957,0.5422919508867667
45039,"Fairfield County, South Carolina",23025,11004,12021,21972,16464,1904,579,187,188,22721,2063,1470,3533,5563,2376,3187,8603,0,6.97,95.9,4.143322475570033,24.160694896851247,954,98.67969598262758,37.36373507057546,0.47791530944625404
45041,"Florence County, South Carolina",138575,64672,73903,23797,92344,13383,5492,954,855,136982,8310,8048,16358,26515,11007,15508,58222,452,10.22,95.2,5.2686270972397615,19.134042937037705,7301,98.85044199891756,42.01479343315894,0.46669312646581274
45043,"Georgetown County, South Carolina",60804,28933,31871,28748,44375,7191,3186,802,408,60193,5186,4901,10087,11514,4611,6903,23324,246,11.02,93.1,7.2297875139793435,18.936254193803038,4396,98.99513189921716,38.359318465890404,0.4758404052364976
45045,"Greenville County, South Carolina",482191,234053,248138,29132,324486,68371,28074,6185,4068,477643,34486,30127,64613,67067,28961,38106,222920,1495,5.93,92,7.94851003025772,13.908803772778837,38327,99.05680529084948,46.23064304393902,0.4853947916904297
45047,"Greenwood County, South Carolina",69881,32511,37370,22636,46691,7441,2675,424,450,68716,5635,5479,11114,16282,6772,9510,28207,135,4.76,95.5,5.078633677251327,23.29960933587098,3549,98.33288018202373,40.36433365292426,0.4652337545255506
45049,"Hampton County, South Carolina",20296,10447,9849,17676,13974,1020,457,47,21,18883,1267,1044,2311,3282,1465,1817,7673,67,9.27,95.8,2.586716594402838,16.170674024438313,525,93.0380370516358,37.80547891210091,0.5147319668900275
45051,"Horry County, South Carolina",300418,145624,154794,25804,217748,33014,12270,2369,1577,298993,27395,23131,50526,52197,23313,28884,131140,907,12.46,92.9,5.397812381415228,17.374791124366716,16216,99.52566091246197,43.65251083490337,0.4847379318150044
45053,"Jasper County, South Carolina",27186,14081,13105,20067,18945,1773,774,104,101,26658,3332,2110,5442,6256,3191,3065,11955,145,11.56,95.9,3.601118222614581,23.011844331641285,979,98.0578238799382,43.974839991171926,0.5179504156551166
45055,"Kershaw County, South Carolina",63090,30547,32543,23530,43219,5690,2689,289,237,62568,4026,3669,7695,9963,4554,5409,26333,247,6.69,94.8,5.095894753526708,15.79172610556348,3215,99.17261055634808,41.73878586146775,0.48418132826121413
45057,"Lancaster County, South Carolina",83704,40886,42818,26425,58697,9142,3728,439,364,81803,5844,4790,10634,14201,6015,8186,33352,485,6.87,94.2,5.4131224314250215,16.965736404472903,4531,97.72890184459524,39.845168689668355,0.4884593328873172
45059,"Laurens County, South Carolina",66442,32155,34287,20748,45030,4056,1885,247,185,65152,4342,4322,8664,13028,5707,7321,27532,113,5.7,94.6,3.487252039372686,19.608079226994974,2317,98.0584570000903,41.43764486318895,0.4839559314891183
45061,"Lee County, South Carolina",18189,9437,8752,16972,12444,925,319,54,6,16546,1172,990,2162,4666,2163,2503,5860,117,7.56,94.3,2.0836769476056958,25.652867117488594,379,90.96706800813679,32.2172741767002,0.5188300621254605
45063,"Lexington County, South Carolina",277702,135372,142330,29311,189215,36081,15754,2670,2002,274691,16857,14457,31314,37445,16231,21214,131894,3142,7.38,97.1,7.355366543993202,13.483878402028074,20426,98.91574421502186,47.49479658050716,0.4874721824113618
45065,"McCormick County, South Carolina",9806,5450,4356,22836,7984,977,389,49,74,8524,466,310,776,1672,766,906,2689,17,4.07,96,5.221293085865796,17.05078523353049,512,86.92637160921885,27.421986538853762,0.555782174179074
45067,"Marion County, South Carolina",31975,14687,17288,18556,21716,2357,995,42,140,31786,2417,2182,4599,8225,3400,4825,11957,57,12.19,94.4,3.6810007818608286,25.723221266614544,1177,99.408913213448,37.3948397185301,0.45932759968725567
45069,"Marlboro County, South Carolina",27702,14716,12986,16561,19675,1074,526,40,19,24566,1734,1459,3193,6551,2690,3861,9499,40,7.95,93.7,2.1117608836907085,23.648112049671504,585,88.67951772435204,34.289942964406904,0.5312251822973071
45071,"Newberry County, South Carolina",37750,18336,19414,22190,25619,2636,1186,106,249,37264,2403,1787,4190,6828,2955,3873,16065,17,5.47,96.5,4.082119205298013,18.087417218543045,1541,98.71258278145696,42.556291390728475,0.48572185430463577
45073,"Oconee County, South Carolina",75375,37104,38271,26798,53965,7486,3646,664,894,74817,5486,5148,10634,13806,5929,7877,29190,246,6.7,93.4,6.904145936981758,18.31641791044776,5204,99.25970149253732,38.72636815920398,0.4922587064676617
45075,"Orangeburg County, South Carolina",89731,42228,47503,19489,59363,7031,3664,468,706,89007,7670,6314,13984,20319,8970,11349,33882,395,10.17,96.2,5.391670660084029,22.64434810712017,4838,99.19314395248018,37.75952569346157,0.4706065908103108
45077,"Pickens County, South Carolina",120722,60065,60657,23501,75105,10488,4825,968,1443,120016,7071,6513,13584,21236,10075,11161,50900,247,5.79,92.4,5.993936482165637,17.59082851510081,7236,99.41518530176769,42.16298603402859,0.4975480856844651
45079,"Richland County, South Carolina",401743,194943,206800,28018,248613,56096,27409,5725,4024,377588,21038,19962,41000,61606,26162,35444,193925,3569,7.06,96.9,9.249196625703497,15.334679135666335,37158,93.98744968798461,48.27090951180232,0.48524305339483204
45081,"Saluda County, South Carolina",20113,10112,10001,20390,13889,1514,626,97,69,19862,1991,1452,3443,3764,1656,2108,8400,52,6.03,96,3.937751702878735,18.714264406105503,792,98.75205091234525,41.76403321235022,0.5027594093372446
45083,"Spartanburg County, South Carolina",294229,142694,151535,24786,196173,28866,12132,2254,1531,290022,20506,18852,39358,48747,21167,27580,127878,703,5.32,93.6,5.409731875511931,16.56770746595339,15917,98.57016133691785,43.46206526209177,0.4849759880909088
45085,"Sumter County, South Carolina",107682,51876,55806,21733,69468,8388,3644,700,491,103816,7192,6666,13858,21063,9372,11691,43422,433,9.5,94.6,4.490072621236604,19.560372207054105,4835,96.40979922363998,40.32428818186884,0.48175182481751827
45087,"Union County, South Carolina",27928,13442,14486,21183,19700,1593,653,74,120,27441,1755,1298,3053,5464,2261,3203,11009,125,6.66,95.2,3.0327986250358063,19.56459467201375,847,98.25623030650243,39.41922085362361,0.4813090804926955
45089,"Williamsburg County, South Carolina",32816,15946,16870,17440,22900,1924,714,168,50,30990,2230,2257,4487,9056,3821,5235,11548,91,10.05,95.2,2.840078010726475,27.596294490492443,932,94.43564115065821,35.190151145782544,0.4859215017064846
45091,"York County, South Carolina",245606,118494,127112,30387,163095,32307,12677,1674,1464,244129,13216,13167,26383,30218,12990,17228,115601,717,6.73,93.4,6.439174938722996,12.303445355569488,15815,99.39863032662069,47.06766121348827,0.48245564033451954
46003,"Aurora County, South Dakota",2732,1437,1295,30872,1823,292,58,10,16,2603,90,66,156,161,72,89,1396,37,5.12,87.4,3.074670571010249,5.89311859443631,84,95.27818448023426,51.09809663250366,0.5259882869692533
46005,"Beadle County, South Dakota",18155,9113,9042,24950,12084,1937,452,17,52,17853,685,864,1549,3812,1741,2071,8895,80,4.18,86.6,2.869732855962545,20.996970531534014,521,98.33654640594878,48.994767281740565,0.5019553841916827
46007,"Bennett County, South Dakota",3445,1576,1869,15287,1922,275,51,6,10,3406,392,368,760,1286,506,780,1114,44,4.66,86.4,1.9448476052249637,37.32946298984035,67,98.86792452830188,32.33671988388969,0.4574746008708273
46009,"Bon Homme County, South Dakota",7001,4064,2937,24858,5146,685,168,37,53,5604,164,163,327,601,275,326,2818,26,7.07,86.6,3.685187830309956,8.584487930295673,258,80.04570775603486,40.25139265819168,0.5804885016426224
46011,"Brookings County, South Dakota",33435,17181,16254,27197,17474,4686,1604,155,711,33303,1250,906,2156,4949,2694,2255,18404,44,5.45,81.7,7.387468221923134,14.801854344250037,2470,99.6052041274114,55.044115447883954,0.5138627187079408
46013,"Brown County, South Dakota",38430,18716,19714,31493,25504,5142,1320,299,361,37898,1478,1579,3057,4076,1832,2244,20537,180,4.18,83.7,5.152224824355972,10.606297163674213,1980,98.61566484517304,53.44002081707,0.4870153525891231
46015,"Brule County, South Dakota",5312,2637,2675,26074,3566,586,220,59,48,5158,295,272,567,772,339,433,2597,119,5.31,88.3,6.1558734939759034,14.533132530120483,327,97.10090361445783,48.88930722891566,0.4964231927710843
46017,"Buffalo County, South Dakota",2052,986,1066,10960,1030,63,11,6,3,2052,494,462,956,800,395,405,601,7,5.01,87.8,0.9746588693957114,38.98635477582846,20,100,29.28849902534113,0.48050682261208577
46019,"Butte County, South Dakota",10268,5076,5192,26178,7032,1133,208,23,21,10147,902,758,1660,1028,433,595,5092,6,2.44,89.6,2.454226723802104,10.011686793922868,252,98.82158161277756,49.59096221269965,0.49435138293728087
46021,"Campbell County, South Dakota",1553,735,818,36158,1084,212,12,15,19,1553,26,55,81,117,54,63,712,0,4.01,84.4,2.962009014810045,7.533805537669028,46,100,45.84674822923374,0.4732775273663876
46023,"Charles Mix County, South Dakota",9277,4628,4649,21805,5736,740,167,74,59,9035,914,951,1865,1927,893,1034,3795,92,7.08,87.4,3.2338040314756924,20.771801228845533,300,97.39139808127628,40.90762099816751,0.49886816858898353
46025,"Clark County, South Dakota",3639,1866,1773,26759,2456,331,63,15,1,3576,198,130,328,553,293,260,1751,18,4.75,83.6,2.1709260785930202,15.19648255015114,79,98.26875515251443,48.11761472932124,0.5127782357790602
46027,"Clay County, South Dakota",14029,7001,7028,24541,6973,1822,754,220,539,13828,668,649,1317,3223,1617,1606,7032,26,5.99,86.3,10.784802908261458,22.97383990305795,1513,98.56725354622567,50.1247416066719,0.49903770760567395
46029,"Codington County, South Dakota",27886,14048,13838,29249,18573,3251,479,132,27,27572,948,1047,1995,2847,1260,1587,14982,48,6.05,82.4,2.2878863946066126,10.209424083769633,638,98.87398694685506,53.725883956107005,0.5037653302732554
46031,"Corson County, South Dakota",4170,2120,2050,15160,2336,318,59,0,5,4170,556,423,979,1929,932,997,1246,8,4.56,86.9,1.5347721822541966,46.2589928057554,64,100,29.88009592326139,0.5083932853717026
46033,"Custer County, South Dakota",8447,4241,4206,31015,6641,1230,264,46,87,8137,456,489,945,944,456,488,3908,59,3.74,85.4,4.699893453297029,11.175565289451876,397,96.3300580087605,46.264946134722386,0.5020717414466674
46035,"Davison County, South Dakota",19824,9974,9850,28086,13203,2649,694,143,32,19467,940,489,1429,2283,1310,973,10188,31,5.36,86.9,4.383575464083939,11.51634382566586,869,98.19915254237289,51.39225181598063,0.5031275221953188
46037,"Day County, South Dakota",5588,2883,2705,30841,4045,543,94,39,17,5425,379,258,637,997,482,515,2721,25,4.5,82.2,2.6843235504652827,17.841803865425913,150,97.08303507516106,48.69362920544023,0.5159269863994274
46039,"Deuel County, South Dakota",4309,2230,2079,29204,3023,470,86,19,23,4242,134,99,233,448,217,231,2268,6,6.49,81.2,2.970526804362961,10.396843815270364,128,98.44511487584126,52.63402181480622,0.5175214666976097
46041,"Dewey County, South Dakota",5652,2784,2868,17267,3076,316,106,4,7,5605,935,865,1800,1545,722,823,1915,17,5.02,88.1,2.070063694267516,27.335456475583864,117,99.16843595187544,33.881811748053785,0.49256900212314225
46043,"Douglas County, South Dakota",2961,1458,1503,27603,2109,307,90,28,10,2865,196,154,350,208,64,144,1496,15,6.33,87.1,4.322863897331983,7.0246538331644715,128,96.75785207700102,50.52347180006755,0.49240121580547114
46045,"Edmunds County, South Dakota",4000,2001,1999,31836,2724,437,148,13,27,3882,187,91,278,380,141,239,1970,17,3.41,83.5,4.7,9.5,188,97.05,49.25,0.50025
46047,"Fall River County, South Dakota",6874,3499,3375,26584,5211,920,194,105,29,6671,323,298,621,1115,525,590,3036,39,2.64,90.2,4.77160314227524,16.220541169624674,328,97.04684317718942,44.166424207157405,0.5090194937445447
46049,"Faulk County, South Dakota",2354,1182,1172,29714,1705,293,92,23,37,2295,125,90,215,287,126,161,1129,4,3.68,84.4,6.457094307561597,12.192013593882752,152,97.49362786745964,47.96091758708581,0.5021240441801189
46051,"Grant County, South Dakota",7195,3707,3488,29363,5100,666,67,10,2,7145,254,112,366,555,225,330,3853,0,6.71,82.8,1.0979847116052814,7.713690062543433,79,99.30507296733843,53.551077136900624,0.5152189020152884
46053,"Gregory County, South Dakota",4217,2158,2059,26169,2976,467,82,14,11,4166,210,212,422,686,326,360,2024,23,5.68,87.3,2.5373488261797488,16.267488736068294,107,98.79060943798909,47.996205833530944,0.5117382025136353
46055,"Haakon County, South Dakota",2073,1009,1064,22863,1467,234,45,8,5,2035,94,78,172,365,190,175,954,0,4.4,89.4,2.797877472262422,17.607332368547997,58,98.16690786300049,46.02026049204052,0.4867342016401351
46057,"Hamlin County, South Dakota",5995,3034,2961,27060,3672,573,134,23,22,5849,174,129,303,449,187,262,2856,37,5.67,82.7,2.9858215179316097,7.489574645537949,179,97.56463719766472,47.63969974979149,0.5060884070058382
46059,"Hand County, South Dakota",3311,1680,1631,33109,2377,427,88,35,0,3256,150,53,203,197,99,98,1691,3,4.63,85.5,3.7148897614013894,5.949864089398973,123,98.33887043189368,51.07218363032317,0.507399577167019
46061,"Hanson County, South Dakota",3390,1724,1666,24805,2057,339,89,11,1,3387,146,103,249,339,218,121,1695,3,5.62,86,2.9793510324483776,10,101,99.91150442477876,50,0.5085545722713865
46063,"Harding County, South Dakota",1277,655,622,30464,842,201,44,5,0,1257,43,47,90,165,82,83,644,8,2.41,89.1,3.837118245888802,12.920908379013312,49,98.43382928739233,50.430696945967114,0.5129209083790133
46065,"Hughes County, South Dakota",17518,8548,8970,32000,12125,2694,905,248,155,16486,769,539,1308,1451,656,795,9473,17,4.55,89.3,7.466605776915173,8.282909007877612,1308,94.10891654298436,54.07580774060966,0.4879552460326521
46067,"Hutchinson County, South Dakota",7264,3641,3623,29869,5016,806,202,57,18,7019,395,230,625,940,491,449,3647,19,5.73,86.3,3.8133259911894273,12.940528634361234,277,96.62720264317181,50.206497797356825,0.5012389867841409
46069,"Hyde County, South Dakota",1440,705,735,30277,1058,179,29,0,8,1402,70,61,131,154,67,87,746,4,4.65,86,2.5694444444444446,10.694444444444445,37,97.36111111111111,51.80555555555556,0.4895833333333333
46071,"Jackson County, South Dakota",3268,1676,1592,16939,1820,242,77,14,6,3223,409,352,761,1167,573,594,1163,15,4.32,89,2.9681762545899635,35.709914320685435,97,98.62301101591187,35.5875152998776,0.5128518971848225
46073,"Jerauld County, South Dakota",2029,975,1054,38776,1470,188,53,20,0,1987,82,61,143,195,72,123,982,17,4.74,86.4,3.597831444061114,9.61064563824544,73,97.93001478560868,48.39822572695909,0.48053228191227204
46075,"Jones County, South Dakota",767,418,349,26526,612,74,13,1,0,767,66,45,111,79,54,25,459,9,4.2,89.9,1.8252933507170794,10.29986962190352,14,100,59.84354628422425,0.5449804432855281
46077,"Kingsbury County, South Dakota",5070,2561,2509,33333,3644,624,143,50,9,4981,181,137,318,465,198,267,2577,7,5.23,83.6,3.9842209072978303,9.171597633136095,202,98.24457593688363,50.828402366863905,0.5051282051282051
46079,"Lake County, South Dakota",12331,6355,5976,31145,8257,2017,469,78,178,12181,528,315,843,1601,643,958,6232,49,4.56,82.4,5.879490714459492,12.983537425999513,725,98.78355364528424,50.53929121725732,0.5153677722812424
46081,"Lawrence County, South Dakota",24859,12353,12506,28606,16919,3571,1298,145,333,24615,1604,1364,2968,2873,1236,1637,12581,99,2.69,84.5,7.144293817128605,11.55718250935275,1776,99.01846413773684,50.60943722595438,0.49692264371052736
46083,"Lincoln County, South Dakota",51396,25464,25932,39404,32937,9482,2728,883,488,51103,1146,1317,2463,1903,682,1221,28369,156,7.84,85.1,7.975328819363375,3.702622772200171,4099,99.42991672503697,55.19690248268348,0.4954471165071212
46085,"Lyman County, South Dakota",3855,2028,1827,21155,2429,313,108,19,4,3827,478,348,826,829,386,443,1706,13,4.86,89.4,3.398184176394293,21.50453955901427,131,99.27367055771725,44.25421530479896,0.5260700389105059
46087,"McCook County, South Dakota",5616,2793,2823,29254,3748,625,172,29,19,5466,243,176,419,566,265,301,2792,9,5.17,84.3,3.9173789173789175,10.078347578347579,220,97.32905982905983,49.71509971509972,0.49732905982905984
46089,"McPherson County, South Dakota",2252,1164,1088,25975,1714,205,40,7,7,2160,248,89,337,404,279,125,1019,0,3.57,81.7,2.3978685612788633,17.939609236234457,54,95.91474245115452,45.248667850799286,0.5168738898756661
46091,"Marshall County, South Dakota",4743,2477,2266,28861,3306,526,139,30,52,4678,280,183,463,493,153,340,2462,54,6.02,81.5,4.659498207885305,10.394265232974911,221,98.62955935062197,51.908075057980184,0.5222433059245204
46093,"Meade County, South Dakota",26840,13990,12850,26896,17464,3129,754,147,123,25605,1424,1303,2727,2353,973,1380,14194,3,3.12,88.3,3.8152011922503726,8.766766020864381,1024,95.39865871833085,52.88375558867362,0.5212369597615499
46095,"Mellette County, South Dakota",2083,1039,1044,14264,1257,156,14,6,0,2051,312,214,526,937,448,489,733,0,4.19,89.3,0.9601536245799328,44.98319731156985,20,98.46375420067211,35.189630340854535,0.4987998079692751
46097,"Miner County, South Dakota",2299,1180,1119,28633,1568,239,48,15,37,2257,102,109,211,223,107,116,1077,14,4.65,84.3,4.349717268377556,9.69986950848195,100,98.17311874728142,46.84645498042627,0.5132666376685515
46099,"Minnehaha County, South Dakota",182014,91348,90666,29551,119030,25397,7377,2042,1200,179267,8810,7112,15922,20543,9135,11408,99226,661,5.33,83.9,5.8341666025690335,11.286494445482216,10619,98.49077543485666,54.51558671310998,0.5018734822596064
46101,"Moody County, South Dakota",6445,3268,3177,27774,4272,852,240,25,30,6389,445,242,687,935,425,510,3329,31,4.54,82.7,4.577191621411948,14.507370054305664,295,99.1311093871218,51.65244375484872,0.5070597362296354
46103,"Pennington County, South Dakota",107298,53929,53369,28910,72302,13903,4899,1253,861,104572,6436,5616,12052,14402,6427,7975,53547,344,2.75,86.1,6.536002534995992,13.422430986598073,7013,97.45941210460586,49.90493765028239,0.5026095546981304
46105,"Perkins County, South Dakota",3019,1547,1472,30120,2183,292,80,41,6,2975,204,120,324,400,184,216,1459,2,3.27,87.6,4.206690957270619,13.249420337860219,127,98.54256376283537,48.32726068234515,0.512421331566744
46107,"Potter County, South Dakota",2306,1103,1203,32853,1752,268,62,14,6,2227,78,83,161,235,118,117,1134,0,4.7,86.1,3.5559410234171724,10.190806591500433,82,96.57415437987858,49.17606244579358,0.47831743278404165
46109,"Roberts County, South Dakota",10294,5167,5127,25767,6498,713,234,49,46,10098,1031,959,1990,2064,973,1091,4343,30,5.64,82.4,3.1960365261317274,20.050514863027004,329,98.09597823975132,42.189625024285995,0.5019428793471925
46111,"Sanborn County, South Dakota",2349,1239,1110,31965,1712,253,54,19,4,2290,97,59,156,199,81,118,1263,0,4.83,86.8,3.277990634312473,8.471690080885484,77,97.48829289059174,53.76756066411239,0.5274584929757343
46115,"Spink County, South Dakota",6539,3270,3269,31957,4504,754,137,47,12,6408,262,262,524,703,289,414,3203,18,3.36,85.4,2.9974002141000153,10.750879339348524,196,97.99663557118825,48.983024927358926,0.500076464291176
46117,"Stanley County, South Dakota",2964,1522,1442,32862,2019,271,188,46,40,2964,152,87,239,211,73,138,1650,7,4.69,90.1,9.244264507422402,7.1187584345479085,274,100,55.66801619433198,0.5134952766531714
46119,"Sully County, South Dakota",1456,802,654,39888,972,205,37,4,0,1456,112,47,159,63,35,28,743,0,4.72,87.8,2.815934065934066,4.326923076923077,41,100,51.03021978021978,0.5508241758241759
46121,"Todd County, South Dakota",10019,4890,5129,11665,4885,573,138,35,23,9978,1578,1459,3037,4582,2197,2385,2790,122,4.59,87,1.9562830621818545,45.73310709651662,196,99.59077752270686,27.847090527996805,0.48807266194230964
46123,"Tripp County, South Dakota",5475,2763,2712,27613,3893,616,132,35,50,5334,285,236,521,1147,513,634,2867,15,5.03,89.1,3.963470319634703,20.949771689497716,217,97.42465753424658,52.36529680365297,0.5046575342465753
46125,"Turner County, South Dakota",8289,4169,4120,27844,5820,911,247,47,43,8132,286,274,560,837,316,521,4195,44,6.23,85.5,4.0656291470623716,10.09771986970684,337,98.10592351308964,50.60924116298709,0.5029557244540958
46127,"Union County, South Dakota",14842,7464,7378,37093,10074,1740,884,229,183,14702,487,449,936,943,342,601,7655,40,5.03,86.2,8.731976822530656,6.3535911602209945,1296,99.0567308988007,51.57660692629026,0.5028971836679693
46129,"Walworth County, South Dakota",5538,2717,2821,29457,3969,600,125,69,25,5375,227,238,465,576,202,374,2636,29,3.96,85.4,3.9544962080173347,10.400866738894909,219,97.05669916937522,47.59841097869267,0.49061032863849763
46135,"Yankton County, South Dakota",22649,11888,10761,30395,15846,2970,896,256,209,21195,984,638,1622,3055,1282,1773,11460,7,6.55,86.3,6.0090953242968785,13.488454236390128,1361,93.58029052055278,50.59826040884807,0.524879685637335
46137,"Ziebach County, South Dakota",2818,1388,1430,13461,1518,182,41,5,8,2818,430,264,694,1106,515,591,945,21,4.62,88.5,1.9162526614620299,39.24769339957417,54,100,33.53442157558552,0.49254790631653655
47001,"Anderson County, Tennessee",75545,36834,38711,26972,53614,7311,3544,813,1182,74667,4265,2681,6946,12747,5526,7221,31134,192,9.17,89.9,7.332053742802303,16.873386723145146,5539,98.83777880733338,41.21252233767953,0.4875769408961546
47003,"Bedford County, Tennessee",46331,22685,23646,22953,30407,2970,961,245,158,45928,3715,2695,6410,7423,3218,4205,20493,108,6.98,91,2.9440331527486996,16.021670156051023,1364,99.13017202305151,44.23172389976474,0.48962897412099887
47005,"Benton County, Tennessee",16173,7958,8215,21282,11898,909,419,77,52,16021,1073,1079,2152,3614,1627,1987,5753,45,9.38,91.2,3.3883633215853584,22.345885117170592,548,99.06016199839239,35.57163173189884,0.4920546589995672
47007,"Bledsoe County, Tennessee",14073,7910,6163,21402,10223,651,427,59,14,12884,1067,787,1854,3050,1458,1592,4798,21,8.5,88.3,3.5529027215234845,21.672706601293257,500,91.55119732821716,34.09365451573936,0.5620692105450152
47009,"Blount County, Tennessee",126192,61268,64924,28334,89312,13732,4464,1572,882,124988,6956,5719,12675,16793,7430,9363,56729,474,7.92,89.8,5.48212248003043,13.307499683022696,6918,99.04589831368074,44.95451375681501,0.48551413718777736
47011,"Bradley County, Tennessee",102860,49964,52896,25144,69225,9286,3746,839,597,101860,7145,6192,13337,18291,7994,10297,43897,549,6.89,93.3,5.037915613455182,17.782422710480265,5182,99.02780478320047,42.67645343184912,0.48574761812171885
47013,"Campbell County, Tennessee",40008,19467,20541,21282,28628,1909,836,216,80,39509,2795,2246,5041,8821,3918,4903,14289,71,8.84,86.6,2.8294341131773644,22.048090381923615,1132,98.75274945010997,35.71535692861428,0.4865776844631074
47015,"Cannon County, Tennessee",13855,6856,6999,24595,9873,873,292,78,40,13666,976,636,1612,2208,983,1225,5757,10,7.26,89.1,2.959220498015157,15.936485023457235,410,98.63587152652472,41.55178635871526,0.4948394081559004
47017,"Carroll County, Tennessee",28417,13815,14602,20557,19538,1763,909,145,109,27936,1661,1410,3071,5441,2476,2965,10880,254,10.76,91.1,4.092620614420945,19.14698947812929,1163,98.30735123341661,38.28694091564908,0.48615265510081995
47019,"Carter County, Tennessee",56707,27824,28883,21001,41161,4427,1622,342,237,55665,4225,3435,7660,13110,5929,7181,22593,332,6,86,3.8813550355335322,23.11883894404571,2201,98.16248434937485,39.841642125310806,0.49066252843564284
47021,"Cheatham County, Tennessee",39575,19558,20017,25673,27138,3596,1341,145,188,39248,2241,1915,4156,5061,2194,2867,18557,111,5.62,92.1,4.229943145925458,12.788376500315856,1674,99.1737207833228,46.89071383449147,0.4942008843967151
47023,"Chester County, Tennessee",17355,8373,8982,20497,10958,997,460,103,170,17272,1144,1020,2164,2911,1448,1463,7245,52,9.74,92.3,4.223566695476808,16.773264188994528,733,99.52175165658312,41.74589455488332,0.4824546240276577
47025,"Claiborne County, Tennessee",31701,15470,16231,20184,22492,1683,931,148,204,31144,1630,1311,2941,6771,2895,3876,11249,71,9.28,87.7,4.047190940348885,21.358947667266015,1283,98.24295763540583,35.48468502570897,0.4879972240623324
47027,"Clay County, Tennessee",7769,3823,3946,17667,5674,327,360,78,15,7675,547,483,1030,1904,912,992,2515,19,7.53,89.4,5.830866263354357,24.50765864332604,453,98.79006307118033,32.37224868065388,0.49208392328485007
47029,"Cocke County, Tennessee",35256,17222,18034,20189,25243,1659,723,129,75,34976,2525,2522,5047,9081,4065,5016,13715,71,5.35,89.8,2.629339686861811,25.757317903335604,927,99.20580894032221,38.90117994100295,0.48848422963467214
47031,"Coffee County, Tennessee",53808,26166,27642,24748,36481,4398,1782,293,258,53196,3252,2976,6228,8437,3766,4671,22116,102,7.78,89,4.335786500148677,15.679824561403509,2333,98.86262265834077,41.101694915254235,0.48628456735057984
47033,"Crockett County, Tennessee",14558,6912,7646,21056,9884,859,368,63,52,14350,1224,949,2173,2602,1256,1346,5716,30,12.67,91.4,3.3177634290424507,17.873334249210057,483,98.57123231213079,39.26363511471356,0.4747904931996153
47035,"Cumberland County, Tennessee",57895,28237,29658,23668,43646,5093,2287,479,330,57246,4123,3035,7158,9075,3762,5313,19945,110,8.4,86.2,5.347612056308835,15.674928750323863,3096,98.87900509543138,34.450297953191125,0.48772778305553155
47037,"Davidson County, Tennessee",667885,322044,345841,32347,454177,108196,43972,12641,8700,660681,52683,41058,93741,114238,51988,62250,344577,2684,7.14,91.6,9.77907873361432,17.104441632915847,65313,98.92137119414271,51.592265135464935,0.48218480726472374
47039,"Decatur County, Tennessee",11703,5698,6005,21098,8392,610,286,22,30,11476,641,649,1290,2399,1083,1316,4554,40,7.53,92.2,2.888148338032983,20.499017345979663,338,98.0603264120311,38.91309920533197,0.4868837050328976
47041,"DeKalb County, Tennessee",19159,9493,9666,25443,13323,1252,385,134,118,18917,1363,1193,2556,4152,1780,2372,7489,90,7.39,89.4,3.3248081841432224,21.67127720653479,637,98.73688605877133,39.088678949840805,0.4954851505819719
47043,"Dickson County, Tennessee",50926,24989,25937,25211,34804,3231,1078,272,339,50393,3089,2803,5892,8019,3348,4671,21808,204,5.88,90.7,3.316576994069827,15.746377096178769,1689,98.95338334053332,42.82291953029887,0.49069237717472414
47045,"Dyer County, Tennessee",37970,18329,19641,24695,25544,2837,1335,325,214,37444,2105,1935,4040,6915,2729,4186,15828,170,11.36,90.8,4.935475375296287,18.211746115354227,1874,98.61469581248355,41.68554121675007,0.4827232025283118
47047,"Fayette County, Tennessee",39071,19264,19807,30471,28134,4131,1618,243,218,38611,1956,1539,3495,5774,2698,3076,17001,117,13.28,92,5.321082132527962,14.778224258401371,2079,98.82265619001305,43.51309155127844,0.49305111207801183
47049,"Fentress County, Tennessee",17936,8806,9130,18171,12652,1004,431,118,32,17714,1342,999,2341,4107,2029,2078,6250,43,8.21,86.6,3.2392952720785013,22.89808206958073,581,98.76226583407671,34.846119536128455,0.4909678858162355
47051,"Franklin County, Tennessee",41348,20171,21177,25637,28149,3147,1480,338,388,40985,2056,2020,4076,6397,2846,3551,16818,154,7.35,90.2,5.335203637418981,15.471123149850053,2206,99.12208571152172,40.67427686949792,0.4878349617877527
47053,"Gibson County, Tennessee",49511,23596,25915,21858,33608,3689,1646,323,162,48388,2761,2334,5095,9039,4033,5006,20305,228,11.52,91.2,4.304094039708348,18.256549049706127,2131,97.73181717194159,41.01108844499202,0.47658096180646725
47055,"Giles County, Tennessee",29034,14140,14894,22994,20348,1897,739,113,103,28627,1908,1439,3347,4721,1952,2769,11678,145,7.16,91.2,3.2892470896190673,16.260246607425778,955,98.59819521939795,40.221808913687404,0.4870152235310326
47057,"Grainger County, Tennessee",22813,11306,11507,20966,16317,1330,392,101,70,22667,1258,1153,2411,4578,2035,2543,8588,46,8.21,89.6,2.467891114715294,20.06750536974532,563,99.36001402708982,37.645202296935956,0.49559461710428265
47059,"Greene County, Tennessee",68502,33474,35028,21960,49012,4716,1922,344,216,67312,4553,3619,8172,12373,5681,6692,27086,423,6.02,90.4,3.623251875857639,18.062246357770576,2482,98.26282444308195,39.54045137368252,0.48865726548129984
47061,"Grundy County, Tennessee",13494,6686,6808,15824,9465,618,338,28,54,13313,1539,1024,2563,3718,1674,2044,4312,8,8.28,86.4,3.112494441974211,27.552986512524086,420,98.65866310953017,31.954942937601896,0.4954794723580851
47063,"Hamblen County, Tennessee",63203,30662,32541,21962,43388,4397,1880,414,237,62448,5053,4085,9138,13112,6043,7069,24934,716,6.73,90.4,4.004556745724096,20.745850671645332,2531,98.80543645080138,39.45065898770628,0.4851351992785153
47065,"Hamilton County, Tennessee",351305,169346,181959,29711,243329,46339,18256,4786,2639,347387,20027,16390,36417,50631,22453,28178,161812,1260,7.76,92.2,7.31017207270036,14.412262848521939,25681,98.88472979319964,46.06026102674314,0.4820483625339804
47067,"Hancock County, Tennessee",6609,3288,3321,19396,4752,335,155,15,33,6446,444,381,825,1757,710,1047,2053,16,7.57,88.2,3.0715690724769256,26.584959903162353,203,97.5336662127402,31.0637010137691,0.49750340444847935
47069,"Hardeman County, Tennessee",25975,14094,11881,16938,18254,1187,611,120,56,22384,1449,1328,2777,5285,2317,2968,8092,16,10.25,92.6,3.0298363811357074,20.34648700673725,787,86.17516843118383,31.153031761308952,0.5425986525505293
47071,"Hardin County, Tennessee",25839,12638,13201,23328,18628,1436,747,159,15,25434,1870,1535,3405,5634,2353,3281,9673,120,5.76,92.5,3.564379426448392,21.804249390456288,921,98.43260188087774,37.435659274739734,0.4891056155423972
47073,"Hawkins County, Tennessee",56567,27698,28869,22141,40416,3566,1138,352,193,55980,3545,2588,6133,10706,4487,6219,20840,188,6.22,89.6,2.975232909646967,18.926229073488077,1683,98.96229250269592,36.84126787703078,0.4896494422543179
47075,"Haywood County, Tennessee",18129,8472,9657,21453,12534,911,425,91,65,17887,1182,874,2056,3744,1622,2122,7421,107,13.62,91.6,3.204809972971482,20.651994042694025,581,98.66512217993271,40.93441447404711,0.46731755750455073
47077,"Henderson County, Tennessee",27952,13455,14497,21344,19242,1725,642,103,101,27646,1496,1508,3004,5703,2453,3250,11077,41,9.94,91.6,3.0266170578133944,20.402833428734976,846,98.90526617057813,39.62864911276474,0.4813609044075558
47079,"Henry County, Tennessee",32291,15680,16611,22952,23226,1917,1069,176,251,31797,2018,1454,3472,6151,2579,3572,12645,228,9.1,90.6,4.632869839893469,19.048651326995138,1496,98.4701619646341,39.15951813198724,0.48558421851289835
47081,"Hickman County, Tennessee",24251,12719,11532,20936,16829,1299,466,95,58,22779,1789,1636,3425,5181,2575,2606,9398,246,7.25,90.9,2.552472063007711,21.364067461135622,619,93.93014721042431,38.753041111706736,0.5244732175992742
47083,"Houston County, Tennessee",8234,4120,4114,20819,5727,488,99,9,19,8037,524,479,1003,1672,846,826,2930,15,7.32,90.4,1.542385231965023,20.3060480932718,127,97.60748117561332,35.584163225649746,0.5003643429681807
47085,"Humphreys County, Tennessee",18216,8971,9245,23498,12762,928,581,78,56,18003,1048,759,1807,3308,1555,1753,6874,43,7.59,90.7,3.92512077294686,18.15985946420729,715,98.83069828722003,37.73605621431708,0.49247913921826963
47087,"Jackson County, Tennessee",11526,5795,5731,18643,8429,392,198,24,61,11348,959,663,1622,2835,1216,1619,3762,15,7.93,89.6,2.4553184105500607,24.59656428943259,283,98.45566545202152,32.63925039042166,0.5027763317716467
47089,"Jefferson County, Tennessee",52851,26034,26817,23724,36897,3473,1763,262,267,51998,3240,2705,5945,7724,3575,4149,22549,189,6.91,90.8,4.336720213430209,14.614671434788367,2292,98.38602864657244,42.665228661709335,0.4925923823579497
47091,"Johnson County, Tennessee",17923,9618,8305,19183,13422,867,386,73,29,16087,1032,1005,2037,4313,2017,2296,5616,99,6.59,84,2.7227584667745357,24.064051777046252,488,89.75617921106958,31.33404006025777,0.5366289125704402
47093,"Knox County, Tennessee",448164,217833,230331,30541,297488,64540,26673,7863,7011,444681,24095,19978,44073,70612,31822,38790,214673,1234,9.41,91.4,9.270490266955846,15.755839380226881,41547,99.22282914290304,47.900545336082324,0.48605644362331646
47095,"Lake County, Tennessee",7643,4823,2820,14232,5685,329,168,20,2,4927,394,247,641,1413,588,825,1734,13,10.33,90.5,2.4859348423393954,18.487504906450347,190,64.4642156221379,22.6874264032448,0.6310349339264687
47097,"Lauderdale County, Tennessee",27261,14248,13013,17178,18415,987,394,156,42,24378,1794,1500,3294,6014,2726,3288,8846,46,11.94,90.7,2.1716004548622574,22.06081948571219,592,89.42445251458128,32.449286526539744,0.5226514067715784
47099,"Lawrence County, Tennessee",42406,20841,21565,19879,28517,1947,962,373,48,41965,3404,3399,6803,8136,3430,4706,15957,174,7.83,90.9,3.2613309437343774,19.185964250341932,1383,98.96005282271376,37.629109088336556,0.49146347215016745
47101,"Lewis County, Tennessee",11907,5904,6003,20099,8397,724,208,60,41,11688,879,840,1719,2384,1162,1222,4779,152,8.32,90.9,2.5951121189216426,20.02183589485177,309,98.1607457797934,40.136054421768705,0.4958427815570673
47103,"Lincoln County, Tennessee",33582,16438,17144,24029,23553,2715,1196,119,93,33236,1975,1639,3614,6123,2906,3217,13563,95,7.4,91.7,4.192722291703889,18.232981954618545,1408,98.96968614138527,40.38770770055387,0.4894884164135549
47105,"Loudon County, Tennessee",50637,24646,25991,30177,37123,5784,2537,552,547,50256,2974,2857,5831,6767,3070,3697,19391,114,8.93,91.8,7.18052017299603,13.36374587752039,3636,99.24758575745008,38.294132748780534,0.48671919742480796
47107,"McMinn County, Tennessee",52606,25618,26988,21583,36650,3260,1239,282,233,51757,3398,2628,6026,10012,4441,5571,20132,75,7.9,92.7,3.334220431129529,19.032049576093982,1754,98.38611565220697,38.269398927878946,0.48697867163441433
47109,"McNairy County, Tennessee",26057,12734,13323,19745,18163,1375,423,89,102,25710,1783,1694,3477,5916,2663,3253,8926,104,7.33,92.8,2.3563725678320604,22.704071842499136,614,98.66830410254443,34.25567026135012,0.4886978547031508
47111,"Macon County, Tennessee",22924,11376,11548,20666,15384,797,407,145,70,22591,1502,1104,2606,4167,1942,2225,9314,37,9.91,88.4,2.7133135578433083,18.177455941371488,622,98.54737393125109,40.62990752050253,0.49624847321584364
47113,"Madison County, Tennessee",98128,46518,51610,24600,64505,10982,3455,952,1083,96919,5666,4642,10308,18345,7718,10627,42124,1140,12.43,91.8,5.594733409424426,18.69496983531714,5490,98.76793575737811,42.92760476112832,0.47405429642915375
47115,"Marion County, Tennessee",28363,13843,14520,23807,20200,1621,673,140,60,28042,1664,1564,3228,5374,2285,3089,11475,62,7.8,88.8,3.0779536720375136,18.947219969678805,873,98.86824383880408,40.45763847265804,0.48806543736558194
47117,"Marshall County, Tennessee",31335,15380,15955,23920,21409,2260,549,136,59,31008,1826,1764,3590,4655,1928,2727,13288,92,6.47,91.7,2.3743417903303015,14.85559278761768,744,98.9564384873145,42.40625498643689,0.49082495611935534
47119,"Maury County, Tennessee",85767,41287,44480,25872,58817,7696,2751,783,276,84594,4987,4413,9400,12413,5618,6795,38445,401,7.44,91.9,4.442268005176817,14.47293247985822,3810,98.63234111021721,44.824932666410156,0.48138561451374073
47121,"Meigs County, Tennessee",11804,5828,5976,22542,8500,392,220,124,14,11670,647,667,1314,2160,835,1325,3878,46,8.2,92.6,3.0328702134869534,18.298881735005082,358,98.86479159606913,32.85327007793968,0.49373093866485934
47123,"Monroe County, Tennessee",45482,22698,22784,20353,31986,2572,912,292,111,44969,3093,2615,5708,8575,3881,4694,16225,190,7.86,90,2.8912536827756035,18.853612418099466,1315,98.87208126291719,35.673453234246516,0.4990545710390924
47125,"Montgomery County, Tennessee",189709,94948,94761,24827,115734,20011,7275,1122,908,175756,9575,8628,18203,28232,12255,15977,85552,882,10.06,91.2,4.9048806329694425,14.881739927994982,9305,92.6450511045865,45.096437174830925,0.5004928601173376
47127,"Moore County, Tennessee",6314,3093,3221,31479,4645,542,177,48,33,6228,253,332,585,644,218,426,2835,0,7.47,90.9,4.08615774469433,10.199556541019955,258,98.63794741843522,44.90022172949002,0.4898637947418435
47129,"Morgan County, Tennessee",21688,12087,9601,18649,15533,725,359,30,44,18836,1259,1011,2270,4415,2156,2259,6726,150,8.94,88,1.9964957580228697,20.35687938030247,433,86.84987089634821,31.01254149760236,0.557312799704906
47131,"Obion County, Tennessee",30900,14833,16067,21939,21585,2164,1046,256,112,30481,2131,2064,4195,6399,2889,3510,12179,208,10.47,90.2,4.576051779935275,20.70873786407767,1414,98.64401294498381,39.41423948220065,0.48003236245954695
47133,"Overton County, Tennessee",22090,10963,11127,19961,15393,1381,529,154,67,21812,1430,1045,2475,4340,2088,2252,8679,32,7.61,87.9,3.3952014486192845,19.646899049343595,750,98.74151199637845,39.28927116342236,0.4962879130828429
47135,"Perry County, Tennessee",7891,3988,3903,20204,5545,394,119,16,16,7749,676,631,1307,2216,984,1232,2666,119,7.13,91.6,1.9135724242808263,28.082625776200736,151,98.20048156127234,33.78532505385883,0.5053858826511215
47137,"Pickett County, Tennessee",5096,2531,2565,21300,3868,153,92,100,12,5002,363,283,646,827,337,490,1894,0,7.83,88.2,4.003139717425432,16.228414442700156,204,98.15541601255887,37.16640502354788,0.4966640502354788
47139,"Polk County, Tennessee",16697,8330,8367,24247,12014,759,310,75,19,16463,932,839,1771,2918,1401,1517,6350,42,6.6,91.2,2.419596334670899,17.47619332814278,404,98.59855063783914,38.03078397316883,0.49889201652991555
47141,"Putnam County, Tennessee",74652,36847,37805,23337,47571,7570,2631,623,775,73863,5308,3884,9192,17180,7807,9373,31185,144,7.95,87.9,5.397042276161389,23.013449070353104,4029,98.9430959652789,41.773830573862725,0.49358356105663614
47143,"Rhea County, Tennessee",32461,15970,16491,22031,22010,1791,854,179,77,32091,1768,1606,3374,7160,3160,4000,13165,82,8.86,90.5,3.4194880009857984,22.057237916268754,1110,98.86017066633806,40.55635993961985,0.49197498536705586
47145,"Roane County, Tennessee",52983,26121,26862,25555,38763,4435,2089,348,407,52377,2752,2378,5130,8449,3975,4474,20493,87,9.11,91.7,5.367759470018685,15.946624388954948,2844,98.85623690617746,38.67844402921692,0.4930071909857879
47147,"Robertson County, Tennessee",67905,33429,34476,26441,45660,5565,2130,306,278,67076,4136,2800,6936,7067,3138,3929,31454,499,10.02,90.6,3.9967601796627643,10.407186510566232,2714,98.77917679110521,46.320594948825565,0.49229070024298655
47149,"Rutherford County, Tennessee",290289,143078,147211,27932,179453,38281,11676,2400,1895,287993,17892,14163,32055,35764,16454,19310,145141,711,7.39,90.8,5.501758592299399,12.320136140191327,15971,99.20906407063306,49.99879430498572,0.4928812321514077
47151,"Scott County, Tennessee",22029,10865,11164,18748,14804,674,392,180,74,21704,1485,1313,2798,6000,2677,3323,7602,263,8.76,86.5,2.9324980707249533,27.236824186299877,646,98.52467202324209,34.50905624404194,0.4932134913069136
47153,"Sequatchie County, Tennessee",14710,7292,7418,22744,10344,826,310,112,122,14484,725,799,1524,2328,1001,1327,5676,8,8.36,87.8,3.698164513936098,15.825968728755948,544,98.4636301835486,38.58599592114208,0.4957171991842284
47155,"Sevier County, Tennessee",94537,46406,48131,23298,66646,7320,3173,779,414,93634,8855,8268,17123,14285,6273,8012,44170,173,6.55,87.2,4.618297597765954,15.110485841522367,4366,99.04481843087892,46.72244729576779,0.490876588002581
47157,"Shelby County, Tennessee",936990,446704,490286,28117,602898,112670,47897,13163,8162,924508,70319,56072,126391,196471,87994,108477,420644,5091,15.49,92.1,7.3876989082060645,20.968313429172138,69222,98.66786198358574,44.893115187995605,0.47674361519333186
47159,"Smith County, Tennessee",19176,9524,9652,23015,13105,831,365,121,88,18945,967,872,1839,3050,1369,1681,8133,31,8.36,89.7,2.9933249895702962,15.905298289528577,574,98.7953692115144,42.41239048811014,0.4966624947851481
47161,"Stewart County, Tennessee",13257,6479,6778,22680,9370,743,342,89,48,13046,737,636,1373,2520,1097,1423,4814,70,10.92,89.8,3.6131854869125744,19.008825526137134,479,98.40838802142264,36.312891302708,0.4887229388247718
47163,"Sullivan County, Tennessee",156644,75878,80766,25946,113116,14814,6516,1488,1345,154992,9265,7242,16507,25982,11907,14075,64978,451,5.85,89.4,5.968310308725518,16.586655090523735,9349,98.94537933147775,41.481320701718545,0.48439774265212837
47165,"Sumner County, Tennessee",172786,84479,88307,30669,116882,20190,7107,1699,927,171238,8947,7476,16423,16543,6972,9571,83075,700,10.66,89.4,5.6329795238040115,9.57427106362784,9733,99.10409408169643,48.07970553169817,0.4889227136457815
47167,"Tipton County, Tennessee",61558,30403,31155,26110,40282,3828,2016,378,69,60678,3964,2827,6791,8378,3688,4690,26989,119,13.45,90.9,4.001104649273856,13.60992884759089,2463,98.57045388089281,43.843204782481564,0.49389193930926933
47169,"Trousdale County, Tennessee",7970,4001,3969,22863,5339,521,207,54,8,7879,648,321,969,1043,450,593,3467,0,9.72,89.4,3.3751568381430364,13.086574654956085,269,98.85821831869511,43.500627352572145,0.5020075282308657
47171,"Unicoi County, Tennessee",17945,8919,9026,21374,13264,1039,405,126,98,17600,1202,844,2046,3687,1554,2133,6636,272,6.66,85.6,3.5051546391752577,20.54611312343271,629,98.07745890220117,36.97966007244358,0.49701866815268875
47173,"Union County, Tennessee",19081,9506,9575,20478,13326,870,369,59,28,18913,1223,1073,2296,4420,1866,2554,6714,25,9.09,89.3,2.389811854724595,23.164404381321734,456,99.11954300089094,35.18683507153713,0.49819191866254386
47175,"Van Buren County, Tennessee",5641,2835,2806,20672,4111,250,157,51,25,5540,344,333,677,1058,531,527,2125,25,8.02,87.2,4.130473320333274,18.755539797908174,233,98.20953731607871,37.67062577557171,0.5025704662293919
47177,"Warren County, Tennessee",40099,19775,20324,21339,27349,2095,1060,327,119,39588,3037,2002,5039,8158,3872,4286,16437,74,8.16,88.7,3.7557046310381805,20.34464699867827,1506,98.72565400633432,40.99104715828325,0.4931544427541834
47179,"Washington County, Tennessee",126044,61224,64820,27334,85711,15482,7287,1680,2003,124245,7016,6740,13756,20810,9062,11748,57340,1004,5.88,90.4,8.70330995525372,16.510107581479485,10970,98.5727206372378,45.49205039510012,0.4857351401098029
47181,"Wayne County, Tennessee",16842,9338,7504,18702,12371,785,303,127,102,14790,907,878,1785,2796,1345,1451,5968,228,7.05,91.1,3.1587697423108896,16.60135375846099,532,87.81617385108657,35.43522147013419,0.5544472152950956
47183,"Weakley County, Tennessee",34024,16549,17475,19699,21485,2898,1140,212,286,33592,1862,1287,3149,5962,2608,3354,13881,151,9.75,90.8,4.81424876557724,17.522924994121798,1638,98.73030801786975,40.79767223136609,0.4863919586174465
47185,"White County, Tennessee",26373,12880,13493,19867,18599,1428,560,107,97,25972,1706,1625,3331,4662,2250,2412,9424,95,7.78,88.1,2.896902134759034,17.67716983278353,764,98.47950555492359,35.73351533765594,0.4883782656504759
47187,"Williamson County, Tennessee",205645,100438,105207,48482,133044,48304,19337,4407,3229,205114,5607,5005,10612,10547,4365,6182,100255,1199,6.42,91.4,13.116292640229522,5.128741277444139,26973,99.74178803277493,48.75148921685429,0.48840477521943154
47189,"Wilson County, Tennessee",125616,61321,64295,31155,85573,17100,5580,1193,824,124597,5424,4556,9980,11266,4244,7022,60090,492,7.79,89.9,6.047796459049803,8.968602725767418,7597,99.18879760540058,47.836262896446314,0.48816233600815184
48001,"Anderson County, Texas",57772,35381,22391,17466,41841,3152,1353,115,304,44462,3377,3611,6988,7561,3435,4126,19239,95,10.38,96.5,3.067229799903067,13.087654919338087,1772,76.96115765422697,33.301599390708304,0.6124247040088624
48003,"Andrews County, Texas",17215,8734,8481,29903,10197,754,228,20,83,17118,1306,1367,2673,1821,757,1064,7849,35,5.11,99.8,1.9227417949462677,10.577984316003485,331,99.43653790299157,45.593958756898054,0.5073482428115016
48005,"Angelina County, Texas",87657,42765,44892,21974,56749,5877,2308,487,215,85415,8203,7965,16168,16688,7316,9372,34747,293,8.11,95.2,3.4338387122534426,19.037840674446993,3010,97.44230352396272,39.63973213776424,0.4878674834867723
48007,"Aransas County, Texas",24729,12246,12483,29999,18302,2337,919,283,156,24313,2247,2082,4329,4124,1986,2138,9356,43,9.37,91.9,5.491528165311982,16.67677625459986,1358,98.31776456791621,37.834121881192125,0.49520805531966516
48009,"Archer County, Texas",8750,4344,4406,31103,6090,1017,259,45,7,8677,571,515,1086,704,307,397,4259,44,7.12,98.1,3.5542857142857143,8.045714285714286,311,99.16571428571429,48.674285714285716,0.4964571428571429
48011,"Armstrong County, Texas",1913,973,940,31219,1359,213,88,5,8,1845,88,38,126,177,73,104,915,2,5.89,97,5.279665446941976,9.252483010977523,101,96.44537375849451,47.830632514375324,0.5086251960271825
48013,"Atascosa County, Texas",47710,23760,23950,23973,30060,2788,1213,228,61,47223,4385,4302,8687,7208,2980,4228,19500,15,9.04,99.7,3.1481869629008594,15.107943827289876,1502,98.97924963320058,40.87193460490463,0.4980088031859149
48015,"Austin County, Texas",29107,14358,14749,30101,19665,2901,987,117,123,28847,2215,2534,4749,4163,1520,2643,13278,177,12.92,96.3,4.215480812175765,14.302401484179063,1227,99.10674408217955,45.617892603153884,0.49328340261792697
48017,"Bailey County, Texas",7131,3787,3344,18662,4317,333,90,9,32,6974,1070,985,2055,1322,520,802,3151,192,6.09,97.7,1.8370495021736082,18.538774365446642,131,97.79834525312017,44.18735100266442,0.5310615621932407
48019,"Bandera County, Texas",21015,10420,10595,29177,15999,2504,867,159,316,20818,1601,1504,3105,3409,1727,1682,8473,45,7.75,95,6.385914822745658,16.221746371639306,1342,99.06257435165358,40.318819890554366,0.49583630739947654
48021,"Bastrop County, Texas",78286,39861,38425,25172,51873,6482,1991,465,587,76165,7312,7337,14649,10350,4690,5660,31923,201,9.76,97.7,3.8870296093809875,13.22075466877858,3043,97.29070331860103,40.777405921876195,0.5091714993740899
48023,"Baylor County, Texas",3639,1759,1880,30820,2625,546,123,14,15,3562,368,288,656,452,154,298,1423,17,5.9,98.8,4.176971695520748,12.420994778785381,152,97.88403407529542,39.10414949161858,0.48337455344874963
48025,"Bee County, Texas",32706,19761,12945,17504,22211,1194,484,128,172,25172,2587,3139,5726,5121,2326,2795,10092,104,5.51,96.9,2.3971136794471963,15.657677490368739,784,76.96447135082248,30.856723536965696,0.6042010640249496
48027,"Bell County, Texas",330859,165045,165814,25017,198709,30282,10889,3259,1747,308757,20472,19680,40152,47165,21421,25744,147488,1017,9.96,97.4,4.8041612892501036,14.255317219721997,15895,93.31981297168885,44.57729727769231,0.49883787353525216
48029,"Bexar County, Texas",1858699,915173,943526,26158,1171084,201468,80858,20598,12404,1828044,159943,148733,308676,313406,142070,171336,850829,6993,8.16,97.8,6.125790136003731,16.861578986161827,113860,98.3507281168172,45.775512872175646,0.49237289093069936
48031,"Blanco County, Texas",10918,5501,5417,31249,8123,1458,576,193,110,10805,910,1048,1958,1045,498,547,4661,51,6.61,96.4,8.050925077853087,9.571350064114307,879,98.96501190694266,42.690969041949074,0.5038468583989741
48033,"Borden County, Texas",698,374,324,38923,460,117,46,5,0,698,13,14,27,18,6,12,281,0,4.74,99.1,7.306590257879656,2.5787965616045847,51,100,40.25787965616046,0.5358166189111748
48035,"Bosque County, Texas",17953,8845,9108,25763,12788,1599,535,73,54,17592,1869,1765,3634,2599,1153,1446,7058,52,7.96,96,3.6874060045674817,14.476689132735476,662,97.98919400657272,39.313763716370524,0.4926753188882081
48037,"Bowie County, Texas",93483,47076,46407,24761,62830,7846,2771,823,350,88111,7349,7308,14657,17166,7480,9686,35977,433,8.45,95.4,4.218948899799964,18.36269696094477,3944,94.25350063647936,38.48507215215601,0.5035781906870768
48039,"Brazoria County, Texas",338419,171456,166963,32343,218876,40289,15788,3745,3048,327859,24860,24639,49499,34248,15269,18979,155872,1156,9.66,93.3,6.672497702552161,10.119999172623286,22581,96.87960782343781,46.05887967283161,0.5066382206672794
48041,"Brazos County, Texas",209896,106391,103505,25337,107109,22975,11353,2392,5885,206103,15578,13464,29042,52652,25257,27395,98853,649,13.66,96,9.352250638411403,25.084803902885238,19630,98.1929145862713,47.09618096581164,0.5068748332507528
48043,"Brewster County, Texas",9188,4363,4825,26073,6541,1365,760,73,156,9104,849,805,1654,1023,414,609,4261,45,4.54,97.7,10.764040052242056,11.134087940792337,989,99.08576404005224,46.37570744449282,0.4748585111014367
48045,"Briscoe County, Texas",1672,849,823,23199,1150,208,44,7,5,1672,181,176,357,239,113,126,739,5,4.41,97.7,3.349282296650718,14.294258373205741,56,100,44.198564593301434,0.5077751196172249
48047,"Brooks County, Texas",7217,3706,3511,13549,4218,409,189,0,16,6800,846,755,1601,2358,1200,1158,2477,2,4.56,100.1,2.8405154496328113,32.67285575723985,205,94.22197589025912,34.32174033531938,0.5135097686019121
48049,"Brown County, Texas",37935,18756,19179,24040,25646,3334,1018,236,163,36856,3015,2419,5434,6390,2829,3561,14782,69,7.92,98,3.7353367602477925,16.844602609727165,1417,97.15566099907737,38.96665348622644,0.4944246737841044
48051,"Burleson County, Texas",17417,8687,8730,27112,12083,1152,490,83,63,17239,1526,1905,3431,2329,1017,1312,7182,9,13.47,96.4,3.6516047539760006,13.371992880519032,636,98.97800999023941,41.23557443876672,0.498765573864615
48053,"Burnet County, Texas",44584,22025,22559,29247,31066,4851,1828,240,227,44235,3531,3478,7009,6346,3091,3255,18961,129,8.9,97.7,5.147586578144626,14.233805849632155,2295,99.21720796698366,42.528709851067646,0.4940113045038579
48055,"Caldwell County, Texas",39848,20019,19829,23366,25450,2651,896,103,92,37894,4356,3562,7918,7014,3544,3470,17272,265,7.28,98.4,2.73790403533427,17.601887171250752,1091,95.0963661915278,43.34470989761092,0.5023840594258181
48057,"Calhoun County, Texas",21805,11039,10766,26909,14466,1443,628,109,50,21608,1739,1834,3573,3914,1826,2088,9574,90,7.53,92,3.6092639302912177,17.95001146526026,787,99.09653749140105,43.907360697087825,0.5062600321027287
48059,"Callahan County, Texas",13596,6528,7068,22205,9508,967,329,80,23,13509,1515,1515,3030,2424,980,1444,5050,3,9.8,97.2,3.177405119152692,17.828773168578994,432,99.36010591350397,37.14327743453957,0.4801412180052957
48061,"Cameron County, Texas",418785,202517,216268,16085,241653,28922,8241,2286,1086,416158,60464,66499,126963,136809,62680,74129,147810,2353,5.02,96.7,2.7730219563737957,32.668075504136965,11613,99.37270914669818,35.294960421218526,0.48358226775075513
48063,"Camp County, Texas",12631,6191,6440,21069,8178,826,306,85,9,12565,1076,1137,2213,2422,1058,1364,5159,55,10.96,95.6,3.1668118122080595,19.1750455229198,400,99.47747605098567,40.84395534795345,0.4901432982345024
48065,"Carson County, Texas",6027,2846,3181,31788,4007,662,338,9,50,5983,344,390,734,351,145,206,2822,0,5.23,96.1,6.587025053924009,5.823792931806869,397,99.2699518831923,46.82263149162104,0.47220839555334326
48067,"Cass County, Texas",30346,14694,15652,22145,21302,2180,762,117,18,29920,2426,2552,4978,5736,2383,3353,11839,369,11,95,2.955908521716206,18.901996968298953,897,98.59619060172675,39.013379028537535,0.4842153825874909
48069,"Castro County, Texas",7875,4002,3873,22292,4702,429,137,32,19,7780,1340,1061,2401,1256,574,682,3170,40,3.77,96.3,2.3873015873015873,15.94920634920635,188,98.7936507936508,40.25396825396825,0.5081904761904762
48071,"Chambers County, Texas",38072,18954,19118,31412,24206,3497,1400,98,121,37872,3119,3128,6247,4411,2063,2348,15729,352,9.31,92.6,4.252469006093717,11.585942424879176,1619,99.47467955452827,41.31382643412481,0.49784618617356585
48073,"Cherokee County, Texas",51257,26069,25188,21102,33344,4149,1207,233,199,48854,4853,4910,9763,10570,4754,5816,19619,148,8.88,95.9,3.197612033478354,20.621573638722516,1639,95.31185984353357,38.275747702752795,0.5085939481436682
48075,"Childress County, Texas",7059,3954,3105,18694,4771,495,242,0,5,5880,499,406,905,1342,567,775,2456,0,6.48,98.8,3.4990791896869244,19.011191386881993,247,83.2979175520612,34.79246352174529,0.560135996600085
48077,"Clay County, Texas",10367,5177,5190,27593,7406,885,272,22,30,10289,785,875,1660,1575,791,784,4430,45,7.97,96.7,3.1253014372528214,15.192437542201215,324,99.24761261695765,42.731744959969134,0.49937301051413135
48079,"Cochran County, Texas",2955,1512,1443,19195,1845,99,50,26,0,2914,441,370,811,569,252,317,1180,8,6.34,98.6,2.571912013536379,19.255499153976313,76,98.61252115059222,39.93231810490694,0.5116751269035533
48081,"Coke County, Texas",3228,1682,1546,24623,2382,361,99,10,18,3115,264,238,502,534,260,274,1465,17,5.75,98.5,3.9343246592317223,16.54275092936803,127,96.4993804213135,45.38413878562577,0.5210656753407683
48083,"Coleman County, Texas",8476,4277,4199,26436,6067,586,158,62,56,8440,1042,1011,2053,1545,541,1004,3313,43,8.21,98.5,3.2562529495044834,18.227937706465315,276,99.57527135441246,39.08683341198679,0.504601226993865
48085,"Collin County, Texas",886633,435186,451447,41609,574718,185636,80151,13923,8861,883650,54120,50410,104530,62651,28576,34075,452343,4217,8.16,95.1,11.609651343904412,7.066170557603879,102935,99.66355865391881,51.0180649716399,0.49082991497045564
48087,"Collingsworth County, Texas",3032,1537,1495,21356,2038,235,95,6,11,2964,357,270,627,582,203,379,1319,3,5.62,97,3.6939313984168867,19.195250659630606,112,97.75725593667546,43.50263852242744,0.5069261213720316
48089,"Colorado County, Texas",20792,10306,10486,26689,14303,1978,441,115,96,20446,1749,1631,3380,2854,1290,1564,9010,5,10.42,96.9,3.1358214697960753,13.726433243555213,652,98.33589842247018,43.33397460561755,0.49567141208156984
48091,"Comal County, Texas",124234,61175,63059,35841,86147,19803,7665,1177,1088,123157,8896,8165,17061,11356,4790,6566,55913,635,6.94,96.7,7.992980987491347,9.140814913791715,9930,99.13308756057118,45.00619798122897,0.4924175346523496
48093,"Comanche County, Texas",13506,6708,6798,22751,9350,1135,333,51,71,13298,1499,1618,3117,2825,1305,1520,5286,58,9.31,97.4,3.3688730934399524,20.916629646083223,455,98.45994372871317,39.13816081741448,0.49666814749000443
48095,"Concho County, Texas",4142,2851,1291,17513,3107,251,79,14,13,2756,220,235,455,293,97,196,1048,0,6.03,98.8,2.5591501690004828,7.073877353935297,106,66.53790439401256,25.301786576533075,0.6883148237566393
48097,"Cooke County, Texas",38878,19299,19579,29067,25977,3776,1395,349,91,38363,3086,3113,6199,5726,2511,3215,17677,120,7.09,94.9,4.71989299861104,14.728123874684911,1835,98.67534338186121,45.46787386182417,0.4963989917176809
48099,"Coryell County, Texas",75710,37638,38072,21171,46747,5032,1681,301,67,58144,2870,3062,5932,8697,3472,5225,30741,397,10.07,97.5,2.7063796063928147,11.48725399550918,2049,76.79830933826443,40.603619072777704,0.4971338000264166
48101,"Cottle County, Texas",1560,763,797,20566,1088,125,39,9,3,1560,169,128,297,388,156,232,638,24,5.83,99.5,3.269230769230769,24.871794871794872,51,100,40.8974358974359,0.4891025641025641
48103,"Crane County, Texas",4823,2462,2361,24582,2936,261,91,26,0,4724,356,449,805,550,236,314,1986,21,4.9,101,2.4258760107816713,11.403690648973669,117,97.94733568318475,41.177690234294005,0.5104706614140576
48105,"Crockett County, Texas",3836,1894,1942,23296,2508,201,58,7,11,3753,365,442,807,851,332,519,1752,0,4.13,96.7,1.981230448383733,22.18456725755996,76,97.83628779979145,45.6725755995829,0.4937434827945777
48107,"Crosby County, Texas",5987,2908,3079,20057,3835,376,73,10,4,5893,557,719,1276,1177,499,678,2427,75,3.6,97.5,1.453148488391515,19.659261733756473,87,98.42993151828962,40.53783196926675,0.48571905795891096
48109,"Culberson County, Texas",2259,1168,1091,16763,1515,84,20,1,11,2248,269,185,454,535,229,306,1033,39,4.54,98.2,1.416555998229305,23.683045595396194,32,99.51305887560868,45.728198317839755,0.5170429393536963
48111,"Dallam County, Texas",7052,3730,3322,25221,4106,413,72,0,1,7010,866,881,1747,1129,496,633,3408,36,4.63,97.1,1.0351673284174703,16.00964265456608,73,99.40442427680091,48.32671582529779,0.5289279636982417
48113,"Dallas County, Texas",2513054,1238199,1274855,29810,1590088,301964,121728,33892,14405,2492805,306970,271043,578013,461045,205849,255196,1199288,21186,6.97,96.1,6.765672365177987,18.346004502887723,170025,99.19424731820327,47.72233306566433,0.49270688174627364
48115,"Dawson County, Texas",13317,7478,5839,21360,8601,806,255,13,12,11465,1082,1307,2389,1866,630,1236,4741,38,4.92,99,2.1025756551775925,14.012164902004956,280,86.09296388075393,35.601111361417736,0.561537883907787
48117,"Deaf Smith County, Texas",19039,9478,9561,21209,11128,1190,303,58,30,18835,1839,1760,3599,3235,1382,1853,8348,26,4.57,97.2,2.05367928987867,16.991438625978255,391,98.92851515310679,43.84684069541468,0.49782026366931037
48119,"Delta County, Texas",5226,2543,2683,22732,3631,462,185,0,27,5153,404,459,863,1110,464,646,1869,20,11.09,97.1,4.0566398775354,21.23995407577497,212,98.60313815537697,35.76349024110218,0.4866054343666284
48121,"Denton County, Texas",754650,371110,383540,37928,484647,140442,50188,7740,5994,750044,50537,49508,100045,64613,28257,36356,394108,3418,6.22,95.5,8.470416749486517,8.561982375935864,63922,99.38965083151129,52.22394487510766,0.49176439408997547
48123,"DeWitt County, Texas",20660,10847,9813,28116,14529,1579,441,15,89,18868,1466,1328,2794,3038,1400,1638,7668,64,5.92,97.7,2.6379477250726042,14.704743465634076,545,91.32623426911907,37.115198451113265,0.5250242013552759
48125,"Dickens County, Texas",2237,1160,1077,24171,1629,159,60,0,14,2067,187,251,438,391,156,235,733,39,4.12,98.6,3.308001788109075,17.478766204738488,74,92.40053643272239,32.76709879302638,0.5185516316495307
48127,"Dimmit County, Texas",10842,5243,5599,17939,6563,402,249,39,0,10741,1736,1337,3073,2504,951,1553,3893,32,4.92,102.1,2.6563364692861096,23.095369857959785,288,99.06843755764619,35.906659287954255,0.4835823648773289
48129,"Donley County, Texas",3506,1785,1721,23212,2300,259,115,4,2,3448,406,217,623,481,201,280,1471,3,7.35,96.3,3.451226468910439,13.719338277239018,121,98.34569309754706,41.95664575014261,0.5091272104962921
48131,"Duval County, Texas",11510,5882,5628,19085,7509,430,217,11,9,11003,1379,1668,3047,2675,1126,1549,3979,39,3.9,99.7,2.059079061685491,23.24066029539531,237,95.59513466550825,34.56993918331885,0.5110338835794961
48133,"Eastland County, Texas",18252,9045,9207,20433,12327,1286,425,58,28,17978,2217,1686,3903,3054,1467,1587,6786,43,10.83,97.4,2.799693184308569,16.73241288625904,511,98.49879465264081,37.17948717948718,0.49556213017751477
48135,"Ector County, Texas",153177,77333,75844,27728,90546,9817,2857,741,307,151759,17214,18094,35308,18777,8003,10774,70346,218,3.59,100.3,2.5493383471408895,12.258367770618305,3905,99.07427355281798,45.924649261964916,0.5048603902674683
48137,"Edwards County, Texas",2028,935,1093,28968,1452,309,19,0,20,2015,174,166,340,156,100,56,924,29,6.03,96.2,1.9230769230769231,7.6923076923076925,39,99.35897435897436,45.562130177514796,0.46104536489151876
48139,"Ellis County, Texas",160225,79024,81201,28612,101769,15912,5045,786,592,158933,13730,12715,26445,17458,7966,9492,74611,328,6.87,96,4.008737712591668,10.895927601809955,6423,99.19363395225464,46.566391012638476,0.49320642845997814
48141,"El Paso County, Texas",833592,408310,425282,19950,499096,74860,25084,5120,3167,807800,92758,99160,191918,183925,80398,103527,345010,6105,4.26,100.8,4.00327738270041,22.064151287440378,33371,96.90592040230712,41.38835305521166,0.48981995988445187
48143,"Erath County, Texas",40641,19969,20672,23511,23046,4448,1489,340,221,40139,4199,3906,8105,9500,3622,5878,19028,66,10.2,95.9,5.044167220294776,23.37540906965872,2050,98.76479417337171,46.81971408183854,0.49135109864422627
48145,"Falls County, Texas",17265,8234,9031,17755,11869,1050,280,40,38,15473,1713,1207,2920,3756,1903,1853,5828,106,7.57,96.9,2.0735592238633074,21.754995655951348,358,89.62061975094122,33.756154068925575,0.4769186214885607
48147,"Fannin County, Texas",33757,17824,15933,23212,23710,2294,1070,71,271,30825,2841,2572,5413,5078,2474,2604,12875,124,8.17,96.8,4.182836152501704,15.042805936546493,1412,91.31439405160411,38.140237580353705,0.5280090055395917
48149,"Fayette County, Texas",24909,12292,12617,30405,17803,2277,544,132,90,24469,1543,1959,3502,2630,1054,1576,11259,126,9.9,97.4,3.075193705086515,10.558432695009836,766,98.23357019551166,45.20052992894135,0.4934762535629692
48151,"Fisher County, Texas",3847,1807,2040,27750,2717,374,111,13,3,3822,364,349,713,752,295,457,1676,15,5.09,99.8,3.301273719781648,19.547699506108657,127,99.35014296854692,43.5664153886145,0.46971666233428644
48153,"Floyd County, Texas",6088,2961,3127,24347,3923,505,112,9,17,6041,764,625,1389,1330,572,758,2452,15,4.65,96.3,2.266754270696452,21.846254927726676,138,99.22798948751642,40.27595269382392,0.48636662286465177
48155,"Foard County, Texas",1320,642,678,26034,954,114,39,0,0,1284,86,100,186,89,52,37,533,0,5.21,99.5,2.9545454545454546,6.742424242424242,39,97.27272727272727,40.378787878787875,0.4863636363636364
48157,"Fort Bend County, Texas",683756,335925,347831,38382,434436,122699,52399,9182,9655,678500,45558,43563,89121,55523,24871,30652,319775,3244,10.55,95,10.418336365604105,8.120294374016462,71236,99.23130473443743,46.76741410678663,0.49129367786169337
48159,"Franklin County, Texas",10571,5369,5202,23642,7258,953,357,25,43,10460,1196,990,2186,1759,920,839,4231,39,10.76,96.5,4.020433260807871,16.63986377826128,425,98.94995743070665,40.02459559171318,0.5078989688771166
48161,"Freestone County, Texas",19585,10246,9339,24060,13673,1156,344,47,27,17974,1553,1852,3405,2988,1273,1715,7467,43,8.16,96.1,2.1342864437069187,15.256573908603523,418,91.77431707939749,38.12611692621905,0.523155476129691
48163,"Frio County, Texas",18542,10950,7592,16833,11103,655,153,0,0,15660,1772,2074,3846,3333,1562,1771,6648,42,7,100.9,0.8251537051019308,17.97540718369108,153,84.45690863984467,35.85373746089958,0.5905511811023622
48165,"Gaines County, Texas",19485,9940,9545,22656,10771,770,302,44,12,19371,3188,3135,6323,2076,1073,1003,7923,23,8.04,99,1.8373107518604055,10.654349499615089,358,99.41493456505003,40.662047729022326,0.5101360020528611
48167,"Galveston County, Texas",314485,155271,159214,33870,209066,39256,13771,4349,3103,309976,24641,22867,47508,41948,18648,23300,143505,1669,8.71,91.2,6.748493568850661,13.338633003163903,21223,98.56622732403771,45.631747142153046,0.4937310205574193
48169,"Garza County, Texas",6614,4213,2401,20635,4782,330,69,15,6,4650,497,486,983,624,301,323,2181,40,5.54,99.9,1.360749924402782,9.434532809192621,90,70.3054127608104,32.97550650136075,0.6369821590565468
48171,"Gillespie County, Texas",25732,12550,13182,32557,18862,4505,1282,477,177,25321,2488,2110,4598,2725,1445,1280,11099,170,6.83,95.2,7.523705891496968,10.589926939219648,1936,98.40276698274522,43.13306388932069,0.487719570962226
48173,"Glasscock County, Texas",1253,670,583,32885,821,171,31,3,2,1253,165,105,270,66,25,41,533,0,4.19,98.4,2.873104549082203,5.267358339984038,36,100,42.53790901835595,0.5347166799680766
48175,"Goliad County, Texas",7463,3754,3709,30075,5240,544,234,34,26,7359,383,436,819,1246,636,610,2874,0,5.02,96.7,3.9394345437491625,16.695698780651213,294,98.6064585287418,38.50998258073161,0.50301487337531825
48177,"Gonzales County, Texas",20370,10296,10074,23635,13016,1287,358,46,98,20081,2192,2351,4543,3443,1505,1938,8681,83,6.95,98,2.464408443789887,16.90230731467845,502,98.5812469317624,42.61659302896416,0.5054491899852724
48179,"Gray County, Texas",23028,12142,10886,23457,15367,1557,412,75,43,21442,1942,2093,4035,3359,1415,1944,9179,106,5.23,95.6,2.301545944068091,14.586590237971166,530,93.11273232586417,39.86017022754907,0.5272711481674484
48181,"Grayson County, Texas",124231,60695,63536,26535,83432,11028,4413,660,745,122860,11034,10412,21446,18877,8702,10175,54385,510,6.1,94.9,4.683211114778115,15.195080132978081,5818,98.8964107187417,43.77731806070948,0.48856565591519024
48183,"Gregg County, Texas",123283,60416,62867,25144,78928,11172,3629,915,630,121233,12546,11735,24281,21785,9307,12478,54043,579,11.24,95.2,4.196847902792761,17.670725079694687,5174,98.33715921903263,43.83653869552169,0.49005945669719264
48185,"Grimes County, Texas",27140,14936,12204,23585,18708,1642,673,90,59,23784,1902,2233,4135,4819,2172,2647,10136,52,15.45,95.7,3.0287398673544583,17.756079587324983,822,87.63448784082534,37.347089167280764,0.5503316138540899
48187,"Guadalupe County, Texas",147313,72752,74561,29300,95359,16388,7482,843,602,145117,10427,10567,20994,15190,6768,8422,68535,507,7.2,98,6.059886092877071,10.31137781458527,8927,98.50929653187431,46.52338897449648,0.4938600123546462
48189,"Hale County, Texas",35007,18158,16849,19205,21158,2111,937,69,217,33206,3319,3422,6741,6740,2996,3744,14045,46,4.57,97,3.493586996886337,19.253292198703118,1223,94.85531465135544,40.12054731910761,0.5186962607478505
48191,"Hall County, Texas",3162,1585,1577,20022,2073,178,52,20,10,3099,326,437,763,889,416,473,1135,12,6.41,98.6,2.5932953826691967,28.115117014547753,82,98.00759013282732,35.89500316255535,0.5012650221378874
48193,"Hamilton County, Texas",8232,4015,4217,26522,5912,918,305,21,26,7986,882,507,1389,1174,572,602,3425,2,8.62,97,4.275996112730807,14.261418853255588,352,97.01166180758017,41.60592808551992,0.4877308066083576
48195,"Hansford County, Texas",5552,2757,2795,21989,3454,569,133,3,13,5477,536,499,1035,1096,512,584,2530,35,4.27,97,2.6837175792507204,19.740634005763688,149,98.64913544668588,45.569164265129686,0.4965778097982709
48197,"Hardeman County, Texas",3952,1934,2018,21517,2790,306,60,7,3,3938,448,365,813,606,256,350,1584,41,5.97,99.2,1.771255060728745,15.334008097165992,70,99.64574898785425,40.08097165991903,0.4893724696356275
48199,"Hardin County, Texas",55624,27484,28140,29693,37262,4203,1396,176,217,55144,4958,4767,9725,6480,2757,3723,23983,236,9.47,94.4,3.2162375952826117,11.649647634114771,1789,99.13706313821372,43.1162807421257,0.49410326477779376
48201,"Harris County, Texas",4434257,2205342,2228915,30856,2792590,538089,208416,56242,37160,4413550,511082,467739,978821,763456,342085,421371,2092412,28875,12.4,95,6.8065067045053995,17.217224892467893,301818,99.5330221049434,47.18743185160445,0.49734194477225835
48203,"Harrison County, Texas",66431,32573,33858,25123,43416,5549,1570,295,264,65764,6234,5618,11852,11499,5095,6404,27379,478,12.26,94.9,3.2048290707651548,17.309689753277837,2129,98.99595068567386,41.214192169318544,0.49032831057789283
48205,"Hartley County, Texas",5966,3596,2370,20676,4405,643,170,36,36,4446,298,301,599,326,129,197,2127,9,3.24,97.6,4.056319141803553,5.46429768689239,242,74.52229299363057,35.652028159570904,0.6027489104927924
48207,"Haskell County, Texas",5812,3236,2576,21120,4319,417,98,56,11,4869,525,418,943,1000,332,668,2204,21,7.47,100.7,2.838953888506538,17.205781142463866,165,83.77494838265658,37.921541637990366,0.5567790777701308
48209,"Hays County, Texas",185686,92221,93465,29253,109111,26571,9877,1327,1852,183896,14973,11861,26834,28863,12895,15968,91811,1191,8.35,96.8,7.031224755770494,15.543982852772961,13056,99.03600702260806,49.444223043201966,0.4966502590394537
48211,"Hemphill County, Texas",4151,1985,2166,29470,2499,486,80,5,9,4099,480,598,1078,484,202,282,1884,6,5.65,96.3,2.2645145748012525,11.659841002168152,94,98.74728980968442,45.386653818357026,0.4781980245723922
48213,"Henderson County, Texas",79213,38586,40627,24315,55294,6621,2624,276,148,78293,8135,7519,15654,14593,6431,8162,30124,168,8.27,96.2,3.8478532564099326,18.42248115839572,3048,98.8385744764117,38.029111383232554,0.4871170136215015
48215,"Hidalgo County, Texas",828334,404079,424255,15883,457280,56372,17006,4425,1843,820004,128913,141076,269989,267812,121918,145894,296433,12263,4.45,99.8,2.809736169226423,32.331402550179035,23274,98.99436700654567,35.78665127834907,0.48782133776954706
48217,"Hill County, Texas",34901,17216,17685,23342,23759,2549,980,171,112,34223,3243,3491,6734,6457,2892,3565,14042,195,7.6,95.8,3.6188074840262456,18.500902552935447,1263,98.05736225323056,40.23380418899172,0.4932809948139022
48219,"Hockley County, Texas",23377,11525,11852,22673,14277,1504,450,86,60,23206,2396,2289,4685,3540,1473,2067,10304,50,4.6,98.3,2.549514480044488,15.143089361338067,596,99.26851178508791,44.07751208452753,0.4930059460153142
48221,"Hood County, Texas",54217,26724,27493,32578,38953,6977,2388,428,244,53477,4287,4678,8965,6439,2471,3968,22129,193,7.63,95.7,5.6439862035892805,11.876348746703064,3060,98.63511444749801,40.81561133961672,0.49290812844679716
48223,"Hopkins County, Texas",35844,17592,18252,24236,23904,2623,1177,196,82,35387,3781,3753,7534,6880,2975,3905,14986,73,10.6,96.6,4.059256779377302,19.194286351969644,1455,98.72503068853922,41.808949893985044,0.4907934382323401
48225,"Houston County, Texas",22802,12225,10577,17884,16633,1787,459,92,75,19733,1578,1544,3122,4801,1857,2944,7900,97,8.47,96.5,2.7453732128760633,21.05517059907026,626,86.54065432856767,34.64608367687045,0.5361371809490395
48227,"Howard County, Texas",36423,20654,15769,22994,24500,2273,597,169,54,31343,2706,2660,5366,4646,1761,2885,14139,98,4.94,98.6,2.2513247124069955,12.755676358345001,820,86.05276885484447,38.818878181368916,0.5670592757323669
48229,"Hudspeth County, Texas",3481,1745,1736,12543,2286,137,30,0,4,2981,301,530,831,1131,461,670,1101,29,3.84,98.2,0.9767308244757253,32.4906636024131,34,85.63631140476875,31.628842286699225,0.5012927319735708
48231,"Hunt County, Texas",89068,43952,45116,23942,58766,6501,2803,324,555,88217,8582,8209,16791,16281,7413,8868,35702,255,9.46,96.4,4.1339201508959444,18.27929222616428,3682,99.04455023128396,40.083980778730854,0.4934656666816365
48233,"Hutchinson County, Texas",21782,10853,10929,25154,14158,1540,395,118,111,21646,1725,1838,3563,3561,1343,2218,9265,27,4.36,98,2.8647507115967312,16.348361032044807,624,99.37563125516482,42.53512074189698,0.49825544027178403
48235,"Irion County, Texas",1631,838,793,32307,1079,111,35,4,19,1628,170,155,325,191,92,99,740,10,5.45,97.5,3.556100551808706,11.710606989576947,58,99.81606376456162,45.37093807480073,0.5137952176578786
48237,"Jack County, Texas",8866,5037,3829,25553,6105,474,158,17,9,7680,625,829,1454,1312,539,773,3118,4,7.05,95.7,2.075344010827882,14.798105120685765,184,86.623054364989855,35.16805774870291,0.5681254229641326
48239,"Jackson County, Texas",14678,7199,7479,26809,9797,1215,356,65,54,14429,955,1195,2150,1863,727,1136,6408,0,7.92,94.6,3.23613571331244,12.69246491347595,475,98.30358359449517,43.65717400190762,0.4904619157923423
48241,"Jasper County, Texas",35640,17406,18234,21402,24074,1775,552,88,143,34711,3116,3396,6512,5650,2357,3293,12435,287,10.73,93.7,2.196969696969697,15.85297418630752,783,97.39337822671156,34.89057239057239,0.48838383838383836
48243,"Jeff Davis County, Texas",2221,1054,1167,25167,1744,354,231,7,78,2155,145,278,423,172,86,86,937,0,5.33,94.3,14.227825303917154,7.744259342638451,316,97.0283656010806,42.18820351193156,0.47456100855470507
48245,"Jefferson County, Texas",252993,129384,123609,25370,167128,21953,6960,1496,965,239093,25171,26122,51293,47369,19928,27441,102742,1016,11.2,93,3.7238184455696404,18.72344294110904,9421,94.5057768396754,40.61060977971722,0.5114133592629045
48247,"Jim Hogg County, Texas",5218,2605,2613,17761,3274,258,94,10,0,5194,679,456,1135,1088,535,553,1532,0,4.33,100.9,1.9931008049060943,20.85090072824837,104,99.54005366040629,29.35990801073208,0.49923342276734384
48249,"Jim Wells County, Texas",41486,20332,21154,20631,25755,2095,456,104,104,41072,4257,4363,8620,8471,3882,4589,16115,157,4.28,99.1,1.600539941184978,20.41893650870173,664,99.00207298847803,38.844429446078195,0.49009304343633997
48251,"Johnson County, Texas",157544,78506,79038,26574,102285,13109,3619,832,590,154914,15465,14447,29912,18706,8380,10326,69925,559,7.2,95.1,3.199741024729599,11.873508353221958,5041,98.3306250952115,44.38442593815061,0.4983115827959173
48253,"Jones County, Texas",19944,12822,7122,17960,14819,1304,265,51,4,12892,1062,1189,2251,2151,932,1219,5280,58,7.25,98.6,1.6044925792218212,10.78519855595668,320,64.64099478539912,26.47412755716005,0.6429001203369434
48255,"Karnes County, Texas",14984,8933,6051,27011,10311,942,206,79,37,12313,945,833,1778,2936,1261,1675,5266,19,7.7,98.4,2.148958889482114,19.5942338494394,322,82.17431927389215,35.14415376401495,0.5961692471970101
48257,"Kaufman County, Texas",111830,54970,56860,26631,71729,9478,3794,276,403,110814,9996,9326,19322,15160,6416,8744,50179,608,7.9,96,3.999821157113476,13.556290798533489,4473,99.09147813645713,44.87078601448627,0.4915496736117321
48259,"Kendall County, Texas",39010,18735,20275,39517,26868,7364,2147,637,420,38487,1859,1606,3465,2363,1077,1286,17120,253,7.22,95.1,8.213278646500898,6.057421174057934,3204,98.65931812355807,43.88618302999231,0.48026147141758524
48261,"Kenedy County, Texas",558,297,261,13705,349,20,13,7,0,558,106,76,182,127,60,67,179,0,4.41,96.8,3.5842293906810037,22.759856630824373,20,100,32.07885304659498,0.532258064516129
48263,"Kent County, Texas",667,322,345,27515,498,82,30,7,0,617,48,24,72,72,30,42,315,5,5.38,100.1,5.547226386806597,10.794602698650674,37,92.50374812593704,47.2263868065967,0.4827586206896552
48265,"Kerr County, Texas",50505,24368,26137,28484,36459,5942,2489,709,413,49538,4249,4321,8570,8158,3611,4547,20408,98,7.7,94.9,7.14978714978715,16.152856152856153,3611,98.08533808533808,40.407880407880405,0.4824868824868825
48267,"Kimble County, Texas",4453,2162,2291,26982,3457,415,118,54,0,4391,533,537,1070,831,386,445,2086,32,5.77,97.6,3.8625645632158094,18.66157646530429,172,98.60768021558499,46.84482371434988,0.4855153828879407
48269,"King County, Texas",274,141,133,29918,211,33,6,0,10,274,53,12,65,9,5,4,164,0,5.58,100.3,5.839416058394161,3.2846715328467155,16,100,59.85401459854015,0.5145985401459854
48271,"Kinney County, Texas",3578,2111,1467,21395,2565,280,46,7,6,3202,412,319,731,654,314,340,1175,45,8.58,99,1.6489659027389603,18.278367803242034,59,89.49133594186696,32.83957518166574,0.5899944102850755
48273,"Kleberg County, Texas",31877,16476,15401,19806,17682,2996,1202,34,236,31240,3548,2920,6468,7110,3366,3744,14101,91,5.3,96,4.617749474542774,22.304482855977664,1472,98.00169401135615,44.2356558019889,0.5168616871098284
48275,"Knox County, Texas",3807,1938,1869,21046,2504,347,105,4,3,3666,335,310,645,536,169,367,1450,5,4.87,100.2,2.9419490412398215,14.079327554504859,112,96.29629629629629,38.08773312319411,0.5090622537431048
48277,"Lamar County, Texas",49626,23988,25638,23625,33524,3819,1464,191,122,48984,4755,4850,9605,9691,4095,5596,20338,588,11.53,96.9,3.5807842663120137,19.528069963325677,1777,98.70632329827107,40.98254947003587,0.48337564986096
48279,"Lamb County, Texas",13561,6873,6688,21760,8545,1087,326,61,17,13352,1423,1377,2800,2763,1255,1508,5652,121,4.72,97.1,2.9791313324976034,20.374603642799205,404,98.45881572155446,41.678342305139736,0.5068210308974265
48281,"Lampasas County, Texas",20357,9972,10385,26405,13907,1859,779,107,112,19844,1757,1457,3214,2751,1256,1495,8452,221,8.85,97.6,4.90249054379329,13.513779044063467,998,97.47998231566537,41.518887851844575,0.48985606916539765
48283,"La Salle County, Texas",7319,4240,3079,26268,4784,473,227,0,0,6382,846,776,1622,843,435,408,2238,0,7.15,101,3.1015166006285013,11.517966935373686,227,87.19770460445416,30.577947807077468,0.5793141139499932
48285,"Lavaca County, Texas",19654,9520,10134,29946,13622,1599,494,48,64,19201,1415,1291,2706,1995,777,1218,8752,55,6.63,96.6,3.083341813371324,10.150605474712526,606,97.69512567416302,44.53037549608222,0.48437977002136967
48287,"Lee County, Texas",16754,8456,8298,26740,11285,1331,465,83,43,16253,1032,1339,2371,2402,1003,1399,7530,72,13.31,96.8,3.5275158171183003,14.336874776172854,591,97.00966933269667,44.94449086785245,0.504715291870598
48289,"Leon County, Texas",16923,8410,8513,27096,11819,1435,514,15,13,16821,1485,1573,3058,2694,1243,1451,6509,122,7.52,95.8,3.2027418306446847,15.919163268923949,542,99.39726998759085,38.462447556579804,0.49695680434911066
48291,"Liberty County, Texas",78598,38970,39628,22153,51374,3769,1108,175,105,71930,7796,7325,15121,12448,5366,7082,27704,194,9.87,94.8,1.7659482429578361,15.83755311839996,1388,91.51632357057431,35.247716226876,0.4958141428535077
48293,"Limestone County, Texas",23469,12023,11446,21093,15761,1655,440,119,139,22523,3104,2292,5396,4976,2570,2406,8725,106,6.66,95.8,2.9741360944224295,21.20243725765904,698,95.9691507946653,37.17670118028037,0.5122928117942818
48295,"Lipscomb County, Texas",3507,1898,1609,29995,2281,323,65,8,8,3458,306,317,623,358,156,202,1601,10,4.42,95.6,2.309666381522669,10.208155118334759,81,98.60279441117764,45.651554034787566,0.5412033076703735
48297,"Live Oak County, Texas",11976,6566,5410,22847,8642,723,150,50,35,10385,998,1074,2072,1649,775,874,4225,62,8.19,98.8,1.9622578490313962,13.769205076820308,235,86.71509686038745,35.27889111556446,0.5482631930527722
48299,"Llano County, Texas",19624,9518,10106,35680,15551,2906,852,216,165,19372,1680,1777,3457,2672,1190,1482,7056,74,5.89,98.6,6.2831227068895235,13.61598043212393,1233,98.71585813289849,35.95597227884223,0.48501834488381573
48301,"Loving County, Texas",76,40,36,35530,67,2,0,0,0,76,5,10,15,12,5,7,39,0,2.65,103,0,15.789473684210526,0,100,51.31578947368421,0.5263157894736842
48303,"Lubbock County, Texas",294682,145467,149215,26196,172556,30155,12122,2852,3150,290327,23368,22943,46311,55027,25648,29379,140175,728,4.08,98.3,6.1503586917422846,18.673349576831974,18124,98.52213572596901,47.56822608778276,0.4936406024120917
48305,"Lynn County, Texas",5723,2891,2832,26758,3712,519,94,13,14,5700,756,609,1365,1128,476,652,2305,0,5.27,98.6,2.1142757295124937,19.70994233793465,121,99.59811287786127,40.276078979556175,0.5051546391752577
48307,"McCulloch County, Texas",8242,4182,4060,23398,5825,615,263,39,19,8105,823,835,1658,1484,560,924,3358,0,6.84,98.7,3.894685755884494,18.00533851007037,321,98.33778209172532,40.74253821887891,0.5074011162339238
48309,"McLennan County, Texas",243394,118704,124690,24273,146233,21012,7828,1452,2202,238968,19557,19896,39453,46681,20636,26045,107988,600,7.65,96.9,4.717454004618027,19.17919094143652,11482,98.18154925758236,44.36756863357355,0.4877030658109896
48311,"McMullen County, Texas",671,365,306,33472,474,42,24,11,0,671,74,18,92,59,34,25,254,10,8.12,99.8,5.216095380029806,8.79284649776453,35,100,37.85394932935917,0.5439642324888226
48313,"Madison County, Texas",13843,8758,5085,17436,9866,934,194,33,48,9490,859,951,1810,1561,711,850,4404,17,10.24,95.5,1.9865636061547352,11.276457415300152,275,68.55450408148523,31.81391316911074,0.6326663295528426
48315,"Marion County, Texas",10191,5013,5178,25933,7758,618,299,14,54,10039,1055,770,1825,2161,933,1228,3618,45,12.11,95,3.601216759886174,21.204984790501424,367,98.50848788146403,35.501913453046804,0.4919046217250515
48317,"Martin County, Texas",5451,2783,2668,28560,3221,452,148,16,5,5382,558,642,1200,571,344,227,2461,37,3.05,100,3.1003485598972667,10.47514217574757,169,98.73417721518987,45.14767932489451,0.510548523206751
48319,"Mason County, Texas",4064,2095,1969,24519,3099,540,154,25,14,4052,525,366,891,604,307,297,2111,0,5.74,98.4,4.749015748031496,14.862204724409448,193,99.70472440944881,51.943897637795274,0.515501968503937
48321,"Matagorda County, Texas",36719,18133,18586,23294,23821,2640,703,158,131,36310,3813,3997,7810,7877,3400,4477,15646,69,9.98,93.6,2.701598627413601,21.45210926223481,992,98.88613524333451,42.61009286745282,0.49383153135978647
48323,"Maverick County, Texas",56830,28129,28701,16658,31876,2643,744,310,28,56285,8403,9127,17530,13879,6150,7729,20614,216,6.22,101.5,1.9039239838113673,24.421960232271687,1082,99.0409994721098,36.27309519619919,0.49496744677107163
48325,"Medina County, Texas",47920,25100,22820,25572,31732,4166,1766,119,115,45561,3508,2918,6426,6340,2964,3376,20077,89,8.54,98.5,4.173622704507513,13.230383973288815,2000,95.07721202003339,41.89691151919867,0.5237896494156928
48327,"Menard County, Texas",2163,1150,1013,23613,1544,121,112,0,0,2109,389,247,636,282,111,171,833,4,5.57,97.7,5.17799352750809,13.0374479889043,112,97.50346740638003,38.51132686084142,0.53166897827092
48329,"Midland County, Texas",155817,77923,77894,38545,96774,18152,5134,1513,583,154621,15284,15245,30529,12148,4801,7347,77875,1073,3.59,100.3,4.640058530198887,7.796325176328642,7230,99.23243291810265,49.97850042036492,0.5000930578820026
48331,"Milam County, Texas",24372,12126,12246,22911,16346,1794,585,128,54,23896,1924,1550,3474,3692,1589,2103,9088,22,9.8,96.8,3.147053996389299,15.148531101263746,767,98.04693911045462,37.288691941572296,0.49753815854258987
48333,"Mills County, Texas",4871,2332,2539,24858,3307,495,145,60,53,4699,259,394,653,678,251,427,1864,11,5.61,97.2,5.296653664545268,13.919113118456169,258,96.46889755696982,38.267296243071236,0.47875179634571957
48335,"Mitchell County, Texas",8995,5553,3442,19741,6156,542,104,1,36,6521,705,487,1192,654,270,384,2976,3,4.81,98.9,1.5675375208449138,7.270705947748749,141,72.4958310172318,33.085047248471376,0.617342968315731
48337,"Montague County, Texas",19384,9485,9899,26278,13579,1469,429,87,20,19069,1976,2139,4115,3066,1218,1848,7998,47,8.72,94.8,2.765167148163434,15.817168799009492,536,98.37494841106067,41.2608336772596,0.4893210895583987
48339,"Montgomery County, Texas",518849,256808,262041,38012,336470,73435,26992,6035,4444,515754,40530,38240,78770,56804,25697,31107,234350,1845,13.28,95.3,7.221947040468422,10.9480793063107,37471,99.40348733446532,45.167283737657776,0.4949571069810292
48341,"Moore County, Texas",22186,11429,10757,21372,12804,1322,357,49,0,21988,2200,2088,4288,3908,1845,2063,10395,121,4.46,98.1,1.8299828720814928,17.614711980528263,406,99.10754529883711,46.85387181105202,0.5151446858379158
48343,"Morris County, Texas",12653,6069,6584,22803,8836,1007,366,83,0,12501,962,1128,2090,2316,1020,1296,4620,62,10.42,95,3.548565557575279,18.303959535288072,449,98.79870386469612,36.513079901999525,0.4796490950762665
48345,"Motley County, Texas",1022,541,481,25908,707,103,12,0,8,1022,168,88,256,158,88,70,432,0,5.33,98.5,1.9569471624266144,15.459882583170254,20,100,42.27005870841487,0.5293542074363993
48347,"Nacogdoches County, Texas",65556,31292,34264,22589,37254,5654,2488,560,702,64749,6561,7077,13638,14631,6387,8244,27410,183,8.06,95.1,5.720300201354567,22.318323265604977,3750,98.7689913966685,41.81158093843432,0.47733235706876564
48349,"Navarro County, Texas",48177,23714,24463,22152,31446,3301,1285,266,95,47408,4650,5175,9825,9418,4100,5318,19475,79,8.29,96.1,3.41656807190153,19.548747327562946,1646,98.40380264441538,40.42385370612533,0.4922265811486809
48351,"Newton County, Texas",14138,7082,7056,20800,9291,524,127,15,30,13929,1550,930,2480,2272,1003,1269,4384,171,9.9,93.4,1.2165794313198472,16.07016551138775,172,98.5217145282218,31.008629226198895,0.5009195077097185
48353,"Nolan County, Texas",15017,7593,7424,23686,9791,888,285,48,18,14826,1367,1279,2646,2572,1155,1417,6381,100,5.45,97.8,2.3373510021975097,17.12725577678631,351,98.72810814410335,42.49184257841113,0.5056269561164014
48355,"Nueces County, Texas",355667,175151,180516,26780,229139,30331,11624,2538,2370,350888,32526,31772,64298,59095,25591,33504,162087,1677,5.34,95.8,4.648168089814349,16.61526090416035,16532,98.65632740737826,45.5726845616827,0.49245783274804805
48357,"Ochiltree County, Texas",10577,5398,5179,24157,6174,773,188,19,31,10515,1342,1159,2501,1322,571,751,4746,57,5.51,96,2.2501654533421576,12.49881819041316,238,99.41382244492767,44.870946393117144,0.5103526519807129
48359,"Oldham County, Texas",2069,1082,987,25461,1192,232,62,6,9,1624,104,96,200,215,71,144,734,9,4.62,98,3.721604639922668,10.391493475108748,77,78.49202513291445,35.476075398743355,0.5229579507008216
48361,"Orange County, Texas",83751,41429,42322,27938,55812,6217,1888,249,115,83013,6648,6288,12936,12590,5451,7139,35404,403,11.26,92.9,2.6889231173359125,15.032656326491624,2252,99.11881649174339,42.272928084440785,0.4946687203734881
48363,"Palo Pinto County, Texas",27922,13754,14168,24840,18947,2010,751,130,111,27636,3040,2989,6029,4916,2243,2673,11685,258,9.04,97.5,3.552754100709118,17.606188668433493,992,98.97571807177137,41.84872143829239,0.4925864909390445
48365,"Panola County, Texas",23771,11688,12083,26205,15929,1577,491,62,131,23558,2123,2035,4158,3372,1266,2106,10044,52,12.37,95,2.8774557233603972,14.185351899373186,684,99.1039501914097,42.25316562197636,0.4916915569391275
48367,"Parker County, Texas",123601,61585,62016,33367,82867,15543,5109,809,934,121523,8957,9590,18547,11377,4504,6873,56871,441,6.76,95.9,5.543644468895883,9.204618085614195,6852,98.3187838286098,46.01176365887007,0.49825648659800487
48369,"Parmer County, Texas",9921,5097,4824,21876,6005,659,247,19,37,9832,1223,909,2132,1637,718,919,4502,108,3.71,97.2,3.0541276081040216,16.500352787017437,303,99.10291301280112,45.378490071565366,0.5137586936800725
48371,"Pecos County, Texas",15826,9075,6751,19088,10590,672,304,29,11,13755,1323,1234,2557,1334,589,745,6155,59,2.87,97.8,2.173638316694048,8.429167193226336,344,86.9139390875774,38.891697207127514,0.5734234803487931
48373,"Polk County, Texas",46583,24995,21588,23023,33339,2886,874,121,108,42514,3986,4257,8243,7706,3321,4385,16425,524,9.33,94.7,2.3678165854496274,16.542515509949983,1103,91.26505377498229,35.259644076165124,0.5365691346628598
48375,"Potter County, Texas",121883,62660,59223,21941,76661,7772,2286,625,486,115136,13147,13001,26148,25187,11058,14129,52840,349,4.42,98,2.7870991032383516,20.664899945029248,3397,94.4643633648663,43.35305169711937,0.5140995873091407
48377,"Presidio County, Texas",7144,3508,3636,15329,4652,630,396,138,0,7144,1214,1348,2562,1749,792,957,2378,25,5.69,97.4,7.474804031354983,24.482082866741322,534,100,33.286674132138856,0.4910414333706607
48379,"Rains County, Texas",11087,5653,5434,23976,8146,499,240,29,2,11021,1186,892,2078,1174,534,640,4348,35,9.87,96.3,2.444304139983765,10.588978082438892,271,99.40470821683053,39.217101109407416,0.5098764318571299
48381,"Randall County, Texas",128603,63181,65422,32922,83799,17114,6232,1218,933,127746,7882,8227,16109,13245,5621,7624,65782,271,3.9,97,6.518510454655024,10.299137656197756,8383,99.33360808068241,51.15121731219334,0.4912871394913027
48383,"Reagan County, Texas",3625,1933,1692,25273,2344,204,55,3,7,3590,616,489,1105,630,356,274,1704,16,4.6,97.2,1.793103448275862,17.379310344827587,65,99.03448275862068,47.00689655172414,0.5332413793103449
48385,"Real County, Texas",3348,1611,1737,20873,2483,417,144,0,14,3254,380,470,850,599,282,317,1118,70,5.87,95.7,4.7192353643966545,17.891278375149344,158,97.19235364396654,33.39307048984468,0.48118279569892475
48387,"Red River County, Texas",12455,5917,6538,21177,8953,942,184,24,51,12241,1185,1059,2244,2020,876,1144,4761,69,11.73,96.2,2.079486150140506,16.218386190285027,259,98.28181453231633,38.22561220393416,0.4750702529104777
48389,"Reeves County, Texas",14438,8676,5762,18992,9615,851,143,60,22,11611,1078,1189,2267,1697,892,805,4881,52,3.97,102.5,1.55838758830863,11.753705499376645,225,80.41972572378445,33.80662141570855,0.6009142540518078
48391,"Refugio County, Texas",7315,3599,3716,23959,4974,401,94,23,19,7145,590,605,1195,1124,529,595,3011,8,7.42,94,1.8591934381408066,15.365686944634312,136,97.676008202324,41.161995898838,0.4920027341079973
48393,"Roberts County, Texas",939,457,482,34555,619,150,41,3,1,939,53,65,118,17,11,6,402,0,5.92,97,4.792332268370607,1.810436634717785,45,100,42.81150159744409,0.48668796592119273
48395,"Robertson County, Texas",16537,8214,8323,23337,11091,1346,452,35,92,16332,1645,1479,3124,2460,1205,1255,6981,58,7.98,95.7,3.501239644433694,14.875733204329684,579,98.76035556630586,42.214428251799,0.496704359920179
48397,"Rockwall County, Texas",88010,43084,44926,38933,56673,14290,5366,1095,757,87235,5167,5060,10227,5380,2407,2973,42009,684,8.34,95.6,8.20134075673219,6.112941711169185,7218,99.11941824792638,47.73207590046586,0.4895352800818089
48399,"Runnels County, Texas",10411,5181,5230,22190,7049,1014,193,38,33,10193,929,841,1770,1804,765,1039,4199,20,6.08,98.8,2.5357794640284315,17.327826337527615,264,97.90606089712804,40.3323407933916,0.4976467198155797
48401,"Rusk County, Texas",53197,27866,25331,23521,36050,3653,1380,162,108,48414,5005,5087,10092,7945,3372,4573,20417,82,10.56,94.9,3.101678666090193,14.935052728537324,1650,91.0088914788428,38.37998383367483,0.5238265315713292
48403,"Sabine County, Texas",10367,5131,5236,20876,7512,589,375,0,8,10279,1220,1053,2273,2385,1164,1221,2774,35,10.94,94.2,3.6944149705797242,23.00569113533327,383,99.1511526960548,26.75798205845471,0.4949358541525996
48405,"San Augustine County, Texas",8556,4174,4382,21066,6239,497,172,40,9,8324,906,869,1775,2213,1145,1068,2204,24,9.73,94.3,2.5829827021972886,25.864890135577372,221,97.28845254791959,25.75970079476391,0.48784478728377745
48407,"San Jacinto County, Texas",27172,13260,13912,22308,18970,1405,342,82,69,27028,2405,2914,5319,4627,1772,2855,10256,229,11.56,94.6,1.8143677314882969,17.02855881054026,493,99.47004269100545,37.744737229500956,0.48800235536581776
48409,"San Patricio County, Texas",66706,33444,33262,24613,42209,4333,1316,279,174,65906,6702,6177,12879,9397,4156,5241,28917,226,5.44,94.8,2.651935358138698,14.087188558750338,1769,98.80070758252631,43.34992354510839,0.5013641951248763
48411,"San Saba County, Texas",5881,3076,2805,22481,4172,439,101,36,31,5203,616,404,1020,930,391,539,2279,25,5.33,98.1,2.856657031117157,15.813637136541404,168,88.47134841013433,38.751912939976194,0.5230402992688318
48413,"Schleicher County, Texas",3171,1615,1556,28112,1961,259,116,0,0,3171,348,359,707,417,171,246,1497,31,5.11,97.3,3.6581520025228635,13.15042573320719,116,100,47.20908230842006,0.5093030589719332
48415,"Scurry County, Texas",17314,9353,7961,24140,11161,1254,399,39,30,15811,1123,1215,2338,1261,494,767,7113,26,4.9,98.3,2.703014901235994,7.2831234838858725,468,91.31916368256901,41.082361095067576,0.5401986831465866
48417,"Shackelford County, Texas",3323,1655,1668,24296,2234,462,89,7,4,3306,312,274,586,609,336,273,1485,46,8.27,98.2,3.0093289196509176,18.32681312067409,100,99.48841408365935,44.68853445681613,0.4980439362022269
48419,"Shelby County, Texas",25705,12614,13091,20686,16393,1653,618,161,76,25514,3239,3099,6338,5792,2854,2938,9406,75,11.28,94.2,3.3262011281851778,22.532581209881346,855,99.25695390001945,36.592102703754136,0.49072164948453606
48421,"Sherman County, Texas",3069,1609,1460,25358,2081,353,78,0,18,3028,439,280,719,413,143,270,1575,35,4.8,97.8,3.1280547409579667,13.457152166829585,96,98.66405995438254,51.31964809384164,0.5242750081459759
48423,"Smith County, Texas",219745,106129,113616,26270,142257,24358,7555,1889,1293,217347,20595,19915,40510,36474,16506,19968,95273,1790,9.18,96,4.8861180004095655,16.59832988236365,10737,98.90873512480375,43.356162825092724,0.48296434503629204
48425,"Somervell County, Texas",8673,4265,4408,27095,5923,833,153,96,53,8476,864,786,1650,1485,530,955,3555,47,8.3,94.9,3.482070794419463,17.122103078519544,302,97.72858295860718,40.98927706675891,0.4917560244436758
48427,"Starr County, Texas",63008,30589,32419,13167,34711,2257,869,23,71,62428,10811,11130,21941,23445,10272,13173,20402,121,3.47,101.5,1.5283773489080752,37.20956069070594,963,99.07948197054343,32.38001523616049,0.4854780345352971
48429,"Stephens County, Texas",9787,5291,4496,23044,6566,770,293,30,18,9163,1015,1055,2070,2012,922,1090,3771,109,9,98.4,3.48421375293757,20.557882905895575,341,93.624195361193415,38.530703995095536,0.5406151016654747
48431,"Sterling County, Texas",1233,651,582,25675,793,130,38,11,9,1193,169,125,294,184,93,91,584,32,5.35,97.6,4.703974047039741,14.922952149229522,58,96.7558799675588,47.364152473641525,0.5279805352798054
48433,"Stonewall County, Texas",1233,619,614,28063,886,82,34,0,4,1177,88,95,183,221,116,105,488,0,4.86,100.6,3.0819140308191404,17.923763179237632,38,95.45823195458232,39.57826439578265,0.5020275750202757
48435,"Sutton County, Texas",3936,2094,1842,31603,2535,351,60,16,0,3913,385,401,786,358,180,178,1711,23,5.18,97.3,1.9308943089430894,9.095528455284553,76,99.41565040650407,43.47052845528455,0.5320121951219512
48437,"Swisher County, Texas",7639,3964,3675,18878,5041,548,181,18,0,7006,590,590,1180,1639,658,981,2633,0,4.52,96.4,2.605053017410656,21.45568791726666,199,91.71357507527163,34.467862285639484,0.5189160884932583
48439,"Tarrant County, Texas",1947529,953334,994195,30857,1235550,255467,95008,16720,12547,1931815,182155,169602,351757,275899,124939,150960,934029,8402,6.18,96.4,6.381163001937327,14.16661831479788,124275,99.19313139881358,47.95969662069217,0.48950952720087865
48441,"Taylor County, Texas",135234,66259,68975,25419,81927,13533,4435,1008,783,130152,10028,10395,20423,22653,9888,12765,63916,427,7.3,97.1,4.603871807385716,16.75096499401038,6226,96.24206930209859,47.2632621973764,0.48995814661993287
48443,"Terrell County, Texas",778,376,402,21204,648,63,47,0,0,778,79,58,137,194,72,122,338,0,4.92,98,6.041131105398458,24.93573264781491,47,100,43.44473007712082,0.4832904884318766
48445,"Terry County, Texas",12724,6764,5960,21938,8062,652,258,68,0,11611,1744,1548,3292,1581,668,913,4567,103,5.66,99,2.562087393901289,12.425337944042754,326,91.25275070732474,35.89280100597296,0.5315938384155926
48447,"Throckmorton County, Texas",1520,709,811,27732,1127,180,34,1,9,1509,125,133,258,199,85,114,660,2,6.47,98.7,2.8947368421052633,13.092105263157896,44,99.27631578947368,43.421052631578945,0.4664473684210526
48449,"Titus County, Texas",32592,16017,16575,21090,19669,1878,735,230,137,32319,3450,3465,6915,6654,2944,3710,13749,291,10.61,96,3.3811978399607265,20.416053019145803,1102,99.16237113402062,42.18519882179676,0.49143961708394696
48451,"Tom Green County, Texas",116264,57521,58743,27513,74147,11099,3891,913,730,111360,9458,9261,18719,15267,6463,8804,55019,778,5.82,98.5,4.759856877451318,13.131321819307782,5534,95.78201334893002,47.322472992499826,0.4947447189155715
48453,"Travis County, Texas",1148176,578199,569977,38820,767787,227391,90355,22500,16365,1140612,99943,83890,183833,171023,79909,91114,612192,5319,8.39,97.2,11.25437215200457,14.895190284416326,129220,99.34121598082524,53.318654979724364,0.50358046153203
48455,"Trinity County, Texas",14360,6844,7516,20369,10493,951,271,25,31,14261,1413,1395,2808,2206,1028,1178,4644,69,9.34,95.8,2.277158774373259,15.362116991643454,327,99.31058495821728,32.33983286908078,0.4766016713091922
48457,"Tyler County, Texas",21371,11624,9747,21172,15013,1293,341,30,36,18648,1482,1518,3000,2903,1280,1623,6660,196,10.69,94.2,1.904449955547237,13.58382855271162,407,87.25843432689159,31.163726545318422,0.5439146506948669
48459,"Upshur County, Texas",40295,19908,20387,24088,27110,3047,1034,117,81,39765,3398,3367,6765,5367,2324,3043,16120,116,10.17,95.2,3.057451296686934,13.319270380940564,1232,98.68470033502916,40.004963394962154,0.49405633453282044
48461,"Upton County, Texas",3475,1688,1787,25290,2152,126,60,27,0,3418,362,410,772,695,325,370,1347,15,4.9,98.7,2.5035971223021583,20,87,98.35971223021583,38.76258992805755,0.4857553956834532
48463,"Uvalde County, Texas",27055,13221,13834,19146,16580,1833,516,61,65,26672,3187,2799,5986,5484,2442,3042,11053,43,6.42,98.5,2.3729440029569395,20.26982073553872,642,98.58436518203659,40.85381630012937,0.4886712252818333
48465,"Val Verde County, Texas",48862,24804,24058,20160,29121,3635,1047,175,229,46366,4977,5572,10549,9811,4368,5443,19160,564,5.66,98.9,2.9695878187548606,20.07899799435144,1451,94.89173590929556,39.212475952683064,0.507633744013753
48467,"Van Zandt County, Texas",53070,26096,26974,25394,36590,4166,1461,172,165,52403,5379,5198,10577,8244,3733,4511,21953,79,8.92,96,3.387978142076503,15.534200113058224,1798,98.7431693989071,41.36612021857923,0.491727906538534
48469,"Victoria County, Texas",90989,44622,46367,28181,58697,7764,2478,532,289,89879,8130,8001,16131,13166,5528,7638,42390,248,5.82,95.5,3.625712998274517,14.469880974623306,3299,98.78007231643386,46.58804910483685,0.49041092879359044
48471,"Walker County, Texas",69926,40883,29043,17194,45130,6204,1903,226,468,53304,3792,3697,7489,12072,5082,6990,22557,192,11.14,95.2,3.713926150501959,17.263964762749193,2597,76.22915653691045,32.2583874381489,0.5846609272659669
48473,"Waller County, Texas",47049,23520,23529,23888,25346,3423,1054,155,119,46796,4868,4956,9824,7986,3665,4321,19888,240,13.47,96,2.8225892154987355,16.973793279347063,1328,99.4622627473485,42.270824034517204,0.49990435503411335
48475,"Ward County, Texas",11396,5668,5728,26860,7178,686,283,26,17,11270,865,1094,1959,1873,839,1034,4711,84,3.59,103,2.8606528606528605,16.435591435591437,326,98.8943488943489,41.33906633906634,0.49736749736749736
48477,"Washington County, Texas",34544,17235,17309,28517,23087,3640,1049,168,233,33862,3135,2080,5215,4645,1977,2668,14593,53,18.23,96.2,4.197545159796202,13.446618805002316,1450,98.02570634553034,42.24467345993516,0.49892890226956926
48479,"Webb County, Texas",266006,129588,136418,16316,144764,17812,5810,910,735,263804,38592,41027,79619,84134,37904,46230,97579,879,4.46,101.1,2.802568363119629,31.62860988098013,7455,99.17219912332804,36.68300715021466,0.48716194371555527
48481,"Wharton County, Texas",41377,20325,21052,25867,26867,2460,1224,124,95,41047,4109,3733,7842,7228,3167,4061,18107,44,7.57,95.9,3.4874447156632913,17.46864199917829,1443,99.20245547043044,43.7610266573217,0.491214926166711
48483,"Wheeler County, Texas",5642,2866,2776,25809,3796,415,95,20,6,5573,624,530,1154,951,425,526,2584,37,4.33,96.6,2.144629563984403,16.855724920241048,121,98.77702942219071,45.799361928394184,0.5079758950726693
48485,"Wichita County, Texas",132148,68567,63581,23263,84134,12481,4462,1189,524,117017,9071,10096,19167,21682,9035,12647,60583,685,7.36,98.1,4.672791112994521,16.407361443230318,6175,88.54995913672549,45.84481036413718,0.5188652117323002
48487,"Wilbarger County, Texas",13061,6502,6559,21938,8704,1019,271,52,11,12898,1051,1154,2205,2086,1076,1010,6219,0,6.11,98.5,2.5572314524155884,15.97121200520634,334,98.75200980016844,47.615037133450734,0.4978179312456933
48489,"Willacy County, Texas",21944,11652,10292,13369,13669,945,192,36,9,19881,3037,2892,5929,7371,3428,3943,5992,9,5.26,97.2,1.0800218738607363,33.59004739336493,237,90.5987969376595,27.305869485964273,0.530987969376595
48491,"Williamson County, Texas",490619,241189,249430,34575,319162,85385,31480,5163,3732,486835,28149,25985,54134,35045,15266,19779,240741,1584,9.84,96.9,8.229400002853538,7.143017290402533,40375,99.2287294214044,49.0688293767669,0.4916014259537441
48493,"Wilson County, Texas",46444,23309,23135,29862,31068,4070,1509,167,249,45772,3288,3102,6390,4795,2096,2699,20516,80,10.31,98.6,4.144776505038326,10.324261476186376,1925,98.55309620187754,44.1736284557747,0.5018732236672121
48495,"Winkler County, Texas",7723,3959,3764,23483,4616,369,91,14,2,7626,797,989,1786,1319,501,818,3166,48,3.03,102,1.3854719668522595,17.07885536708533,107,98.7440113945358,40.994432215460314,0.512624627735336
48497,"Wise County, Texas",62089,31097,30992,27447,41319,5374,1308,157,147,61057,5295,5698,10993,7599,2991,4608,26602,94,6.43,95,2.596273091852019,12.238882893910354,1612,98.33786983201533,42.8449483805505,0.5008455604052248
48499,"Wood County, Texas",43198,21423,21775,25955,31212,3727,1289,208,125,42336,3460,3613,7073,5556,2581,2975,15264,100,9.52,96.2,3.754803463123293,12.861706560488912,1622,98.00453724709477,35.33496921153757,0.4959257373026529
48501,"Yoakum County, Texas",8316,4228,4088,23681,4872,614,205,37,12,8316,1009,973,1982,996,351,645,3564,0,7.16,99,3.0543530543530544,11.976911976911977,254,100,42.857142857142854,0.5084175084175084
48503,"Young County, Texas",18275,8997,9278,25661,12468,1569,602,127,20,17981,1906,1906,3812,2759,1167,1592,8526,128,6.9,97.6,4.098495212038304,15.097127222982216,749,98.39124487004104,46.65389876880985,0.492311901504788
48505,"Zapata County, Texas",14335,7185,7150,17817,7970,426,214,23,0,14299,2161,2150,4311,4857,2407,2450,4989,18,4.32,102.5,1.6532961283571677,33.88210673177537,237,99.74886641088246,34.802929891873035,0.5012207882804325
48507,"Zavala County, Texas",12107,6087,6020,13105,6922,459,140,17,16,11858,1354,1215,2569,4248,1581,2667,4225,151,6.85,101.4,1.428925415049145,35.08713967126456,173,97.94333856446684,34.89716692822334,0.5027669943008177
49001,"Beaver County, Utah",6437,3291,3146,21128,3741,580,162,27,30,6360,433,531,964,743,371,372,2751,17,1.88,89.8,3.402205996582259,11.542644088861271,219,98.80379058567655,42.73729998446481,0.5112630107192792
49003,"Box Elder County, Utah",51528,25937,25591,22808,30115,4581,1506,203,149,51123,2184,2063,4247,5250,2430,2820,21459,73,2.4,89.4,3.605806551777674,10.18863530507685,1858,99.21401956217979,41.645319049836985,0.5033573979195777
49005,"Cache County, Utah",118824,59450,59374,21752,59367,14418,4828,707,1611,118122,5818,5406,11224,17367,8181,9186,55055,354,5.55,82.2,6.013936578468996,14.615734195112099,7146,99.40921026055342,46.333232343634286,0.5003198007136606
49007,"Carbon County, Utah",20733,10315,10418,22536,13164,1494,388,100,56,20517,1450,1186,2636,3128,1441,1687,8807,18,4.42,84.1,2.6238363960835382,15.087059277480344,544,98.95818260743742,42.478174890271546,0.49751603723532534
49009,"Daggett County, Utah",751,434,317,28533,530,53,24,0,0,629,11,14,25,30,5,25,279,5,3.64,80.9,3.195739014647137,3.9946737683089215,24,83.75499334221038,37.15046604527297,0.5778961384820239
49011,"Davis County, Utah",329292,165706,163586,28293,188855,46287,15990,3036,1557,326213,13671,12269,25940,23498,10298,13200,151810,1200,4.24,88.2,6.250683284136875,7.135915843688884,20583,99.06496361891574,46.10193991958505,0.50321902748928
49013,"Duchesne County, Utah",20078,10166,9912,23323,11447,1165,334,73,44,19736,1377,1466,2843,2381,1001,1380,7759,41,3.97,80.2,2.246239665305309,11.858750871600757,451,98.29664309194143,38.64428727960952,0.5063253312082877
49015,"Emery County, Utah",10570,5359,5211,21465,6394,680,104,57,19,10516,584,532,1116,1258,479,779,3903,17,2.27,90.8,1.7029328287606433,11.901608325449384,180,99.48912015137181,36.925260170293285,0.5070009460737938
49017,"Garfield County, Utah",5020,2641,2379,23228,3296,487,156,4,15,4796,509,405,914,647,284,363,2062,22,2.34,86.2,3.4860557768924303,12.888446215139442,175,95.5378486055777,41.07569721115538,0.5260956175298804
49019,"Grand County, Utah",9428,4814,4614,25662,6711,1249,444,87,42,9362,895,1058,1953,1579,820,759,4560,25,1.53,91.6,6.077641069155707,16.747984726347052,573,99.29995757318625,48.36656767076793,0.5106067034365719
49021,"Iron County, Utah",47751,23735,24016,19791,26157,5092,1764,266,272,47337,3853,3670,7523,10107,5111,4996,19758,92,2.13,88.6,4.8208414483466315,21.16604887855752,2302,99.13300245021047,41.37714393415845,0.49705765324286405
49023,"Juab County, Utah",10507,5465,5042,20457,5830,714,223,39,9,10368,721,621,1342,1470,685,785,4201,8,2.02,92.3,2.579232892357476,13.990672884743505,271,98.6770724279052,39.9828685638146,0.5201294375178452
49025,"Kane County, Utah",7216,3574,3642,24836,4998,775,417,62,12,7131,818,438,1256,642,271,371,3075,30,2.28,91.7,6.804323725055433,8.89689578713969,491,98.82206208425721,42.61363636363637,0.49528824833702884
49027,"Millard County, Utah",12604,6389,6215,23283,7634,1122,313,54,23,12461,939,850,1789,1288,491,797,5311,20,1.37,93.5,3.094255791812123,10.218978102189782,390,98.86543954300222,42.137416693113295,0.506902570612504
49029,"Morgan County, Utah",10645,5404,5241,30457,5950,1533,545,128,57,10645,385,491,876,434,204,230,4358,12,4.5,81.9,6.857679661813058,4.07703147017379,730,100,40.9394081728511,0.5076561766087365
49031,"Piute County, Utah",1859,995,864,17455,1342,216,35,7,20,1822,203,132,335,304,151,153,597,11,2.56,80.9,3.335126412049489,16.35287789133943,62,98.00968262506724,32.1140398063475,0.5352339967724583
49033,"Rich County, Utah",2284,1086,1198,19512,1382,213,45,0,24,2279,117,246,363,359,112,247,710,8,3.37,80.3,3.021015761821366,15.718038528896672,69,99.78108581436076,31.085814360770577,0.4754816112084063
49035,"Salt Lake County, Utah",1092518,548834,543684,30134,676004,141684,54578,14391,11081,1084951,78591,67552,146143,122608,56805,65803,542042,3674,2.98,88.4,7.327110400011716,11.222515326978595,80050,99.30737983264349,49.61401093620425,0.5023569405721462
49037,"San Juan County, Utah",15540,7789,7751,17385,8809,957,501,37,45,15279,1874,1757,3631,4171,1952,2219,5104,3,2.17,91.9,3.7516087516087517,26.84041184041184,583,98.32046332046332,32.844272844272844,0.5012226512226512
49039,"Sanpete County, Utah",28551,15074,13477,17426,16267,2154,748,90,175,25989,2010,1922,3932,4265,1695,2570,10361,48,3.37,82.6,3.548036846345137,14.938180799271478,1013,91.0265840075654,36.28944695457252,0.5279674967601835
49041,"Sevier County, Utah",20913,10688,10225,21196,12845,1334,661,75,50,20566,1492,1448,2940,2973,1241,1732,8446,64,2.33,82.5,3.7584277721991106,14.216037871180605,786,98.34074499115383,40.38636254961029,0.5110696695835126
49043,"Summit County, Utah",39009,19914,19095,52671,25688,8072,3404,1260,652,38880,2154,1935,4089,3084,1404,1680,20742,204,4.12,75.9,13.62762439437053,7.9058678766438515,5316,99.66930708298085,53.172344843497655,0.5104975774821195
49045,"Tooele County, Utah",61986,31323,30663,24069,35306,5574,1355,257,148,61538,2937,2441,5378,4429,1896,2533,26613,251,1.88,93.3,2.8393508211531637,7.145161810731455,1760,99.27725615461556,42.93388829735747,0.5053237827896622
49047,"Uintah County, Utah",36308,18533,17775,25001,20676,2307,537,160,78,35960,2761,2444,5205,3406,1649,1757,15264,52,3.84,87.3,2.134515809188058,9.380852704638096,775,99.04153354632588,42.040321692189046,0.5104384708604164
49049,"Utah County, Utah",564177,284413,279764,23207,273764,72005,22923,4422,5057,560627,29427,28259,57686,69019,32424,36595,245975,1904,3.02,87.5,5.743233063382591,12.233572088192181,32402,99.3707648486202,43.598906017083294,0.5041201608714996
49051,"Wasatch County, Utah",27895,14176,13719,30086,16567,4109,1315,520,176,27724,1686,1911,3597,2441,1223,1218,12935,112,4.42,79.3,7.209177271912529,8.750672163470156,2011,99.38698691521778,46.370317261157915,0.5081914321563004
49053,"Washington County, Utah",151959,74981,76978,25415,95175,16227,6908,1775,1348,150485,11852,11383,23235,22151,10703,11448,58861,458,3.6,93.4,6.601122671246849,14.576958258477616,10031,99.03000151356616,38.734790305279716,0.493429148651939
49055,"Wayne County, Utah",2716,1388,1328,22195,1789,347,118,7,49,2692,261,218,479,366,192,174,1223,4,1.56,90,6.406480117820324,13.475699558173785,174,99.11634756995582,45.02945508100147,0.5110456553755522
49057,"Weber County, Utah",241328,121181,120147,25275,147300,23458,8526,1238,1101,238430,14774,13865,28639,29410,13863,15547,111359,847,5.33,85.1,4.5021713187031756,12.186733408473115,10865,98.79914473248027,46.14425180666976,0.5021423125372937
50001,"Addison County, Vermont",36926,18312,18614,31051,25239,5286,2610,574,559,36690,1192,731,1923,2955,1394,1561,19279,69,4.33,81,10.136489194605428,8.002491469425337,3743,99.36088393002221,52.20982505551644,0.49591074039971833
50003,"Bennington County, Vermont",36503,17838,18665,31313,25937,5472,2271,588,382,36040,1087,631,1718,4692,2294,2398,17301,244,5.17,79.3,8.878722296797523,12.853738048927486,3241,98.7316111004575,47.3961044297729,0.48867216393173163
50005,"Caledonia County, Vermont",30859,15385,15474,25896,21616,3563,1731,406,281,30473,1031,598,1629,3686,1554,2132,14330,112,5.59,77.5,7.8356395216954535,11.944651479309115,2418,98.74914935675167,46.43701999416702,0.49855795715998574
50007,"Chittenden County, Vermont",160510,78529,81981,36384,104504,30655,14267,4030,2671,159261,3882,2479,6361,17335,7861,9474,88022,446,3.91,80.6,13.063360538284218,10.799950158868606,20968,99.22185533611614,54.83895084418416,0.489246775901813
50009,"Essex County, Vermont",6173,3119,3054,23022,4658,476,201,46,16,6173,285,146,431,912,412,500,2645,11,5.53,77.1,4.2604892272800905,14.774015875587235,263,100,42.84788595496517,0.505264863113559
50011,"Franklin County, Vermont",48625,24147,24478,30624,33590,5236,1911,416,316,48126,1522,955,2477,4147,1805,2342,24536,120,5.56,79.6,5.4354755784061695,8.52853470437018,2643,98.97377892030849,50.45964010282776,0.4965964010282776
50013,"Grand Isle County, Vermont",6945,3455,3490,38635,5142,1042,508,153,91,6945,158,126,284,519,234,285,3666,19,4.13,81.2,10.827933765298775,7.473002159827214,752,100,52.786177105831534,0.4974802015838733
50015,"Lamoille County, Vermont",25136,12471,12665,31390,17329,4049,1677,400,175,25052,1144,816,1960,3148,1391,1757,13150,185,5.06,77.3,8.959261616804582,12.523870146403565,2252,99.66581795035009,52.31540420114577,0.4961409929980904
50017,"Orange County, Vermont",28897,14381,14516,29651,20886,3753,1750,450,353,28815,1080,688,1768,3477,1606,1871,14857,147,5.07,79.6,8.8348271446863,12.032390905630342,2553,99.71623351905042,51.413641554486624,0.4976641173824272
50019,"Orleans County, Vermont",27076,13573,13503,25392,19573,2843,1187,187,117,26433,979,710,1689,3831,1756,2075,11994,140,5.78,77.2,5.506721820062047,14.149061899837495,1491,97.62520313192495,44.297532870438765,0.5012926577042399
50021,"Rutland County, Vermont",60133,29550,30583,28443,43294,7830,3492,809,509,59518,2111,1342,3453,7122,3242,3880,29426,160,4.78,80.3,7.9989356925481845,11.84374636223039,4810,98.97726705802138,48.93486105798813,0.4914107062677731
50023,"Washington County, Vermont",58963,29131,29832,32137,41932,9807,5271,1139,749,58466,1672,1085,2757,6487,2816,3671,31123,287,4.79,78,12.141512473924326,11.001814697352577,7159,99.15709851941048,52.78394925631328,0.49405559418618455
50025,"Windham County, Vermont",43609,21419,22190,29819,31870,6403,3525,725,586,43168,1658,1025,2683,5906,2604,3302,21562,227,5.33,81.2,11.089454011786557,13.543075970556536,4836,98.98874085624527,49.44392212616662,0.49116008163452496
50027,"Windsor County, Vermont",55894,27401,28493,34264,41734,8408,4323,975,975,55056,2211,1465,3676,5456,2472,2984,27593,93,4.85,80.5,11.223029305471071,9.761333953554944,6273,98.50073353132716,49.36665831752961,0.4902315096432533
51001,"Accomack County, Virginia",33060,16125,16935,24266,23850,2647,1230,225,271,32677,3040,2826,5866,6341,2818,3523,14142,92,10.98,88.6,5.220810647307925,19.180278281911676,1726,98.84150030248034,42.776769509981854,0.48774954627949185
51003,"Albemarle County, Virginia",104287,49946,54341,39273,70026,17855,10502,3786,3944,102688,3965,4234,8199,9341,4461,4880,49343,520,6.08,88.8,17.482524188057955,8.957012858745577,18232,98.4667312320807,47.31462214849406,0.4789283419793455
51005,"Alleghany County, Virginia",15919,7788,8131,25952,11720,1234,475,99,101,15672,647,657,1304,2847,1283,1564,6356,52,9.86,83.9,4.240216093975752,17.884289214146616,675,98.44839499968592,39.927131101199826,0.48922671022049125
51007,"Amelia County, Virginia",12793,6642,6151,26118,8924,885,266,78,27,12696,977,847,1824,1465,773,692,5927,123,9.24,89,2.900023450324396,11.451575080121941,371,99.24177284452435,46.330024232001875,0.5191901821308528
51009,"Amherst County, Virginia",31999,15346,16653,24296,22495,2742,1257,103,145,31822,2031,1804,3835,4405,2271,2134,14478,215,7.24,86.8,4.7032719772492895,13.766055189224664,1505,99.44685771430358,45.24516391137223,0.4795774867964624
51011,"Appomattox County, Virginia",15314,7424,7890,26347,10849,1179,722,71,149,15242,683,732,1415,2633,1215,1418,6525,232,8.31,88.2,6.151234164816508,17.19341778764529,942,99.52984197466371,42.60807104610161,0.48478516390231163
51013,"Arlington County, Virginia",226092,112644,113448,67061,169813,58654,44417,14644,7377,222252,10349,8731,19080,19528,8610,10918,143100,820,5.65,89.9,29.38538294145746,8.637191939564426,66438,98.30157634945067,63.29281885250252,0.4982219627408312
51015,"Augusta County, Virginia",74330,37572,36758,30088,53700,8256,3110,577,580,70836,3943,3453,7396,6550,2542,4008,34026,233,6.35,84.9,5.7406161711287504,8.812054352213103,4267,95.29934077761335,45.7769406699852,0.5054755818646576
51017,"Bath County, Virginia",4558,2465,2093,28195,3453,367,146,20,0,4497,199,285,484,373,238,135,2170,0,7.76,83.5,3.641948222904783,8.183413777972795,166,98.66169372531812,47.60860026327337,0.5408073716542343
51019,"Bedford County, Virginia",76933,37888,39045,30633,55090,9619,4124,816,758,76510,3030,3401,6431,7028,3283,3745,35680,431,7.24,87.3,7.406444568650644,9.135221556419221,5698,99.4501709279503,46.37801723577658,0.4924804700193675
51021,"Bland County, Virginia",6612,3733,2879,23505,5082,651,127,21,23,5733,219,329,548,555,309,246,2548,15,5.5,83.1,2.586206896551724,8.39382940108893,171,86.7059891107078,38.53599516031458,0.5645795523290986
51023,"Botetourt County, Virginia",33192,16425,16767,34733,24034,4398,1681,257,234,32914,925,717,1642,2732,1163,1569,15851,57,6.67,86.1,6.543745480838757,8.230899011810076,2172,99.16244878283923,47.75548324897566,0.49484815618221256
51025,"Brunswick County, Virginia",16573,8668,7905,20278,11932,870,492,66,50,14924,1102,753,1855,3184,1378,1806,6424,168,6.73,89.8,3.668617631086707,19.21197127858565,608,90.0500814577928,38.76184154950823,0.5230193688529536
51027,"Buchanan County, Virginia",23158,11673,11485,19241,17309,1082,505,83,50,22169,1541,1564,3105,5297,2648,2649,6735,64,7.38,86.6,2.7549874773296485,22.87330512134036,638,95.72933759392002,29.082822350807497,0.5040590724587616
51029,"Buckingham County, Virginia",17030,9453,7577,19702,12342,984,328,88,69,15063,1268,884,2152,2632,1147,1485,6484,105,7.23,89.4,2.8479154433352907,15.455079271873165,485,88.44979448032883,38.07398708162067,0.555079271873165
51031,"Campbell County, Virginia",55061,26745,28316,26417,39041,5204,2126,325,296,54569,2741,2562,5303,6799,2800,3999,26049,321,7.68,87.4,4.989012186484081,12.348122990864677,2747,99.10644557854016,47.309347814242386,0.4857340041045386
51033,"Caroline County, Virginia",29640,14677,14963,28039,20285,2587,972,28,224,27537,1359,1321,2680,3600,1343,2257,14600,116,9.83,89.4,4.129554655870446,12.145748987854251,1224,92.90485829959515,49.257759784075574,0.4951754385964912
51035,"Carroll County, Virginia",29733,14897,14836,23690,21913,2109,514,47,138,29598,1979,2031,4010,4625,2073,2552,12745,21,7.2,83.6,2.350923216627989,15.555107120034977,699,99.5459590354152,42.8648303232099,0.5010257962533212
51036,"Charles City County, Virginia",7086,3456,3630,32689,5449,405,212,28,49,7069,496,353,849,1032,362,670,3253,45,9.48,89.6,4.078464578041208,14.563928873835733,289,99.76009031893875,45.90742308777872,0.48772226926333617
51037,"Charlotte County, Virginia",12232,6121,6111,19830,8488,705,365,10,27,12100,1023,922,1945,2979,1283,1696,4878,167,8.55,87.8,3.2864617396991496,24.3541530412034,402,98.92086330935251,39.87900588620013,0.5004087638979725
51041,"Chesterfield County, Virginia",331839,159789,172050,35370,220124,51287,23690,4408,3579,329363,13960,13839,27799,24148,10353,13795,166686,1641,9.9,89.2,9.545894243895383,7.277022893632153,31677,99.25385503210894,50.23098550803251,0.4815256796217443
51043,"Clarke County, Virginia",14307,7087,7220,38658,10161,1715,968,178,186,14118,932,1059,1991,1587,678,909,6912,14,5.96,88,9.310127909414971,11.092472216397567,1332,98.67896833717761,48.31201509750472,0.4953519256308101
51045,"Craig County, Virginia",5195,2509,2686,26753,3953,389,74,25,24,5178,316,261,577,667,210,457,1942,31,6.45,83.7,2.367661212704524,12.839268527430221,123,99.67276227141483,37.382098171318574,0.48296438883541865
51047,"Culpeper County, Virginia",48952,24612,24340,29979,32652,4685,1970,438,197,47534,2821,2767,5588,4330,1725,2605,22194,308,5.8,88.7,5.321539467233208,8.84539957509397,2605,97.10328485046577,45.33829057035463,0.5027782317372119
51049,"Cumberland County, Virginia",9769,4779,4990,23488,6843,683,289,34,29,9756,856,582,1438,2204,1198,1006,4446,110,7.77,89.6,3.603234722080049,22.561162862114852,352,99.86692599037772,45.51131129081789,0.4892005322960385
51051,"Dickenson County, Virginia",15304,7814,7490,21082,11043,692,421,39,31,14859,869,820,1689,3196,1485,1711,4815,21,6.45,85.9,3.2083115525352848,20.883429168844746,491,97.09226346053319,31.462362780972295,0.5105854678515421
51053,"Dinwiddie County, Virginia",28155,13903,14252,25981,19771,2260,943,57,87,27780,1739,1571,3310,4375,1876,2499,12638,153,8.22,89.6,3.860770733439886,15.538980642869827,1087,98.6680873734683,44.88723139762032,0.4938021665778725
51057,"Essex County, Virginia",11130,5137,5993,25730,7903,852,355,69,40,11053,598,731,1329,1477,488,989,5274,131,9.44,89.1,4.168912848158131,13.270440251572326,464,99.30817610062893,47.38544474393531,0.46154537286612757
51059,"Fairfax County, Virginia",1132887,560803,572084,52976,768784,238610,164811,35616,24233,1119536,60428,54440,114868,67306,29776,37530,605414,5656,5.43,90,19.830750992817464,5.941104452606482,224660,98.82150646975383,53.439928254097715,0.4950211274381293
51061,"Fauquier County, Virginia",68025,33659,34366,43067,46507,9642,4571,904,483,67570,3144,2648,5792,4042,1770,2272,34169,293,6.49,88,8.758544652701213,5.941933112826167,5958,99.33112826166851,50.2300624770305,0.4948033811098861
51063,"Floyd County, Virginia",15587,7682,7905,25446,11413,1234,561,110,117,15497,869,617,1486,1832,819,1013,6884,116,6.48,82,5.055494963751845,11.75338423044845,788,99.42259575287098,44.16500930262398,0.49284660293834603
51065,"Fluvanna County, Virginia",26046,11826,14220,31952,18500,3244,1945,272,275,24798,1118,891,2009,1726,718,1008,11750,34,6.46,89.8,9.567687936727328,6.626737310911464,2492,95.20847730937572,45.11249328111802,0.4540428472702142
51067,"Franklin County, Virginia",56230,27592,28638,27282,40412,5183,2467,457,238,55878,3394,3402,6796,7950,3514,4436,24937,289,6.69,87.8,5.623332740529966,14.138360305886538,3162,99.37399964431798,44.348212697848126,0.49069891516983816
51069,"Frederick County, Virginia",82321,40925,41396,32554,56274,9899,4809,777,736,81286,4706,4212,8918,4800,2060,2740,41296,201,5.95,87.6,7.679692909464171,5.8308329587833,6322,98.74272664326234,50.164599555398986,0.49713924757959693
51071,"Giles County, Virginia",16871,8233,8638,25004,12051,1133,504,116,158,16756,1299,983,2282,1970,955,1015,7452,73,5.65,83.7,4.61146345800486,11.676841918084287,778,99.31835694386818,44.170470037342184,0.487997154881157
51073,"Gloucester County, Virginia",37021,18267,18754,32271,26385,3670,1741,344,195,36385,2185,1720,3905,2798,1070,1728,17787,310,9.05,89.8,6.158666702682261,7.5578725588179685,2280,98.28205613030443,48.045703789740955,0.4934226520083196
51075,"Goochland County, Virginia",21979,10791,11188,47610,16290,3733,1281,615,247,20746,563,596,1159,1033,387,646,10171,69,8.22,89.3,9.750216115382866,4.699940852632058,2143,94.39009964056599,46.275990718413034,0.49096865189499067
51077,"Grayson County, Virginia",15180,7463,7717,20525,11446,878,261,29,52,14725,848,828,1676,2899,1215,1684,6165,12,6.57,81.9,2.2529644268774702,19.09749670619236,342,97.00263504611331,40.612648221343875,0.49163372859025034
51079,"Greene County, Virginia",19085,9321,9764,30215,13147,1974,915,122,200,18887,1409,1534,2943,2076,834,1242,8884,122,5.9,86.9,6.481529997380141,10.877652606759234,1237,98.96253602305475,46.54964631909877,0.488394026722557
51081,"Greensville County, Virginia",11698,7254,4444,16835,8660,412,234,66,24,8596,495,432,927,1534,604,930,4057,185,7.42,90,2.769704222944093,13.113352709864934,324,73.48264660625748,34.681142075568474,0.6201060010258164
51083,"Halifax County, Virginia",35305,16844,18461,21155,25226,2587,1050,271,84,34592,2418,2445,4863,6498,2857,3641,14051,583,7.61,87.9,3.979606288061181,18.405325024784023,1405,97.98045602605863,39.798895340603316,0.4770995609687013
51085,"Hanover County, Virginia",102199,50104,52095,37924,69493,16877,6473,1226,912,101502,3136,2620,5756,6201,2650,3551,52846,661,10.23,89.1,8.425718451256861,6.067574046712786,8611,99.3179972406775,51.708920830927894,0.4902592001878688
51087,"Henrico County, Virginia",321921,152084,169837,36497,220192,55742,24647,5947,3535,319834,16501,15303,31804,33818,14599,19219,164021,923,10.16,89.3,10.601669353661302,10.505061800876613,34129,99.35170430012332,50.95069908455801,0.4724264648780291
51089,"Henry County, Virginia",52209,25094,27115,21473,37910,2828,1080,151,324,51630,3280,3198,6478,9776,4027,5749,20267,164,6.12,88.9,2.9784136834645367,18.724740945047788,1555,98.89099580532093,38.81897757091689,0.48064509950391693
51091,"Highland County, Virginia",2230,994,1236,32648,1847,273,115,8,18,2230,163,174,337,279,86,193,962,7,5.75,81.7,6.322869955156951,12.511210762331839,141,100,43.139013452914796,0.44573991031390137
51093,"Isle of Wight County, Virginia",36027,17600,18427,33172,25624,4314,2043,438,218,35549,1411,1219,2630,3901,1715,2186,17202,32,10.29,90.6,7.491603519582536,10.82799011852222,2699,98.67321730924029,47.74752269131485,0.48852249701612677
51095,"James City County, Virginia",71900,34876,37024,42047,51936,13855,8059,1442,1453,70246,2855,2461,5316,5595,2604,2991,32169,202,9.13,90.1,15.235048678720444,7.7816411682892905,10954,97.69958275382476,44.741307371349095,0.4850625869262865
51097,"King and Queen County, Virginia",7140,3673,3467,25831,5301,718,262,10,29,7140,489,430,919,1013,520,493,3093,107,9.82,89.2,4.215686274509804,14.18767507002801,301,100,43.319327731092436,0.5144257703081232
51099,"King George County, Virginia",25260,12588,12672,35676,16483,3518,1916,71,175,24873,1032,854,1886,1395,498,897,12407,107,8.55,90.1,8.558986539984165,5.522565320665083,2162,98.46793349168647,49.117181314330956,0.4983372921615202
51101,"King William County, Virginia",16156,8003,8153,31192,11247,1493,495,71,34,16100,646,668,1314,1953,879,1074,7963,96,10.19,89.3,3.713790542213419,12.088388214904679,600,99.65337954939342,49.28819014607576,0.49535776182223323
51103,"Lancaster County, Virginia",11055,5128,5927,33997,8694,1401,719,282,184,10961,687,627,1314,1095,397,698,4471,47,8.84,89.1,10.719131614654003,9.905020352781547,1185,99.14970601537766,40.44323835368611,0.4638625056535504
51105,"Lee County, Virginia",24911,13083,11828,18514,18465,1372,554,88,134,23396,2107,1607,3714,6080,2528,3552,7438,63,8.29,86.6,3.115089719401068,24.40688852314239,776,93.91834932359198,29.858295532094257,0.5251896752438682
51107,"Loudoun County, Virginia",362435,179315,183120,50456,230834,81174,44288,5527,4834,360391,14210,12715,26925,14313,5917,8396,191979,1244,5.72,88.6,15.078289900257976,3.949121911515168,54649,99.4360368065998,52.96922206740519,0.4947507828990026
51109,"Louisa County, Virginia",34350,16874,17476,30237,24702,3329,1553,284,250,34252,2648,2325,4973,4086,1759,2327,15603,196,6.98,88.9,6.075691411935954,11.895196506550219,2087,99.71470160116448,45.4235807860262,0.4912372634643377
51111,"Lunenburg County, Virginia",12450,6498,5952,18555,9102,726,290,7,47,11496,1002,855,1857,2361,1180,1181,4384,190,8.67,88.3,2.7630522088353415,18.96385542168675,344,92.33734939759036,35.21285140562249,0.5219277108433735
51113,"Madison County, Virginia",13122,6410,6712,29705,9304,1471,674,105,136,12946,1130,864,1994,1510,664,846,5851,52,5.74,86.7,6.973022405121171,11.50739216582838,915,98.65874104557233,44.58923944520652,0.48849260783417164
51115,"Mathews County, Virginia",8848,4144,4704,35252,6779,1048,584,109,61,8757,423,310,733,843,443,400,4028,93,8.46,89.5,8.521699819168173,9.52757685352622,754,98.97151898734177,45.52441229656419,0.46835443037974683
51117,"Mecklenburg County, Virginia",31209,15133,16076,22970,22993,2515,1158,188,78,30071,2044,1853,3897,5328,2380,2948,12224,289,8.06,89.3,4.562786375724951,17.07199846198212,1424,96.35361594411869,39.16818866352655,0.4848921785382422
51119,"Middlesex County, Virginia",10728,5295,5433,29871,8292,1209,478,155,96,10367,668,347,1015,1130,509,621,4297,74,9.3,89.2,6.795302013422819,10.533184190902311,729,96.63497390007457,40.05406413124534,0.4935682326621924
51121,"Montgomery County, Virginia",97227,50364,46863,28277,53800,12136,7262,1489,3868,96586,3830,2827,6657,21191,11380,9811,45609,471,5.81,85,12.97890503666677,21.795386055313852,12619,99.34071811328128,46.90980900367182,0.5180042580764602
51125,"Nelson County, Virginia",14831,7171,7660,33597,10854,1594,1203,291,174,14777,960,825,1785,2125,1075,1050,6613,282,6.68,87,11.246712966084553,14.328096554514193,1668,99.63589778167352,44.58903647764817,0.4835142606702178
51127,"New Kent County, Virginia",20051,10215,9836,36768,14373,2275,1124,95,237,19473,576,650,1226,970,392,578,10070,93,9.95,89.5,7.261483217794623,4.837663956909879,1456,97.11735075557328,50.22193406812628,0.5094509002044786
51131,"Northampton County, Virginia",12118,5772,6346,24835,8831,1221,526,84,66,11799,996,968,1964,2568,1009,1559,4682,24,9.91,88.8,5.578478296748639,21.19161577818122,676,97.36755240138636,38.63673873576498,0.4763162237993068
51133,"Northumberland County, Virginia",12272,5966,6306,33364,9634,1572,751,156,128,12272,615,441,1056,1343,600,743,4778,83,7.58,89.6,8.433833116036507,10.94361147327249,1035,100,38.934159061277704,0.48614732724902215
51135,"Nottoway County, Virginia",15641,8483,7158,19452,11010,1095,469,104,10,14317,931,632,1563,3030,1420,1610,5690,193,8.6,88.6,3.727383159644524,19.37216290518509,583,91.53506809027556,36.378748161882235,0.5423566268141423
51137,"Orange County, Virginia",34873,17110,17763,30660,24552,3741,2184,313,130,34335,2321,1540,3861,3136,1149,1987,15541,142,5.39,88.8,7.533048490235999,8.992630401743469,2627,98.45725919766008,44.564562842313535,0.49063745591145014
51139,"Page County, Virginia",23759,11636,12123,24057,17170,1487,614,46,68,23557,1527,1667,3194,3770,1723,2047,10198,64,6.22,85.5,3.0641020244959805,15.867671198282755,728,99.14979586682941,42.9226819310577,0.4897512521570773
51141,"Patrick County, Virginia",18180,8967,9213,21785,13632,1180,559,51,64,17921,1325,1270,2595,3968,1920,2048,7247,68,7.47,86.4,3.7073707370737075,21.826182618261825,674,98.57535753575358,39.86248624862486,0.49323432343234325
51143,"Pittsylvania County, Virginia",62392,30667,31725,23597,45313,4326,1865,302,133,61461,3411,3130,6541,9254,3761,5493,27181,244,8.16,87.5,3.68637004744198,14.832029747403514,2300,98.50782151557893,43.56488011283498,0.49152134889088345
51145,"Powhatan County, Virginia",28286,15198,13088,33807,20402,3997,1543,211,63,25657,1069,1083,2152,1431,531,900,12979,203,9,89.2,6.423672488156686,5.05903980767871,1817,90.70564943788446,45.88489005161564,0.5372976030545146
51147,"Prince Edward County, Virginia",23077,11532,11545,19751,12968,1504,916,287,302,22233,1331,1198,2529,3355,1311,2044,8947,512,8.48,88.3,6.52164492785024,14.538284872383759,1505,96.34267885773714,38.77020409931967,0.49971833427221907
51149,"Prince George County, Virginia",37664,20615,17049,27970,25977,3810,1525,210,186,32626,1729,1221,2950,3231,1530,1701,15882,372,8.51,89.8,5.1003610875106205,8.578483432455394,1921,86.62383177570094,42.167587085811384,0.547339634664401
51153,"Prince William County, Virginia",443630,220996,222634,38225,280543,65693,37684,4268,3032,435485,28830,25577,54407,30869,13809,17060,227832,2156,6.04,90.2,10.139981516128305,6.958276040844848,44984,98.16401054933165,51.35631043887925,0.4981538669612064
51155,"Pulaski County, Virginia",34417,17147,17270,26328,25510,3026,1211,170,240,33383,1634,1568,3202,4491,2104,2387,15330,261,5.57,85.1,4.7098817444867365,13.048784031147399,1621,96.99567074410902,44.54194148240695,0.4982130923671441
51157,"Rappahannock County, Virginia",7416,3643,3773,38185,5589,1046,556,99,111,7399,585,560,1145,681,241,440,3454,16,6.25,86.2,10.329018338727076,9.18284789644013,766,99.77076591154261,46.57497303128371,0.491235167206041
51159,"Richmond County, Virginia",8868,4960,3908,19728,6679,624,221,5,47,7039,373,413,786,1173,498,675,3127,93,8.86,89.1,3.078484438430311,13.227334235453315,273,79.37528191249436,35.2616147947677,0.5593143888137122
51161,"Roanoke County, Virginia",93655,44946,48709,33717,66984,15057,4840,1851,1088,92050,3534,2502,6036,7270,3144,4126,44840,207,5.64,86.5,8.306016763653837,7.762532699802467,7779,98.28626341359244,47.87784955421494,0.47991030911323473
51163,"Rockbridge County, Virginia",22450,11150,11300,31534,16817,2135,1178,515,397,22273,1514,1069,2583,3274,1526,1748,9917,95,7.27,85.6,9.309576837416481,14.583518930957684,2090,99.21158129175947,44.17371937639198,0.49665924276169265
51165,"Rockingham County, Virginia",78427,38501,39926,28884,53298,7900,3684,608,899,78063,4918,4249,9167,8888,3982,4906,37267,360,7.23,85.4,6.618894003340686,11.33283180537315,5191,99.53587412498247,47.5180741326329,0.49091511851785735
51167,"Russell County, Virginia",27973,13693,14280,21673,20317,1793,741,55,76,27748,1977,1561,3538,4710,1938,2772,10413,15,5.89,85.3,3.1172916741143246,16.83766489114503,872,99.19565295105996,37.22518142494548,0.4895077396060487
51169,"Scott County, Virginia",22378,11259,11119,20969,16512,1440,433,141,60,21697,1389,1104,2493,4355,1930,2425,8112,45,6.99,87.1,2.833139690767718,19.461077844311376,634,96.95683260344981,36.24988828313522,0.5031280722137814
51171,"Shenandoah County, Virginia",42857,20972,21885,27016,30844,3960,1445,315,273,42398,2285,2342,4627,4514,1770,2744,20061,132,6.77,87.2,4.743682478941596,10.532701775672585,2033,98.9289964299881,46.8091560305201,0.48934829782765943
51173,"Smyth County, Virginia",31513,15623,15890,22319,22711,2033,1072,128,126,30958,1819,1654,3473,5477,2624,2853,12605,133,5.43,83.8,4.207787262399645,17.380128835718594,1326,98.23882207343001,39.99936534128772,0.4957636530955479
51175,"Southampton County, Virginia",18291,9555,8736,25784,13326,1472,544,78,50,16820,1173,913,2086,2475,1045,1430,7660,111,10.55,90.6,3.6739380022962114,13.531244874528456,672,91.95779345033077,41.87851949045979,0.5223880597014925
51177,"Spotsylvania County, Virginia",129181,63429,65752,33859,84467,15385,7986,934,694,128362,7033,6078,13111,10920,4931,5989,62876,506,8.17,89.2,7.4422709221944405,8.45325550971118,9614,99.36600583677166,48.6727924385165,0.49100873967533926
51179,"Stafford County, Virginia",139548,70245,69303,39158,87903,19237,11702,961,917,133418,5953,4510,10463,6880,2851,4029,68955,567,8.03,89.8,9.731418579986814,4.9302032275632754,13580,95.60724625218563,49.4131051681142,0.5033751827328231
51181,"Surry County, Virginia",6731,3317,3414,27162,4956,803,255,47,26,6731,476,415,891,804,408,396,3079,47,7.93,90.4,4.872975783687417,11.944733323428911,328,100,45.743574506016934,0.49279453275887686
51183,"Sussex County, Virginia",11733,7715,4018,15882,9794,661,382,43,17,6690,174,385,559,1238,383,855,2879,49,7.53,90.4,3.7671524759226114,10.551436120344327,442,57.018665302991565,24.537628909912215,0.6575470894059491
51185,"Tazewell County, Virginia",43367,21489,21878,24325,31344,2971,1012,351,230,42152,2909,2459,5368,7466,3315,4151,15784,95,6.63,82.4,3.6732999746350914,17.215855373901814,1593,97.19833052782069,36.39633822952936,0.49551502294371297
51187,"Warren County, Virginia",38807,19357,19450,30009,26608,3559,1453,178,144,38438,2186,2162,4348,3937,1600,2337,18100,116,6.51,86.6,4.573917076816039,10.145076919112531,1775,99.0491406189605,46.64106991006777,0.49880176256860875
51191,"Washington County, Virginia",54562,27008,27554,25640,39783,6182,2522,685,468,53859,2989,2870,5859,7569,3611,3958,24040,246,5.74,86.5,6.735456911403541,13.872292071405008,3675,98.71155749422675,44.059968476228875,0.4949965177229574
51193,"Westmoreland County, Virginia",17528,8640,8888,32265,12916,1723,782,140,92,17381,1193,968,2161,1940,920,1020,7450,107,8.15,89.8,5.785029666818804,11.068005476951164,1014,99.16134185303514,42.503423094477405,0.492925604746691
51195,"Wise County, Virginia",40074,20706,19368,21694,27966,2489,1085,263,197,37969,2505,2224,4729,7865,3445,4420,13210,46,7.49,83.4,3.8553675699955083,19.626191545640566,1545,94.7472176473524,32.96401656934671,0.5166941158856116
51197,"Wythe County, Virginia",29171,14234,14937,24879,21223,2286,889,227,119,28954,1617,2164,3781,4677,2102,2575,12524,123,5.12,84.4,4.233656713859655,16.03304651880292,1235,99.25611052072263,42.93304994686504,0.4879503616605533
51199,"York County, Virginia",66919,32825,34094,38193,44447,10167,6823,1003,1219,63499,2084,1701,3785,4052,1807,2245,32672,232,8.44,90.2,13.516340650637337,6.0550815164601985,9045,94.88934383358986,48.82320417220819,0.4905183879017917
51650,"Hampton city, Virginia",136789,65983,70806,27053,90364,13706,6541,761,680,131597,8313,7132,15445,20596,9362,11234,64324,499,11.35,90.3,5.835264531504726,15.056766260444919,7982,96.20437315866042,47.02424902587196,0.48237065845937904
51700,"Newport News city, Virginia",181606,88071,93535,26028,115809,17537,8794,1246,1054,172213,11105,10313,21418,27776,12117,15659,88159,583,10.32,90.4,6.108829003447022,15.294648855214035,11094,94.82781405900685,48.54410096582712,0.4849564441703468
51710,"Norfolk city, Virginia",245724,128011,117713,26670,150374,24064,11425,2684,1844,218963,17487,14496,31983,46307,21493,24814,124486,1159,12.49,90.3,6.492243329914864,18.845127053116503,15953,89.10932591037098,50.660904103791246,0.5209544041282089
51800,"Suffolk city, Virginia",87061,42144,44917,31239,57919,9391,4587,986,437,84759,4278,3419,7697,9914,4035,5879,40928,279,12.18,90.5,6.903205798233422,11.387418017252271,6010,97.35587691388797,47.01071662397629,0.4840743846268708
51810,"Virginia Beach city, Virginia",449733,221023,228710,34607,301104,67672,26544,5820,3069,424254,21377,18309,39686,35924,15175,20749,235755,2254,12.39,89.7,7.878674680310318,7.987850569115453,35433,94.33463855220765,52.42110318789148,0.49145381815432715
53001,"Adams County, Washington",19100,9716,9384,18415,10473,980,359,85,20,18882,2122,1686,3808,4322,2061,2261,7711,100,3.99,86.9,2.4293193717277486,22.6282722513089,464,98.8586387434555,40.3717277486911,0.5086910994764398
53003,"Asotin County, Washington",22113,10635,11478,26878,15737,2336,748,127,96,21921,1090,1089,2179,3154,1363,1791,9400,82,3.39,85.4,4.391082168859946,14.263103151992041,971,99.1317324650658,42.508931397820284,0.48093881427214763
53005,"Benton County, Washington",187519,93970,93549,30511,120427,22103,9350,1657,2311,185968,10804,8563,19367,25797,11494,14303,82498,308,2.34,88.7,7.102213642350908,13.757005956729719,13318,99.17288381444014,43.99447522651038,0.501122552914638
53007,"Chelan County, Washington",74761,37199,37562,27605,50144,7559,3725,910,498,74136,5429,4781,10210,9318,4216,5102,32418,490,8.91,76.2,6.8658792686026135,12.46371771378125,5133,99.16400262168777,43.36218081620096,0.4975722636133813
53009,"Clallam County, Washington",72969,36072,36897,28857,54880,8087,3717,1007,501,72010,4637,3255,7892,11273,5114,6159,27438,244,20.48,71.8,7.160575038715071,15.449026298839232,5225,98.68574326083679,37.60226945689265,0.4943469144431197
53011,"Clark County, Washington",450893,222759,228134,32162,299896,54925,21248,4535,2911,448292,22957,18600,41557,45773,20420,25353,203037,1488,15.69,81.8,6.363815805523705,10.151632427205568,28694,99.42314473722146,45.02997385188947,0.49403960584883777
53013,"Columbia County, Washington",3971,1950,2021,28950,2959,528,166,22,36,3909,125,176,301,577,277,300,1590,34,5.93,82.8,5.6408964996222615,14.530345001259128,224,98.43868043314026,40.04029211785444,0.4910601863510451
53015,"Cowlitz County, Washington",102854,50660,52194,25878,70866,6964,3397,614,263,101858,5186,4072,9258,17070,7777,9293,40257,302,18.94,78.7,4.155404748478426,16.59634044373578,4274,99.0316370777996,39.1399459427927,0.49254282769751295
53017,"Douglas County, Washington",40101,20132,19969,25060,26145,3381,864,218,164,39969,3028,2627,5655,5330,2424,2906,17870,717,3.28,85.5,3.107154435051495,13.291439116231516,1246,99.67083115134285,44.56247973865988,0.502032368270118
53019,"Ferry County, Washington",7639,3874,3765,21951,5580,666,285,23,34,7566,463,438,901,1771,920,851,2339,39,5.96,79.5,4.4770257887158005,23.183662783086792,342,99.04437753632675,30.619190993585548,0.5071344416808483
53021,"Franklin County, Washington",87810,45747,42063,22125,49890,5095,2118,289,388,85683,7957,6854,14811,14019,6475,7544,36851,191,3.18,88,3.183008768932923,15.965152032798088,2795,97.57772463272975,41.9667463842387,0.5209771096686027
53023,"Garfield County, Washington",2231,1102,1129,24781,1649,300,88,3,8,2206,91,112,203,250,103,147,864,5,4.09,84,4.437471985656656,11.205737337516808,99,98.87942626624832,38.72702823845809,0.49394890183774093
53025,"Grant County, Washington",92530,46630,45900,22508,55417,5781,2270,398,205,92022,8708,7141,15849,15441,6970,8471,37647,891,2.6,88,3.1049389387225763,16.68756079109478,2873,99.4509888684751,40.68626391440614,0.503944666594618
53027,"Grays Harbor County, Washington",71233,36656,34577,24081,50788,5270,1899,261,344,68271,5180,3966,9146,11269,5263,6006,25938,282,23.07,75.6,3.515224685188045,15.819914927070318,2504,95.84181488916654,36.41289851613718,0.5145929555121924
53029,"Island County, Washington",80113,39928,40185,33837,57535,11517,4918,1120,679,74976,3158,2410,5568,7362,2939,4423,35691,464,5.32,74.9,8.38440702507708,9.18951980327787,6717,93.58780722229851,44.550821963975885,0.49839601562792557
53031,"Jefferson County, Washington",30333,14876,15457,32317,24605,5626,2719,568,629,29603,1196,1224,2420,3541,1513,2028,11344,224,27.26,71,12.91003197837339,11.67375465664458,3916,97.59338014703458,37.39821316717766,0.49042297168100746
53033,"King County, Washington",2079550,1037792,1041758,46316,1464776,441453,193995,47865,35241,2066068,95653,75956,171609,219317,102151,117166,1086503,8031,14.48,73.8,13.325046284051838,10.546368204659663,277101,99.35168666297997,52.24702459666755,0.4990464283138179
53035,"Kitsap County, Washington",257488,131150,126338,34412,176275,35746,13776,3296,2093,243892,10864,7951,18815,26110,11721,14389,118652,970,12.7,77.9,7.443065307897844,10.140278381905176,19165,94.71975393028025,46.08059404710122,0.5093441247747468
53037,"Kittitas County, Washington",42785,21381,21404,26698,25606,6059,2030,266,519,42452,2649,2178,4827,8402,3731,4671,19510,165,7.39,78.9,6.579408671263293,19.637723501227065,2815,99.2216898445717,45.60009349070936,0.4997312142105878
53039,"Klickitat County, Washington",20930,10486,10444,25069,15063,2527,915,112,124,20888,1011,978,1989,3261,1202,2059,7681,81,5.71,85.3,5.499283325370282,15.580506450071667,1151,99.79933110367892,36.69851887243192,0.5010033444816053
53041,"Lewis County, Washington",75724,37742,37982,23853,53024,5137,2370,519,198,74875,4695,3329,8024,12131,5543,6588,28668,146,16.27,75.7,4.076646769848397,16.02002007289631,3087,98.87882309439544,37.85853890444245,0.4984152976599229
53043,"Lincoln County, Washington",10326,5249,5077,26918,7481,1168,351,80,45,10213,481,405,886,1506,738,768,4129,140,4.31,85.5,4.609723029246562,14.584543869843115,476,98.90567499515785,39.98644199109045,0.5083284911872942
53045,"Mason County, Washington",61060,31442,29618,26312,44688,5580,2053,409,255,59883,5023,3210,8233,10136,5414,4722,22178,64,27.26,76.8,4.449721585325909,16.60006550933508,2717,98.07238781526368,36.32165083524402,0.5149361283982967
53047,"Okanogan County, Washington",41299,20785,20514,22755,28657,3290,1418,394,177,40781,3823,3084,6907,8637,4313,4324,16484,255,5.64,77.5,4.8160972420639725,20.913339306036466,1989,98.74573234218747,39.913799365602074,0.5032809511126177
53049,"Pacific County, Washington",20743,10368,10375,23050,15801,1784,646,158,104,20500,1378,955,2333,3829,1765,2064,6945,171,20.23,74.7,4.377380321072169,18.45923926143759,908,98.82852046473509,33.48117437207733,0.4998312683796944
53051,"Pend Oreille County, Washington",13001,6677,6324,26128,9574,1258,452,47,33,12889,754,644,1398,2543,1153,1390,4096,117,10.31,77.7,4.09199292362126,19.560033843550496,532,99.13852780555342,31.505268825474964,0.5135758787785555
53053,"Pierce County, Washington",832896,413477,419419,31157,552099,92646,34167,8414,5008,810962,42908,36300,79208,103562,46121,57441,381957,2798,13.68,73.5,5.713678538497003,12.433965345013062,47589,97.36653795912095,45.85890675426464,0.4964329280006147
53055,"San Juan County, Washington",16056,7739,8317,40784,12947,3450,1708,463,466,16002,943,812,1755,1749,711,1038,7333,113,5.56,75,16.423766816143498,10.893124065769806,2637,99.66367713004485,45.67140009965122,0.48200049825610364
53057,"Skagit County, Washington",120475,59573,60902,30069,83393,13133,5353,1389,736,119303,7319,6008,13327,17805,8047,9758,51906,530,16.47,73.8,6.207096908072214,14.778999792488069,7478,99.02718406308362,43.08445735629799,0.49448433284913884
53059,"Skamania County, Washington",11316,5713,5603,28644,8164,1119,584,67,85,11279,541,541,1082,1597,742,855,4554,31,22.93,75.1,6.504065040650406,14.11276069282432,736,99.67302933898904,40.24390243902439,0.5048603746907034
53061,"Snohomish County, Washington",758649,380430,378219,35737,517950,109719,36130,7610,5025,749283,38004,31532,69536,69695,31211,38484,374583,2669,18.65,73,6.4278737598019635,9.18672534993126,48765,98.76543698073813,49.37500741449603,0.5014571956201089
53063,"Spokane County, Washington",485859,240656,245203,28325,326281,59298,24013,6625,3845,476871,24183,18931,43114,73462,35626,37836,213480,1531,6.77,84,7.097326590636378,15.120024533866822,34483,98.1500805789334,43.9386735657876,0.49532065887428245
53065,"Stevens County, Washington",43744,21911,21833,24707,30980,3564,1568,323,135,43496,2468,2022,4490,7133,3265,3868,15664,181,7.33,82.5,4.631492318946599,16.30623628383321,2026,99.4330651060717,35.80833942940746,0.5008915508412582
53067,"Thurston County, Washington",266311,130394,135917,32410,184136,37766,16897,4551,2109,260340,13066,9632,22698,31605,14441,17164,121298,990,12,78.9,8.84567291625205,11.867703549609292,23557,97.75788457855666,45.54749897676025,0.4896305447390457
53069,"Wahkiakum County, Washington",4051,1975,2076,26964,3072,320,128,8,7,3988,187,145,332,562,247,315,1207,18,18.45,75.6,3.5299925944211306,13.873117748704024,143,98.44482843742286,29.795112317946185,0.48753394223648483
53071,"Walla Walla County, Washington",59809,30670,29139,26651,39044,6902,3086,664,506,56472,3552,2587,6139,8971,4136,4835,25926,141,3.73,88.7,7.115985888411443,14.999414803792071,4256,94.42057215469244,43.34799110501764,0.5127990770619807
53073,"Whatcom County, Washington",209729,103878,105851,29186,136697,29211,10408,2517,2469,208060,11267,9326,20593,32649,14841,17808,98326,872,13.82,73,7.3399482188919984,15.567231999389689,15394,99.20421114867281,46.88240538981257,0.4952963109536592
53075,"Whitman County, Washington",47494,24138,23356,22154,22920,5860,3182,668,1704,47247,1995,1480,3475,12246,6287,5959,21017,87,4.83,86.7,11.694108729523728,25.784309597001727,5554,99.47993430749148,44.251905503853116,0.5082326188571188
53077,"Yakima County, Washington",247681,123899,123782,21510,148605,14009,5910,1940,838,244752,25279,19620,44899,50081,22744,27337,100448,733,6.78,81.6,3.507737775606526,20.21996035222726,8688,98.81743048518054,40.55539181447104,0.500236190906852
54001,"Barbour County, West Virginia",16892,8175,8717,20762,11405,942,431,41,49,16732,987,741,1728,3657,1814,1843,6349,30,6.36,85.6,3.084300260478333,21.649301444470755,521,99.0528060620412,37.58583945062752,0.48395690267582286
54003,"Berkeley County, West Virginia",110173,54159,56014,27658,74900,9696,4309,646,518,109711,5025,4638,9663,14436,6287,8149,49810,87,5.45,88.8,4.967641799714993,13.103028872772821,5473,99.58065950822797,45.21071405879844,0.49158142194548576
54005,"Boone County, West Virginia",23645,11731,11914,20992,16675,873,510,51,15,23527,1161,875,2036,6090,2752,3338,6846,106,6.51,86.6,2.436032987946712,25.755973778811587,576,99.50095157538591,28.95326707549165,0.4961302600972721
54007,"Braxton County, West Virginia",14463,7234,7229,20633,10465,956,221,42,58,14119,659,763,1422,2842,1425,1417,5305,240,6.84,87.5,2.219456544285418,19.65014174099426,321,97.62151697434834,36.67980363686649,0.5001728548710502
54009,"Brooke County, West Virginia",23473,11407,12066,25630,16845,2147,952,144,99,23274,1029,804,1833,2851,1293,1558,10226,39,4.93,86.1,5.090955565969412,12.145869722660077,1195,99.15221744131556,43.56494696033741,0.4859625953222852
54011,"Cabell County, West Virginia",96623,47314,49309,24646,64310,9054,5231,1459,1066,95192,5410,4148,9558,20249,9324,10925,39146,730,5.36,88.7,8.02707429907993,20.95670803017915,7756,98.51898616271488,40.5141632944537,0.48967637105037104
54013,"Calhoun County, West Virginia",7482,3685,3797,19696,5441,477,150,21,0,7459,451,585,1036,1176,523,653,2449,24,6.02,87,2.285485164394547,15.717722534081796,171,99.69259556268378,32.73188986901898,0.4925153702218658
54015,"Clay County, West Virginia",9033,4523,4510,16229,6350,341,279,12,10,8985,437,302,739,2073,941,1132,2588,20,7.26,87.2,3.3322262814125985,22.94918631683826,301,99.46861507804716,28.650503708623933,0.5007195837484778
54017,"Doddridge County, West Virginia",8363,4483,3880,21164,5945,580,216,69,16,7749,621,389,1010,1186,491,695,2682,56,6.62,87.9,3.5991868946550283,14.181513810833433,301,92.65813703216548,32.069831400215236,0.5360516561042687
54019,"Fayette County, West Virginia",45192,22716,22476,20758,32444,2794,1134,212,130,43949,2827,2229,5056,8306,3744,4562,16058,591,8.42,83.4,3.266064790228359,18.379359178615683,1476,97.2495131881749,35.53283767038414,0.502655337227828
54021,"Gilmer County, West Virginia",8497,5080,3417,18207,6020,562,261,37,102,7029,420,417,837,1741,891,850,2653,65,6,87.9,4.707543839002001,20.48958455925621,400,82.72331411086266,31.22278451218077,0.5978580675532541
54023,"Grant County, West Virginia",11770,5908,5862,21705,8544,666,398,84,49,11662,432,324,756,1525,652,873,4745,8,5.92,86,4.511469838572642,12.956669498725573,531,99.08241291418861,40.3143585386576,0.5019541206457094
54025,"Greenbrier County, West Virginia",35580,17384,18196,23777,26059,3181,1281,476,165,34955,2048,1671,3719,6398,2905,3493,13703,43,11.21,81.3,5.401911186059584,17.982012366498033,1922,98.2433951658235,38.51320966835301,0.48858909499718944
54027,"Hampshire County, West Virginia",23455,12082,11373,21771,16920,1202,639,60,20,22957,1831,1129,2960,3864,1923,1941,8864,0,5.9,87.9,3.0654444681304627,16.474099339160095,719,97.87678533361756,37.791515668301,0.515114048177361
54029,"Hancock County, West Virginia",30024,14559,15465,25157,22077,2764,989,204,53,29788,1469,1496,2965,4286,1853,2433,13176,190,4.81,85.5,4.150013322675193,14.275246469491075,1246,99.21396216360245,43.884892086330936,0.484912070343725
54031,"Hardy County, West Virginia",13942,6935,7007,23446,10171,1028,315,68,80,13884,811,693,1504,1897,783,1114,6051,0,5.85,86.5,3.3209008750537943,13.606369244010903,463,99.58399081910773,43.401233682398505,0.4974178740496342
54033,"Harrison County, West Virginia",68775,33599,35176,27162,48789,6879,2689,619,335,68180,3379,2681,6060,10743,5028,5715,29359,547,6,87.2,5.296982915303526,15.620501635768811,3643,99.13486005089058,42.68847691748455,0.48853507815339875
54035,"Jackson County, West Virginia",29199,14443,14756,23246,20621,2220,1070,185,171,29020,1184,1095,2279,4315,1905,2410,10798,86,5.86,87.3,4.883728894825166,14.77790335285455,1426,99.38696530703106,36.98071851775746,0.4946402274050481
54037,"Jefferson County, West Virginia",55531,27512,28019,33241,37690,7014,3306,460,484,55221,2524,1865,4389,5884,2422,3462,26419,115,5.55,88.5,7.653382795195476,10.595883380454161,4250,99.44175325493869,47.575228250886894,0.4954349822621599
54039,"Kanawha County, West Virginia",189636,91385,98251,28201,136129,19763,9619,3425,1473,187842,9113,7621,16734,29779,13076,16703,81592,353,5.9,87.4,7.655192052141999,15.703242000464046,14517,99.05397709295703,43.02558585922504,0.48189689721360923
54041,"Lewis County, West Virginia",16422,8229,8193,21513,11833,1027,416,181,36,16296,852,772,1624,3142,1411,1731,6027,76,6.36,87.6,3.854585312385824,19.132870539520155,633,99.23273657289002,36.70076726342711,0.5010960906101571
54043,"Lincoln County, West Virginia",21482,10732,10750,19321,15076,840,354,148,18,21423,1156,797,1953,5394,2528,2866,7226,155,6.37,89.1,2.420631226142817,25.109393911181453,520,99.7253514570338,33.637463923284614,0.49958104459547525
54045,"Logan County, West Virginia",35166,17402,17764,21074,25308,1470,560,191,29,34604,2107,1721,3828,6986,2957,4029,10676,41,7.48,87.5,2.218051527043167,19.86577944605585,780,98.40186543820737,30.358869362452367,0.4948529829949383
54047,"McDowell County, West Virginia",20273,10323,9950,13985,15029,444,231,79,20,18827,1382,1376,2758,7076,3262,3814,4242,14,7.49,85.2,1.6277807921866523,34.90356631973561,330,92.86736052878213,20.92438218319933,0.5091994278103882
54049,"Marion County, West Virginia",56716,27861,28855,25205,38917,5584,2306,313,288,56351,2515,2489,5004,9222,4324,4898,24944,77,5.55,86,5.125537767120389,16.25996191550885,2907,99.35644262641935,43.98053459341279,0.49123704069398405
54051,"Marshall County, West Virginia",32296,15904,16392,24043,23340,2482,1035,199,49,31904,1608,1338,2946,4600,1839,2761,13184,48,5.31,85.8,3.9726281892494426,14.243249938072827,1283,98.78622739658162,40.8223928659896,0.492444884815457
54053,"Mason County, West Virginia",27060,13057,14003,21094,19476,1595,538,79,2,26431,938,1066,2004,4970,2326,2644,8889,44,5.76,87.5,2.287509238728751,18.36659275683666,619,97.67553584626755,32.849223946784925,0.48252032520325205
54055,"Mercer County, West Virginia",61476,29344,32132,21698,43366,5620,1970,568,283,61055,3005,2435,5440,12712,5403,7309,23123,205,6.39,82.5,4.588782614353569,20.67798815798035,2821,99.31517990760622,37.61305224803175,0.4773244843516169
54057,"Mineral County, West Virginia",27606,13724,13882,21888,19334,1533,706,96,56,27376,1468,1821,3289,4386,2016,2370,10796,59,5.57,89,3.1080199956531187,15.88785046728972,858,99.16684778671303,39.10744041150475,0.49713830326740566
54059,"Mingo County, West Virginia",25549,12539,13010,19272,17988,1022,645,59,58,25466,1360,1133,2493,6594,2856,3738,6952,0,7.34,88.6,2.9825042076010804,25.809229324043994,762,99.67513405612745,27.210458334964187,0.4907824180985557
54061,"Monongalia County, West Virginia",102827,53232,49595,29285,62141,12369,7003,2408,2558,101185,4957,3845,8802,21353,10780,10573,48228,237,6.01,85.4,11.63993892654653,20.765946687154152,11969,98.40314314333784,46.902078247930994,0.5176850438114503
54063,"Monroe County, West Virginia",13496,6682,6814,22830,9909,867,373,42,42,13368,753,683,1436,2283,864,1419,4863,7,8.27,83.5,3.386188500296384,16.916123295791344,457,99.0515708358032,36.03289863663308,0.49510966212211027
54065,"Morgan County, West Virginia",17514,8678,8836,24026,12925,1401,731,50,101,17350,1044,995,2039,1962,772,1190,7236,115,6.06,88.1,5.0359712230215825,11.202466598150052,882,99.06360625785086,41.31551901336074,0.49548932282745234
54067,"Nicholas County, West Virginia",25743,12552,13191,22101,18606,1631,843,186,184,25599,967,1166,2133,4486,1896,2590,9582,146,9.58,83.9,4.711960532960417,17.426096414559296,1213,99.44062463582333,37.22176902458921,0.48758885910733013
54069,"Ohio County, West Virginia",43257,20831,22426,29769,30333,5751,2477,655,253,42697,1888,1774,3662,6626,2927,3699,19573,64,5.04,85.8,7.825323069098643,15.317752040132232,3385,98.70541184085813,45.248167926578354,0.4815636775550778
54071,"Pendleton County, West Virginia",7291,3674,3617,23697,5462,425,292,51,29,7125,342,318,660,1307,612,695,2744,0,6.18,83.4,5.102180770813331,17.926210396379098,372,97.72322040872308,37.63544095460156,0.503908928816349
54073,"Pleasants County, West Virginia",7612,4013,3599,24605,5528,429,303,5,7,7030,260,227,487,1187,598,589,2923,9,4.82,88,4.138202837624803,15.593799264319495,315,92.35417761429322,38.39989490278508,0.5271939043615345
54075,"Pocahontas County, West Virginia",8620,4451,4169,23219,6535,617,324,38,80,8337,693,439,1132,1545,626,919,3582,6,8.31,78.3,5.127610208816705,17.92343387470998,442,96.7169373549884,41.55452436194896,0.5163573085846868
54077,"Preston County, West Virginia",33793,17411,16382,22540,24754,2115,1218,109,166,31263,1816,1568,3384,4761,2137,2624,13388,39,6.45,83.2,4.418074749208416,14.088716598112034,1493,92.5132423874767,39.61767229899684,0.5152250466072855
54079,"Putnam County, West Virginia",56743,27863,28880,30690,39868,5854,3255,593,273,56376,2410,1826,4236,5546,2156,3390,25267,47,4.93,88.5,7.262569832402234,9.773892814972772,4121,99.35322418624324,44.528840561831416,0.49103854219903775
54081,"Raleigh County, West Virginia",78051,39244,38807,23435,55687,6793,2618,492,204,75249,4398,3835,8233,13173,5926,7247,28276,334,7.61,82.2,4.245941756031313,16.877426298189643,3314,96.41003958949918,36.227594777773504,0.5027994516405939
54083,"Randolph County, West Virginia",29287,15020,14267,23642,21148,2034,1397,203,236,27480,1507,1497,3004,4568,2060,2508,11469,42,7.01,80.8,6.268993068596989,15.597364018165056,1836,93.83002697442551,39.160719773278245,0.5128555331717144
54085,"Ritchie County, West Virginia",10044,4982,5062,21533,7229,461,225,49,16,9977,751,586,1337,1919,877,1042,3674,26,5.12,88,2.887295898048586,19.105933890880127,290,99.33293508562326,36.57905217045002,0.49601752289924333
54087,"Roane County, West Virginia",14513,7145,7368,20723,10339,784,290,40,94,14418,692,576,1268,2870,1267,1603,4493,54,5.69,86.9,2.9215186384620684,19.775373802797493,424,99.34541445600496,30.95845104389168,0.4923172328257424
54089,"Summers County, West Virginia",13325,6170,7155,20142,10162,932,480,62,28,12286,577,447,1024,2254,1139,1115,4559,19,7.65,83.9,4.277673545966229,16.915572232645403,570,92.20262664165104,34.21388367729831,0.4630393996247655
54091,"Taylor County, West Virginia",16949,8602,8347,23683,12271,1507,639,71,56,16508,880,556,1436,2729,1349,1380,6859,216,5.86,85.5,4.5194406749660745,16.1012449112042,766,97.39807658268924,40.46846421617794,0.5075225677031093
54093,"Tucker County, West Virginia",6922,3444,3478,22385,5188,401,289,27,20,6748,281,296,577,899,394,505,2967,11,7.71,82.1,4.85408841375325,12.987575845131465,336,97.48627564287779,42.86333429644611,0.49754406240970817
54095,"Tyler County, West Virginia",9000,4481,4519,24599,6541,614,226,33,26,8924,599,682,1281,1663,636,1027,3249,5,4.95,87.6,3.1666666666666665,18.477777777777778,285,99.15555555555555,36.1,0.4978888888888889
54097,"Upshur County, West Virginia",24632,12356,12276,21279,16620,1892,937,143,113,24470,1538,1200,2738,4154,1957,2197,9760,213,6.88,85.3,4.843293277038,16.864241636895095,1193,99.34231893471906,39.62325430334524,0.5016239038648912
54099,"Wayne County, West Virginia",41237,20050,21187,20582,29149,2237,1202,255,60,41093,2296,2184,4480,8566,3959,4607,14130,146,7.27,89,3.6787351165215703,20.772607124669594,1517,99.65079903969736,34.26534422969663,0.486213837088052
54101,"Webster County, West Virginia",8820,4374,4446,20314,6404,318,216,25,29,8763,468,489,957,2383,1027,1356,2902,171,9.05,81.8,3.061224489795918,27.01814058956916,270,99.35374149659864,32.90249433106576,0.4959183673469388
54103,"Wetzel County, West Virginia",15997,7839,8158,22088,11471,721,397,48,67,15899,730,849,1579,3340,1466,1874,5469,39,5.25,86.7,3.200600112521098,20.87891479652435,512,99.38738513471276,34.18766018628493,0.4900293805088454
54105,"Wirt County, West Virginia",5826,2986,2840,19747,4144,237,84,45,34,5826,227,402,629,876,340,536,2166,0,5.34,87.4,2.79780295228287,15.036045314109165,163,100,37.17816683831102,0.5125300377617577
54107,"Wood County, West Virginia",86262,41616,44646,26717,61176,7871,3361,791,372,85759,4638,3481,8119,14747,6155,8592,36143,242,4.57,88.6,5.244487723447173,17.095592497275742,4524,99.416892722172,41.89909809649672,0.48243722612506085
54109,"Wyoming County, West Virginia",22537,11145,11392,20474,16061,817,450,52,0,22458,1333,1191,2524,4483,2212,2271,6264,177,7.85,84.5,2.227448196299419,19.891733593646006,502,99.64946532368994,27.794293827927408,0.4945201224652793
55001,"Adams County, Wisconsin",20294,10955,9339,24874,16147,1351,516,127,51,19127,901,567,1468,2420,1311,1109,7290,108,9.68,82.2,3.419729969449098,11.92470680989455,694,94.24953188134424,35.92194737360796,0.5398147235636148
55003,"Ashland County, Wisconsin",15936,8000,7936,22983,10791,1497,634,167,99,15708,686,641,1327,2347,1000,1347,7318,30,6.54,78.3,5.647590361445783,14.727660642570282,900,98.56927710843374,45.92118473895582,0.5020080321285141
55005,"Barron County, Wisconsin",45548,22945,22603,26935,32359,3839,1436,438,181,44968,1960,1520,3480,5467,2446,3021,21639,172,5.3,80.7,4.511723895670501,12.002722402739966,2055,98.72661807324141,47.50812329849829,0.5037542811978573
55007,"Bayfield County, Wisconsin",14987,7668,7319,28272,11440,2173,859,189,123,14880,734,582,1316,1693,764,929,6731,61,7.37,78.8,7.813438313204777,11.29645692933876,1171,99.2860479081871,44.91225728965103,0.5116434243010609
55009,"Brown County, Wisconsin",256621,127380,129241,29874,169787,34512,9924,2473,1045,253682,10256,7212,17468,29105,12745,16360,130506,1444,4.94,80.4,5.238074826300264,11.341628315687336,13442,98.85473129634754,50.855541830169784,0.4963740301845913
55011,"Buffalo County, Wisconsin",13256,6743,6513,28286,9515,1176,421,67,67,13174,532,352,884,1424,700,724,6725,71,9.64,82.5,4.186783343391672,10.742305371152685,555,99.3814121907061,50.73174411587206,0.5086753168376584
55013,"Burnett County, Wisconsin",15259,7803,7456,26308,11609,1497,520,75,58,15122,674,471,1145,2402,1159,1243,6342,50,8.5,80.8,4.279441640998755,15.741529589094961,653,99.10216921161282,41.56235664198178,0.5113703388164362
55015,"Calumet County, Wisconsin",49653,24933,24720,32713,33227,7245,1830,303,159,49472,1021,696,1717,3129,1201,1928,26892,45,5.41,81.6,4.6160352848770465,6.301734034197329,2292,99.63547016293074,54.159869494290376,0.5021448855054075
55017,"Chippewa County, Wisconsin",63355,32937,30418,27020,44241,6175,1694,342,318,61053,2417,1829,4246,6753,3315,3438,30790,267,6.42,80.4,3.715570988872228,10.658985084050194,2354,96.36650619524899,48.599163444084915,0.5198800410385921
55019,"Clark County, Wisconsin",34486,17482,17004,23437,21713,1820,498,130,44,33992,4255,3672,7927,5060,2341,2719,15376,233,7.48,80.4,1.9486168300179783,14.672620773647278,672,98.56753465174273,44.58620889636374,0.5069303485472365
55021,"Columbia County, Wisconsin",56650,28819,27831,31290,39844,6479,1861,450,245,55253,1946,1514,3460,4729,2032,2697,29367,170,8.36,82.2,4.511915269196822,8.3477493380406,2556,97.53398058252426,51.83936451897617,0.508720211827008
55023,"Crawford County, Wisconsin",16415,8525,7890,24391,11821,1266,500,59,32,15721,705,564,1269,2123,966,1157,7375,59,12.23,81.3,3.6003655193420654,12.933292720073103,591,95.7721596101127,44.92841912884557,0.5193420651842827
55025,"Dane County, Wisconsin",516818,256341,260477,37193,336861,98516,43125,11401,12108,512893,15497,12495,27992,63673,29243,34430,287022,1070,6.32,82.1,12.893126787379696,12.320197825927115,66634,99.24054502745648,55.536378376914115,0.4959985913803312
55027,"Dodge County, Wisconsin",88404,46157,42247,27000,63022,7213,2209,570,252,83817,2374,1852,4226,7384,3180,4204,42945,242,6.93,81.9,3.4285778924030588,8.35256323243292,3031,94.81132075471699,48.57811863716574,0.5221143839645265
55029,"Door County, Wisconsin",27669,13651,14018,34253,21443,4319,1724,402,272,27328,842,544,1386,2451,1145,1306,12917,84,5.62,78.8,8.666738949727131,8.858289059958798,2398,98.7675738190755,46.68401460117821,0.49336802920235645
55031,"Douglas County, Wisconsin",43705,21814,21891,27844,30710,4843,1676,312,164,43114,1846,1621,3467,6577,3060,3517,21151,233,7.68,78.8,4.923921748083743,15.0486214391946,2152,98.64775197345841,48.394920489646495,0.49911909392518017
55033,"Dunn County, Wisconsin",44348,22351,21997,26354,27055,4541,1909,333,421,44018,2000,1436,3436,5768,2599,3169,22208,143,5.99,81.5,6.0047803734103,13.006223505005863,2663,99.25588527103815,50.07666636601425,0.5039911608189772
55035,"Eau Claire County, Wisconsin",101907,50071,51836,27780,63664,12748,4836,1022,971,101226,4690,3494,8184,14233,6605,7628,54404,299,7.87,81.2,6.701207964124152,13.966655872511211,6829,99.3317436486208,53.38593030900723,0.49134014346413885
55037,"Florence County, Wisconsin",4474,2331,2143,28211,3520,460,119,25,12,4416,191,186,377,353,144,209,1911,18,4.61,80,3.48681269557443,7.890031291908806,156,98.70362092087618,42.713455520786766,0.5210102816271792
55039,"Fond du Lac County, Wisconsin",101968,49884,52084,29431,70475,10721,3698,544,488,100278,3134,2662,5796,8497,3753,4744,51680,201,6.17,81.7,4.6387101835870075,8.333006433390867,4730,98.34261729169936,50.68256707986819,0.48921230189863485
55041,"Forest County, Wisconsin",9108,4589,4519,23936,6497,565,270,67,13,8916,602,603,1205,1520,725,795,3536,22,5.66,78.2,3.8427755819060168,16.688625384277557,350,97.8919631093544,38.823012736056214,0.503842775581906
55043,"Grant County, Wisconsin",51723,26874,24849,23753,31846,4178,1912,382,323,50593,2251,1693,3944,7335,3626,3709,25708,198,7.69,81.7,5.059644645515535,14.181311988863754,2617,97.81528526960926,49.70322680432303,0.5195754306594745
55045,"Green County, Wisconsin",37050,18347,18703,30208,25860,3985,1376,275,231,36692,1049,908,1957,3243,1464,1779,19670,81,6.29,82.6,5.079622132253712,8.753036437246964,1882,99.03373819163293,53.09041835357625,0.495195681511471
55047,"Green Lake County, Wisconsin",18881,9535,9346,26372,13366,1596,567,126,76,18689,1075,916,1991,2076,1033,1043,8777,114,7.13,81.9,4.072877495895344,10.995180340024364,769,98.98310470843705,46.48588528149992,0.5050050315131613
55049,"Iowa County, Wisconsin",23751,11936,11815,31717,16599,2586,904,228,106,23572,876,547,1423,2277,1087,1190,12105,162,6.72,81.5,5.212412108963833,9.586964759378553,1238,99.24634752220959,50.96627510420614,0.5025472611679508
55051,"Iron County, Wisconsin",5850,2970,2880,26689,4675,621,233,38,27,5743,295,211,506,726,332,394,2519,30,6.49,77.2,5.094017094017094,12.41025641025641,298,98.17094017094017,43.05982905982906,0.5076923076923077
55053,"Jackson County, Wisconsin",20566,10972,9594,24740,14390,1284,559,106,47,19469,1162,802,1964,2536,1151,1385,9102,73,8.4,81.5,3.462024700962754,12.331031800058348,712,94.66595351551103,44.257512399105316,0.5335018963337548
55055,"Jefferson County, Wisconsin",84538,42212,42326,28819,57118,9388,3027,587,404,84082,3021,2189,5210,8350,3871,4479,43514,105,6.39,82.8,4.752892190494215,9.87721498024557,4018,99.4605976010788,51.47271049705458,0.4993257470013485
55057,"Juneau County, Wisconsin",26399,14023,12376,24376,19185,1769,510,107,93,24808,1209,739,1948,3244,1564,1680,11657,73,8.54,82.1,2.6894958142353875,12.288344255464223,710,93.97325656274859,44.15697564301678,0.531194363422857
55059,"Kenosha County, Wisconsin",167896,82941,84955,28996,110495,17855,7327,1119,932,165962,8392,5993,14385,24708,11099,13609,80015,589,4.61,83.4,5.585600609901367,14.71625291847334,9378,98.84809644065373,47.65747843903369,0.49400223948158384
55061,"Kewaunee County, Wisconsin",20459,10392,10067,28767,14473,1847,436,86,77,20325,552,351,903,1817,727,1090,10252,58,4.88,79.5,2.9278068331785523,8.881176988122586,599,99.34503152646757,50.1099760496603,0.507942714697688
55063,"La Crosse County, Wisconsin",117538,57392,60146,29495,74268,14950,6097,1625,1443,116220,3826,3061,6887,16675,6934,9741,61584,307,11.05,82,7.797478262349197,14.18690125746567,9165,98.87866051830046,52.394970137317294,0.4882846398611513
55065,"Lafayette County, Wisconsin",16793,8531,8262,27023,11340,1388,492,91,32,16698,845,728,1573,1863,845,1018,8584,63,6.37,82.2,3.6622402191389267,11.093908176025725,615,99.43428809623057,51.1165366521765,0.5080092895849461
55067,"Langlade County, Wisconsin",19414,9763,9651,25142,14242,1496,579,188,23,19179,927,769,1696,3026,1541,1485,8777,79,7.57,78.9,4.069228391882147,15.586690017513135,790,98.78953332646543,45.20964252601215,0.5028845163284228
55069,"Lincoln County, Wisconsin",28171,14126,14045,28603,20650,2337,732,155,72,27600,991,780,1771,2616,1203,1413,14055,69,6,79.3,3.4042100031947746,9.286145326754465,959,97.97309289695076,49.89173263284938,0.5014376486457705
55071,"Manitowoc County, Wisconsin",80178,39917,40261,27777,57053,8090,2513,468,145,79660,2235,1733,3968,8143,3470,4673,40489,234,5.12,80.4,3.8988251141210806,10.156152560552771,3126,99.35393748908679,50.49888996981716,0.4978547731297862
55073,"Marathon County, Wisconsin",135367,68051,67316,30151,92748,15028,5137,1552,486,134265,5568,3750,9318,14825,6724,8101,69291,376,5.5,80.2,5.300405564133061,10.951709057598972,7175,99.18591680394779,51.18751246611065,0.502714841874312
55075,"Marinette County, Wisconsin",41090,20622,20468,25778,30114,2946,1025,296,102,40568,1445,1157,2602,5254,2290,2964,18504,129,5.62,81,3.4631297152591873,12.786566074470674,1423,98.7296179119007,45.032854709174984,0.5018739352640545
55077,"Marquette County, Wisconsin",15082,7661,7421,26050,11241,1089,354,72,32,14889,699,489,1188,1730,789,941,6772,83,8.76,82.2,3.036732528842329,11.470627237766875,458,98.72032886885029,44.90120673650709,0.5079565044423816
55078,"Menominee County, Wisconsin",4457,2205,2252,17197,2508,266,120,12,15,4406,705,569,1274,1449,703,746,1454,0,7.53,79.8,3.298182634058784,32.510657392865156,147,98.85573255553062,32.62284047565627,0.4947273951088176
55079,"Milwaukee County, Wisconsin",955306,462020,493286,26933,622645,119607,47028,11340,7251,946031,53844,38232,92076,198227,89498,108729,442745,2194,4.48,82.6,6.868898551877618,20.750105201893426,65619,99.02910690396585,46.34588288988031,0.483635609951157
55081,"Monroe County, Wisconsin",45365,22874,22491,26724,30563,4006,1105,317,128,44491,2640,1833,4473,6192,2752,3440,21041,205,9.82,81.2,3.416730959991183,13.649289099526067,1550,98.07340460707594,46.38157169624159,0.5042213159925052
55083,"Oconto County, Wisconsin",37475,19134,18341,28437,27219,2996,1119,216,77,37213,1300,893,2193,3334,1571,1763,18678,105,7.26,79.8,3.7678452301534358,8.896597731821213,1412,99.30086724482989,49.84122748498999,0.5105803869246164
55085,"Oneida County, Wisconsin",35604,17961,17643,30550,27130,4517,1890,452,262,35114,1382,945,2327,3294,1475,1819,16192,65,6.51,77.3,7.3137849679811255,9.251769464105157,2604,98.62375014043366,45.47803617571059,0.5044657903606337
55087,"Outagamie County, Wisconsin",181799,90637,91162,30858,121672,24326,7210,1483,788,180388,5991,4159,10150,16096,7392,8704,95958,545,5.63,81.7,5.215100193070369,8.853734068944274,9481,99.22386811808646,52.78246855043207,0.498556097668304
55089,"Ozaukee County, Wisconsin",87625,42971,44654,45820,60610,17900,6864,2613,906,87098,1789,1508,3297,4786,1891,2895,45356,75,4.96,81.6,11.849358059914408,5.4619115549215405,10383,99.39857346647646,51.76148359486448,0.49039657631954353
55091,"Pepin County, Wisconsin",7349,3716,3633,27901,5222,672,209,55,22,7241,315,318,633,965,445,520,3633,29,9.3,82.1,3.891685943665805,13.131038236494762,286,98.53041230099333,49.43529731936318,0.5056470268063682
55093,"Pierce County, Wisconsin",40881,20328,20553,31109,25571,4871,1769,227,246,40616,1379,1144,2523,4572,2019,2553,22469,83,8.55,80.8,5.48421026882904,11.183679459895796,2242,99.35177710917051,54.96196276999095,0.49724811036912014
55095,"Polk County, Wisconsin",43483,21904,21579,27993,30903,4211,1395,345,106,43043,1983,1677,3660,4250,1938,2312,20861,175,6.51,81.1,4.245337258238852,9.773934641124118,1846,98.98811029597773,47.975070717291814,0.5037370926569004
55097,"Portage County, Wisconsin",70551,35384,35167,28363,44811,9245,2977,633,725,70241,2542,1606,4148,9454,4692,4762,36010,134,6.03,81.3,6.144491219118085,13.400235290782554,4335,99.5606015506513,51.041090842085865,0.5015378945727205
55099,"Price County, Wisconsin",13707,6893,6814,27161,10604,1249,363,63,44,13514,411,426,837,1724,826,898,6448,32,6.01,77.3,3.4289049390822206,12.57751513825053,470,98.59196031224921,47.041657547238636,0.5028817392573138
55101,"Racine County, Wisconsin",194873,96388,98485,29582,132031,20883,8587,1267,914,190709,8791,6630,15421,23751,9952,13799,90557,689,4.65,83.3,5.525650038743182,12.187937785121592,10768,97.86322374059003,46.46975209495415,0.49461957274737905
55103,"Richland County, Wisconsin",17642,8912,8730,24941,12308,1405,580,122,89,17504,877,615,1492,2373,1160,1213,8248,42,11.14,81.5,4.483618637342705,13.450855912028114,791,99.21777576238522,46.75206892642557,0.505158145334996
55105,"Rock County, Wisconsin",160986,79211,81775,26954,108352,14892,5920,1018,670,159593,7362,5480,12842,23215,10605,12610,75198,372,6.31,82.7,4.7258767843166485,14.42050861565602,7608,99.1347073658579,46.71089411501621,0.4920365746089722
55107,"Rusk County, Wisconsin",14272,7180,7092,23574,10277,1050,326,107,37,14136,861,613,1474,2225,1083,1142,6317,43,6.15,79.4,3.2931614349775784,15.589966367713005,470,99.04708520179372,44.261491031390136,0.5030829596412556
55109,"St. Croix County, Wisconsin",86726,43307,43419,36561,57837,13641,4151,875,650,85932,2690,2224,4914,4851,2133,2718,46098,259,6.97,81.4,6.544750132601527,5.5934783110024675,5676,99.084472937758,53.153610220695064,0.4993542882180661
55111,"Sauk County, Wisconsin",63317,31647,31670,28331,43941,6708,2289,480,332,62596,2819,2434,5253,6933,3045,3888,32661,225,9.31,82,4.8975788492821835,10.949665966486094,3101,98.86128527883507,51.583303062368714,0.49981837421229686
55113,"Sawyer County, Wisconsin",16438,8333,8105,29712,12099,1752,649,173,104,16142,991,736,1727,2623,1160,1463,6932,21,6.86,78.3,5.633288721255627,15.956929066796448,926,98.19929431804356,42.17058036257452,0.506935150261589
55115,"Shawano County, Wisconsin",41384,20689,20695,26627,29421,2980,1229,248,132,40807,1940,1677,3617,4594,2026,2568,19963,88,6.24,81,3.8879760293833368,11.100908563696114,1609,98.60574134931375,48.238449642373865,0.49992750821573556
55117,"Sheboygan County, Wisconsin",115269,57928,57341,28849,79871,13186,4502,637,542,112989,3928,2858,6786,9942,4433,5509,58653,265,5.43,81,4.9284716619385955,8.625042292376962,5681,98.02201806209823,50.88358535252323,0.5025462179770797
55119,"Taylor County, Wisconsin",20521,10498,10023,26290,14225,1318,479,87,31,20298,1287,855,2142,2511,1165,1346,9964,109,5.96,78.8,2.909214950538473,12.23624579698845,597,98.91330831830807,48.55513863846791,0.5115735100628624
55121,"Trempealeau County, Wisconsin",29521,14895,14626,26654,20199,2766,930,102,91,29108,1428,952,2380,2804,1139,1665,15027,143,8.84,82.2,3.8040716777886927,9.498323227532943,1123,98.60099590122286,50.902747196910674,0.5045560787236205
55123,"Vernon County, Wisconsin",30442,15269,15173,25314,20448,2823,1125,219,171,30138,2599,2454,5053,4882,2176,2706,13210,177,12.92,81,4.976676959463899,16.03705407003482,1515,99.00137967282045,43.39399513829578,0.5015767689376519
55125,"Vilas County, Wisconsin",21373,10705,10668,29058,16560,2919,1083,273,165,21203,1186,694,1880,3098,1305,1793,8808,39,5.68,76.5,7.116455340850606,14.494923501614187,1521,99.2046039395499,41.21087353202639,0.5008655780657839
55127,"Walworth County, Wisconsin",103021,51470,51551,29192,67197,11794,5170,922,807,102290,5127,3596,8723,12885,5687,7198,51151,260,4.85,83,6.696692907271333,12.507158734626922,6899,99.29043593053844,49.65104202055892,0.49960687626794537
55129,"Washburn County, Wisconsin",15685,7808,7877,28232,11776,1703,645,131,61,15497,695,462,1157,1976,868,1108,6871,50,7.54,79.6,5.336308575071724,12.59802358941664,837,98.80140261396238,43.806184252470516,0.49780044628626074
55131,"Washington County, Wisconsin",133422,66198,67224,36177,93022,19757,6026,1175,411,132557,3449,2792,6241,7486,3093,4393,71528,416,5.78,82,5.70520603798474,5.61076883872225,7612,99.35168113204719,53.61034911783664,0.49615505688717004
55133,"Waukesha County, Wisconsin",395377,194157,201220,42094,276229,75600,28485,7358,3533,392911,8310,6969,15279,20167,8479,11688,207865,864,5.09,82.7,9.959102325122604,5.100701355921058,39376,99.37629148888276,52.573872531786115,0.49106801862526145
55135,"Waupaca County, Wisconsin",51974,26369,25605,29423,37188,4818,1353,275,123,50488,2080,1433,3513,5327,2501,2826,25411,243,6.32,81.9,3.368992188401893,10.249355446954246,1751,97.14087813137338,48.89175356909224,0.5073498287605341
55137,"Waushara County, Wisconsin",24238,12720,11518,25838,18131,1782,784,108,61,23049,1153,902,2055,2646,1200,1446,10161,142,7.94,82,3.9318425612674313,10.916742305470748,953,95.09447974255302,41.92177572406964,0.5247957752289792
55139,"Winnebago County, Wisconsin",169487,85414,84073,29763,113204,21612,6529,1402,894,164418,5589,4331,9920,19573,8217,11356,85824,294,6.06,82.2,5.206889023936939,11.548378341701724,8825,97.0092101459109,50.63751202157098,0.5039560556266852
55141,"Wood County, Wisconsin",73621,36286,37335,29039,52074,6855,2438,893,428,72958,2502,1817,4319,7715,3263,4452,36106,174,6.68,81.4,5.1058801157278495,10.479346925469635,3759,99.09944173537441,49.043071949579605,0.4928756740603904
56001,"Albany County, Wyoming",37836,19767,18069,26034,20498,5626,2384,511,1290,37625,1849,1439,3288,9070,4634,4436,20509,53,2.93,80.4,11.060894386298763,23.971878634105085,4185,99.4423300560313,54.20498995665504,0.5224389470345703
56003,"Big Horn County, Wyoming",11931,6037,5894,23724,8044,1150,342,35,26,11700,948,819,1767,1385,632,753,5248,86,3.6,83.9,3.3777554270388066,11.608415053222696,403,98.0638672366105,43.986254295532646,0.5059927918866818
56005,"Campbell County, Wyoming",48473,25202,23271,33200,30492,4430,1012,249,122,48060,2656,2624,5280,3898,1746,2152,25596,499,2.51,88.9,2.853134734800817,8.04159016359623,1383,99.14797928743837,52.80465413735482,0.5199183050357932
56007,"Carbon County, Wyoming",15696,8501,7195,27797,10616,1498,498,101,60,14891,1001,858,1859,2133,958,1175,7443,57,3,81.6,4.198521916411825,13.589449541284404,659,94.87130479102956,47.419724770642205,0.5416029561671764
56009,"Converse County, Wyoming",14223,7121,7102,31948,9561,1050,331,39,65,14165,545,831,1376,1178,427,751,7179,20,2.8,86.1,3.0584264923012023,8.282359558461646,435,99.59220980102651,50.47458342121915,0.5006679322224565
56011,"Crook County, Wyoming",7284,3761,3523,34186,5111,772,268,35,17,7230,431,378,809,441,234,207,3537,88,2.4,88.1,4.393190554640308,6.0543657331136735,320,99.25864909390445,48.55848434925865,0.5163371773750687
56013,"Fremont County, Wyoming",40683,20379,20304,27220,27023,4136,1303,337,264,40058,4058,3838,7896,5585,2622,2963,17577,164,3.32,81.6,4.680087505837819,13.728092815180789,1904,98.4637317798589,43.20477840867193,0.5009217609320846
56015,"Goshen County, Wyoming",13546,7167,6379,27253,9463,1333,600,122,118,13052,994,658,1652,2031,891,1140,5989,93,3.57,89.9,6.201092573453418,14.993355972242728,840,96.3531669865643,44.21231359811014,0.529086077070722
56017,"Hot Springs County, Wyoming",4781,2388,2393,30939,3622,498,248,39,24,4691,239,314,553,524,193,331,2195,3,2.88,83.9,6.504915289688349,10.9600501987032,311,98.11754862999372,45.9108973018197,0.4994770968416649
56019,"Johnson County, Wyoming",8572,4546,4026,32732,6052,1013,356,98,74,8521,653,534,1187,499,325,174,4168,89,3.07,85,6.159589360709286,5.821278581427904,528,99.4050396640224,48.623425104993004,0.5303313112459169
56021,"Laramie County, Wyoming",96459,48755,47704,31554,64359,11375,4394,1150,878,93453,5058,4715,9773,9812,4125,5687,47876,616,3.61,87,6.65775096154843,10.172197513969666,6422,96.88365004820702,49.63352305124457,0.5054479105112016
56023,"Lincoln County, Wyoming",18543,9499,9044,29516,12259,1746,554,95,102,18431,1049,985,2034,1616,693,923,8846,38,4.38,79,4.050045839400313,8.714878930054468,751,99.39599848999623,47.705333549048156,0.5122687806719517
56025,"Natrona County, Wyoming",80871,40903,39968,31900,54103,7721,3145,675,477,79755,6253,5447,11700,8333,3592,4741,41163,175,2.72,85.6,5.31340035364964,10.304064497780416,4297,98.62002448343658,50.89958081388878,0.5057808114157114
56027,"Niobrara County, Wyoming",2498,1138,1360,23370,1764,284,29,13,9,2195,135,135,270,296,130,166,1077,12,2.46,88.8,2.0416333066453163,11.849479583666934,51,87.87029623698959,43.11449159327462,0.455564451561249
56029,"Park County, Wyoming",29083,14308,14775,32557,20371,3992,1895,266,366,28817,1707,1703,3410,2288,668,1620,14781,70,4.32,75.7,8.688924801430389,7.86713887838256,2527,99.08537633669154,50.823505140460064,0.49197125468486747
56031,"Platte County, Wyoming",8740,4570,4170,31242,6325,925,313,5,3,8628,895,565,1460,1340,558,782,3996,13,3.58,88.7,3.6727688787185353,15.331807780320366,321,98.71853546910755,45.720823798627,0.522883295194508
56033,"Sheridan County, Wyoming",29924,14821,15103,31643,21042,3978,1588,520,253,29447,1598,1268,2866,2378,1029,1349,14241,65,3.89,84.1,7.8899879695227915,7.946798556342735,2361,98.40596176981687,47.59056275898944,0.49528806309316936
56035,"Sublette County, Wyoming",10032,5322,4710,32175,6976,1284,387,28,0,10010,803,574,1377,775,459,316,5386,18,3.64,76.6,4.136762360446571,7.725279106858054,415,99.78070175438596,53.688197767145134,0.5305023923444976
56037,"Sweetwater County, Wyoming",44812,23381,21431,31700,28407,4205,1241,245,380,44531,3103,2758,5861,4868,2066,2802,22597,148,2.8,84.2,4.164063197357851,10.863161653128627,1866,99.3729358207623,50.426225118271894,0.521757564937963
56039,"Teton County, Wyoming",22623,11742,10881,49200,16920,6500,1987,391,223,22571,2224,1089,3313,1650,932,718,14008,250,7.88,72.5,11.49714891924148,7.29346240551651,2601,99.77014542722009,61.919285682712285,0.5190293064580295
56041,"Uinta County, Wyoming",20893,10587,10306,27115,13039,1728,491,126,29,20705,1562,1685,3247,3462,1728,1734,9312,87,3.2,80.2,3.091944670463792,16.57014311013258,646,99.1001770928062,44.5699516584502,0.5067247403436558
56043,"Washakie County, Wyoming",8351,4062,4289,27345,5836,869,266,75,20,8183,666,715,1381,1198,511,687,3640,33,2.69,87.4,4.32283558855227,14.345587354807808,361,97.98826487845767,43.58759430008382,0.48640881331577057
56045,"Weston County, Wyoming",7175,3734,3441,30955,5179,640,283,32,19,6819,499,473,972,1002,445,557,3231,17,1.89,88.3,4.655052264808362,13.965156794425088,334,95.0383275261324,45.03135888501742,0.520418118466899
