GEOID,COUNTY,POP_TOT,MALE_POP,FEMALE_POP,GDP,DEGREE_TOT,BACHELOR,MASTER,PROFFE,DOCTOR,TOT_NO_INS,MALE_INS,FEMALE_INS,BOTH_INS,TOT_POV,MALE_POV,FEMALE_POV,TOT_COMM,OTHER_COMM,preciMax,maxTemp,PER_PROF,PER_POV,POP_GRAD,PER_NO_INS,PER_COMM,PER_MALE
01001,"Autauga County, Alabama",55036,26899,28137,27824,36757,5316,3058,426,376,54170,2171,2585,4756,7483,3143,4340,24325,280,10.76,91.8,7.013591104004652,13.596554982193473,3860,98.42648448288394,44.19834290282724,0.4887528163383967
01003,"Baldwin County, Alabama",203360,99527,103833,29364,143022,29237,10714,2885,1132,200929,11841,9831,21672,23728,10271,13457,87837,828,15.8,90.3,7.243804091266719,11.667977970102282,14731,98.80458300550747,43.19285995279308,0.4894128638867034
01005,"Barbour County, Alabama",26201,13976,12225,17561,18434,1403,656,90,69,23326,1676,1196,2872,6332,2675,3657,8683,98,11.84,92.1,3.1105682989198886,24.16701652608679,815,89.02713636884089,33.139956490210295,0.5334147551620168
01007,"Bibb County, Alabama",22580,12251,10329,20911,15859,1289,617,92,99,20553,881,784,1665,3133,1395,1738,8024,125,11.39,90.8,3.578387953941541,13.87511071744907,808,91.02302922940656,35.53587245349867,0.5425597874224978
01009,"Blount County, Alabama",57667,28490,29177,22021,39475,3416,1378,216,162,57207,3510,2800,6310,8919,4116,4803,21230,64,9.46,89.7,3.0450691036468,15.466384587372326,1756,99.20231674961417,36.81481609932891,0.4940433870324449
01011,"Bullock County, Alabama",10478,5616,4862,20856,7377,485,334,115,56,10113,923,502,1425,2852,1130,1722,4290,75,12.07,91.4,4.819622065279633,27.218934911242602,505,96.51651078450085,40.94292803970223,0.5359801488833746
01013,"Butler County, Alabama",20126,9416,10710,19004,13958,1342,667,132,112,19832,1025,1227,2252,4835,1933,2902,7623,72,12.19,91,4.526483156116466,24.02365099870814,911,98.5392030209679,37.87637881347511,0.4678525290668787
01015,"Calhoun County, Alabama",115527,55593,59934,23638,78975,8092,4284,997,740,113964,6324,5569,11893,20940,8670,12270,46289,404,7.6,90.3,5.211768677452024,18.125632968916356,6021,98.64706951621699,40.067689804115055,0.4812121841647407
01017,"Chambers County, Alabama",33895,16320,17575,22002,23698,2131,713,273,41,33513,2070,2012,4082,6288,2684,3604,14241,68,10.7,89.9,3.029945419678419,18.55140876235433,1027,98.87299011653636,42.01504646703054,0.4814869449771353
01019,"Cherokee County, Alabama",25855,12862,12993,23010,18797,1237,710,280,117,25561,1277,1028,2305,4104,1970,2134,9731,25,7.82,89.8,4.281570295880874,15.873138657899826,1107,98.86288918971185,37.63682073099981,0.49746664088184106
01021,"Chilton County, Alabama",43805,21554,22251,23368,29697,2809,1268,289,118,43473,3453,2975,6428,8392,3792,4600,17386,302,11.03,90.4,3.8237644104554276,19.15763040748773,1675,99.24209565118137,39.689533158315264,0.4920442871818286
01023,"Choctaw County, Alabama",13188,6277,6911,20994,9449,745,276,45,34,13060,751,681,1432,2903,1260,1643,4230,47,13.63,91.1,2.691841067637246,22.012435547467394,355,99.029420685471635,32.074613284804364,0.4759629966636336
01025,"Clarke County, Alabama",24625,11649,12976,20765,16921,1422,579,85,107,24341,1250,1396,2646,6108,2448,3660,7805,195,14.82,90.6,3.130964467005076,24.804060913705584,771,98.84670050761422,31.695431472081218,0.47305583756345176
01027,"Clay County, Alabama",13407,6471,6936,21330,9455,562,317,45,46,13153,876,855,1731,2493,1013,1480,5402,31,11.13,89.2,3.0431863951667038,18.594763929290668,408,98.10546729320504,40.2923845752219,0.48265831282166033
01029,"Cleburne County, Alabama",14939,7367,7572,20873,10387,807,318,120,38,14758,1094,1036,2130,2800,1180,1620,5469,7,8.51,89.4,3.186290916393333,18.742887743490193,476,98.78840618515295,36.60887609612424,0.49313876430818665
01031,"Coffee County, Alabama",51073,25225,25848,26216,34736,5111,2193,307,266,49425,2618,2569,5187,8122,3516,4606,22159,196,12.84,91.4,5.415777416638929,15.902727468525445,2766,96.77324613788107,43.3869167661974,0.4939008869657157
01033,"Colbert County, Alabama",54435,26143,28292,23675,38423,4403,2297,331,176,53993,2457,2200,4657,9056,3832,5224,21809,153,7.53,90.4,5.151097639386424,16.636355286121063,2804,99.18802241205107,40.06429686782401,0.48026086157802883
01035,"Conecuh County, Alabama",12649,6040,6609,16337,8772,458,267,30,13,12603,962,1021,1983,3316,1420,1896,3897,2,13.14,91,2.450786623448494,26.21551110759744,310,99.63633488813345,30.808759585738002,0.477508103407384
01037,"Coosa County, Alabama",10955,5474,5481,20342,8117,611,255,12,14,10563,549,510,1059,1513,675,838,3750,21,12.3,90.3,2.565038795070744,13.811045184847101,281,96.42172523961662,34.230944774075766,0.4996805111821086
01039,"Covington County, Alabama",37519,18133,19386,22431,26416,2740,1028,265,66,36970,2347,2002,4349,6491,2845,3646,14532,165,14.71,91.2,3.6221647698499426,17.300567712359072,1359,98.53674138436526,38.732375596364506,0.4833017937578294
01041,"Crenshaw County, Alabama",13866,6786,7080,21580,9588,1143,377,21,21,13666,787,672,1459,2399,1060,1339,5611,36,12.42,91,3.021779893264099,17.301312563103995,419,98.55762296264244,40.46588778306649,0.4893985287754219
01043,"Cullman County, Alabama",81703,40223,41480,21857,56720,5409,2206,634,208,80867,5372,5486,10858,13157,6031,7126,31603,171,8.3,89.4,3.7305851682312765,16.10344785381198,3048,98.97678175831977,38.68034221509614,0.49230750400842077
01045,"Dale County, Alabama",49393,24524,24869,23194,33288,3688,1520,270,109,46471,2934,2803,5737,9441,4143,5298,20282,210,12.69,91.7,3.844674346567327,19.114044500232826,1899,94.08418196910493,41.06249873463851,0.4965076022918227
01047,"Dallas County, Alabama",40755,18809,21946,18248,26849,2181,1275,252,101,40454,2595,2304,4899,12795,5198,7597,14063,151,10.66,92.4,3.9946018893387314,31.39492086860508,1628,99.26144031407189,34.50619555882714,0.4615139246718194
01049,"DeKalb County, Alabama",71194,35328,35866,20020,47694,3638,1875,428,261,70448,5559,5061,10620,15115,6558,8557,28110,135,8.6,87.3,3.6014270865522375,21.23072169003006,2564,98.95215888979408,39.48366435373767,0.49622159170716634
01051,"Elmore County, Alabama",80989,39357,41632,26251,55278,7983,3614,603,429,75789,3327,2526,5853,10299,4318,5981,32647,98,11.72,91.6,5.736581511069405,12.716541752583684,4646,93.57937497684871,40.31041252515774,0.48595488276185655
01053,"Escambia County, Alabama",37621,19326,18295,18164,25896,1956,848,238,104,34883,2476,2978,5454,8281,3574,4707,11916,47,15.57,91,3.1631269769543606,22.01164243374711,1190,92.72214986310837,31.67379920788921,0.5137024534169745
01055,"Etowah County, Alabama",103132,49738,53394,22278,71745,7435,3328,918,438,102339,6649,5340,11989,18166,7814,10352,40402,173,7.91,89.8,4.541752317418454,17.61431951285731,4684,99.23108249621843,39.17503781561494,0.4822751425357794
01057,"Fayette County, Alabama",16657,8191,8466,21191,11715,1178,463,34,37,16468,769,605,1374,2967,1311,1656,6203,33,7.97,90.9,3.2058593984511017,17.8123311520682,534,98.86534189830101,37.23959896740109,0.49174521222308937
01059,"Franklin County, Alabama",31507,15818,15689,19314,20734,1722,788,142,126,31272,1734,2023,3757,7175,3234,3941,12456,275,7.84,89.1,3.3516361443488747,22.772717173961343,1056,99.25413400196781,39.53407179356968,0.5020471641222586
01061,"Geneva County, Alabama",26572,13008,13564,21084,18666,1407,603,66,0,26211,1917,1731,3648,5903,2586,3317,10204,208,11.44,91.3,2.5176877916603946,22.215113653469817,669,98.6414270660846,38.401324702694566,0.4895378594008731
01063,"Greene County, Alabama",8533,4058,4475,14197,5830,486,125,15,37,8480,652,462,1114,3293,1539,1754,2402,42,10.78,91.6,2.074299777335052,38.59135122465721,177,99.37888198757764,28.14953709129263,0.47556545177546
01065,"Hale County, Alabama",14995,7049,7946,20269,10161,1008,286,136,34,14762,859,717,1576,3852,1549,2303,5148,62,11.06,91.4,3.0410136712237414,25.68856285428476,456,98.44614871623875,34.33144381460487,0.4700900300100033
01067,"Henry County, Alabama",17110,8208,8902,23983,12123,1087,835,117,35,16828,1004,815,1819,2310,1135,1175,6865,225,12.3,91.9,5.768556399766219,13.500876680303916,987,98.35184102863822,40.12273524254822,0.4797194623027469
01069,"Houston County, Alabama",104108,49905,54203,24781,71238,9418,3939,1058,488,103300,6118,5258,11376,19030,8135,10895,43572,242,11.55,91.4,5.268567257079187,18.279094786183578,5485,99.22388289084412,41.85269143581665,0.4793579744111884
01071,"Jackson County, Alabama",52326,25712,26614,20946,37016,3192,1331,161,272,51817,3105,2413,5518,9827,4533,5294,19975,152,8.36,88.2,3.371173030615755,18.780338646179718,1764,99.02725222642664,38.174139051332034,0.49138095784122615
01073,"Jefferson County, Alabama",659460,312333,347127,29456,447048,86862,34310,13878,7629,652283,35896,30988,66884,113368,49345,64023,295958,2067,11.62,90.6,8.464046340945622,17.191035089315502,55817,98.91168531829072,44.878840263245685,0.4736193249021927
01075,"Lamar County, Alabama",14021,6875,7146,21152,9938,880,365,28,44,13856,673,800,1473,3191,1355,1836,5317,0,7.17,91.8,3.1167534412666713,22.758719064260752,437,98.82319378075744,37.921688895228584,0.49033592468440196
01077,"Lauderdale County, Alabama",92590,44263,48327,25803,63168,8710,4096,667,757,91721,4934,4473,9407,14701,6256,8445,39262,125,6.42,90.5,5.961766929474026,15.87752457068798,5520,99.06145372070418,42.40414731612485,0.47805378550599414
01079,"Lawrence County, Alabama",33288,16164,17124,22419,23370,1671,605,62,42,33050,1814,1399,3213,5490,2389,3101,12300,55,6.38,89.1,2.129896659456861,16.49242970439798,709,99.28502763758712,36.95025234318673,0.4855803893294881
01081,"Lee County, Alabama",156597,77172,79425,26170,92452,18261,9345,1694,2922,154952,7131,6279,13410,33132,14975,18157,70876,346,10.76,90.1,8.915241032714547,21.15749343857162,13961,98.9495328773859,45.26012631148745,0.49280637560106516
01083,"Limestone County, Alabama",91695,45889,45806,26685,63026,10410,4085,553,446,88681,5306,4586,9892,13138,5570,7568,38648,191,6.84,89.2,5.544468073504553,14.327935001908502,5084,96.71301597687987,42.14842684988276,0.5004525873820819
01085,"Lowndes County, Alabama",10362,4896,5466,18976,7065,671,246,33,21,10268,736,528,1264,3095,1413,1682,3421,61,11.66,92.2,2.895193977996526,29.868751206330824,300,99.09283922022776,33.01486199575371,0.472495657209033
01087,"Macon County, Alabama",19358,8933,10425,19564,12280,1332,801,165,168,19141,1219,713,1932,4380,1883,2497,7178,87,11.42,91.4,5.858043186279574,22.626304370286185,1134,98.87901642731687,37.08027688810827,0.4614629610496952
01089,"Madison County, Alabama",353213,172568,180645,34232,239756,60410,28926,3758,4228,348398,17669,16115,33784,46925,20787,26138,167817,1830,7.41,89.4,10.450351487629277,13.285184860126892,36912,98.63679989128373,47.511558181607136,0.48856638911931327
01091,"Marengo County, Alabama",19743,9235,10508,22996,13557,1315,611,83,80,19526,1196,888,2084,5000,2116,2884,6542,151,11.46,92.1,3.9203768424251635,25.325431798612165,774,98.90087625994023,33.13579496530416,0.4677607253203667
01093,"Marion County, Alabama",30058,14880,15178,21835,21406,1784,970,104,20,29540,1420,1409,2829,5175,2432,2743,11629,159,7.16,89.8,3.6396300485727595,17.21671435225231,1094,98.27666511411272,38.688535498037126,0.495042917027081
01095,"Marshall County, Alabama",94738,46771,47967,22710,63248,7353,3036,512,311,93913,7590,6864,14454,19654,8424,11230,37835,126,8.44,88.7,4.073339103633177,20.74563533112373,3859,99.1291773100551,39.936456332200386,0.4936878549262176
01097,"Mobile County, Alabama",414328,197968,216360,24347,275878,42066,15743,3606,2130,406941,24792,24277,49069,78256,32827,45429,171077,1134,14.9,90.3,5.1840570755536675,18.88745148771022,21479,98.21711301191327,41.29023382440965,0.47780502403892566
01099,"Monroe County, Alabama",21745,10355,11390,17264,14794,1079,576,67,121,21518,1494,1727,3221,7249,3208,4041,6111,66,13.64,91.1,3.5134513681306045,33.3363991722235,764,98.95608185789837,28.103012186709588,0.47620142561508394
01101,"Montgomery County, Alabama",227120,107470,119650,26712,149318,28898,13859,3348,2058,222268,13243,11439,24682,45863,19394,26469,99969,499,12.3,92.2,8.48230010567101,20.19328989080662,19265,97.86368439591405,44.015938710813664,0.47318598097921805
01103,"Morgan County, Alabama",119157,58761,60396,25013,82094,11822,4040,897,383,117243,6715,6418,13133,19448,8267,11181,49709,310,7.12,89.4,4.464697835628624,16.321323967538625,5320,98.39371585387346,41.717230208884075,0.49313930360784514
01105,"Perry County, Alabama",9680,4630,5050,13449,5858,512,401,11,67,9532,692,665,1357,3706,1882,1824,2439,106,11.61,91.9,4.948347107438017,38.28512396694215,479,98.47107438016529,25.196280991735538,0.47830578512396693
01107,"Pickens County, Alabama",20170,9601,10569,20089,14241,1248,355,46,30,18987,979,718,1697,4340,1742,2598,6775,22,8.27,92.4,2.136836886465047,21.51710461080813,431,94.13485374318294,33.58948934060486,0.4760039662865642
01109,"Pike County, Alabama",33287,15897,17390,20808,19657,2930,1417,149,364,33081,1588,1334,2922,8224,3678,4546,14028,61,13.68,90.9,5.798059302430378,24.70634181512302,1930,99.38113978430017,42.14257818367531,0.47757382762039235
01111,"Randolph County, Alabama",22530,10998,11532,20983,15594,1415,725,89,40,22276,1408,1321,2729,4102,1875,2227,8400,81,11.14,89.5,3.7905015534842432,18.206835330670216,854,98.87261429205503,37.28362183754993,0.4881491344873502
01113,"Russell County, Alabama",58480,28424,30056,21279,38710,4092,2012,251,181,56790,4290,3546,7836,12024,5249,6775,23772,167,11.31,91.2,4.179206566347469,20.560875512995896,2444,97.11012311901504,40.64979480164158,0.48604651162790696
01115,"St. Clair County, Alabama",86937,43469,43468,24686,60248,6366,2391,443,443,85000,3373,3311,6684,11656,5194,6462,37923,426,10.04,90.3,3.769396229453512,13.407409963536814,3277,97.77194980273072,43.62124296904655,0.5000057512911649
01117,"Shelby County, Alabama",208721,101420,107301,35330,141263,39369,15003,3304,1983,207053,8516,6834,15350,17127,7438,9689,102784,516,11.96,90.5,9.721110956731714,8.205690850465453,20290,99.20084706378371,49.24468548924162,0.4859118152941007
01119,"Sumter County, Alabama",13084,6033,7051,14739,8244,872,537,52,41,12946,1079,1111,2190,4398,1842,2556,4239,0,10.28,91.9,4.81504127178233,33.61357383063283,630,98.94527667380007,32.39834912870682,0.46109752369306023
01121,"Talladega County, Alabama",80888,39140,41748,21382,56103,4620,2296,474,216,77941,4276,3661,7937,14946,6613,8333,30156,194,11.46,90.5,3.691524082682227,18.477400850558798,2986,96.35669073286519,37.281178914054,0.48387894372465634
01123,"Tallapoosa County, Alabama",40756,19616,21140,22430,28609,3474,1265,321,150,40211,1857,1906,3763,8532,3554,4978,15124,131,10.3,90.6,4.259495534399843,20.934340955932868,1736,98.66277357935029,37.10864657964471,0.481303366375503
01125,"Tuscaloosa County, Alabama",204424,98725,105699,24895,125145,23230,10010,1987,2598,202930,9694,7858,17552,33597,14289,19308,89791,328,11.59,91.1,7.139572652917465,16.43495871326263,14595,99.26916604703949,43.923903259891205,0.4829423159707275
01127,"Walker County, Alabama",64927,31709,33218,21217,45197,3014,1451,442,103,64196,3930,3523,7453,13754,6263,7491,23873,158,9.08,90.3,3.074221818349839,21.183791026845533,1996,98.87412016572458,36.76898670814915,0.4883792567036826
01129,"Washington County, Alabama",16746,8342,8404,23239,11607,785,358,95,0,16621,694,889,1583,3644,1554,2090,5612,73,18.86,90.4,2.7051236116087423,21.760420398901232,453,99.25355308730443,33.51248059238027,0.498148811656515
01131,"Wilcox County, Alabama",10919,5096,5823,15774,7242,578,204,59,27,10621,771,811,1582,3371,1385,1986,2888,6,11.72,91.9,2.655920871874714,30.872790548585034,290,97.27081234545288,26.44930854473853,0.46670940562322555
01133,"Winston County, Alabama",23968,11850,12118,20580,17255,1354,620,146,110,23646,1489,1289,2778,4395,1736,2659,8476,123,7.18,88.7,3.6548731642189587,18.336949265687583,876,98.65654205607477,35.36381842456609,0.4944092122830441
04001,"Apache County, Arizona",71602,35355,36247,13865,43766,3340,1347,112,221,70807,8745,7503,16248,25225,12301,12924,18014,164,2.51,88.5,2.3463031758889414,35.229462864165804,1680,98.88969581855255,25.15851512527583,0.4937711237116282
04003,"Cochise County, Arizona",126516,64094,62422,24896,87509,12916,6288,897,575,115099,5141,5218,10359,21054,8833,12221,46348,583,4.67,97.8,6.133611559012299,16.64137342312435,7760,90.97584495241709,36.63410161560593,0.5066078598754308
04005,"Coconino County, Arizona",138639,68264,70375,25722,80822,16933,8170,1602,1917,137820,10309,8532,18841,26719,12905,13814,64026,618,2.74,91.2,8.431249504107791,19.272354820793574,11689,99.40925713543808,46.181810313115356,0.4923867021545164
04007,"Gila County, Arizona",53145,26284,26861,22433,38632,4513,2042,463,323,52401,3456,3049,6505,11427,5251,6176,17501,147,5.09,95.2,5.321290808166338,21.50155235675981,2828,98.60005644933672,32.93066139806191,0.4945714554520651
04009,"Graham County, Arizona",37700,20233,17467,17874,23350,2120,940,172,65,33658,1650,1321,2971,7089,3111,3978,11911,109,4.33,96.7,3.1220159151193636,18.80371352785146,1177,89.27851458885942,31.594164456233422,0.5366843501326259
04011,"Greenlee County, Arizona",9368,4997,4371,24935,5834,560,123,11,13,9325,404,302,706,1069,509,560,3656,27,3.67,91.4,1.5691716481639624,11.411187019641332,147,99.54099060631938,39.026473099914604,0.5334116140051238
04012,"La Paz County, Arizona",20477,10530,9947,21707,15536,1145,457,34,110,20309,1291,1208,2499,3971,1872,2099,6357,21,1.41,106.8,2.935000244176393,19.39248913415051,601,99.17956731943156,31.044586609366608,0.5142354837134346
04013,"Maricopa County, Arizona",4155501,2055464,2100037,30186,2730613,546841,226449,52841,32641,4125142,278633,229259,507892,644476,299424,345052,1902120,21587,1.77,106,7.506459509936347,15.508984355917613,311931,99.26942623765461,45.77354210719718,0.4946368680936426
04015,"Mohave County, Arizona",204691,103175,101516,23527,153930,12194,4604,1544,634,200916,13703,11057,24760,37080,17533,19547,68100,802,2.64,98.1,3.3132868567743574,18.115110092773985,6782,98.15575672599186,33.26966012184219,0.5040524497901715
04017,"Navajo County, Arizona",107902,54037,53865,17685,68236,6428,3177,497,447,105552,8885,7089,15974,30548,13969,16579,32554,604,2.67,91.1,3.8192063168430614,28.310874682582345,4121,97.82209782951196,30.16996904598617,0.5007970195177105
04019,"Pima County, Arizona",1007257,495714,511543,27323,666989,121598,60484,15099,13699,987178,57881,50296,108177,179569,82744,96825,428675,5112,3.46,103.1,8.863874860139964,17.82752564638419,89282,98.00656634801247,42.55865186342711,0.4921425217198788
04021,"Pinal County, Arizona",405537,211665,193872,22944,276364,32987,14490,1903,1933,380940,21267,17879,39146,58750,27126,31624,142275,1617,3.12,103.9,4.518946483304853,14.486964198087968,18326,93.93470879352562,35.083112021837714,0.5219375790618366
04023,"Santa Cruz County, Arizona",46358,22229,24129,19482,28877,4380,1440,418,157,46024,2909,2911,5820,10049,4602,5447,17246,222,6.78,96.2,4.3466068424004485,21.676948962422884,2015,99.2795202554036,37.20177747098667,0.4795073126536952
04025,"Yavapai County, Arizona",220972,108100,112872,27504,168134,24698,12227,3061,2082,219401,13310,11479,24789,31859,14701,17158,81737,643,3.72,96.4,7.860724435675108,14.41766377640606,17370,99.28905019640497,36.98975435801821,0.48920225186901506
04027,"Yuma County, Arizona",204281,104914,99367,20600,127583,11782,5071,1035,407,197418,15900,13821,29721,39161,17517,21644,76330,561,1.37,107.4,3.188255393306279,19.170162668089542,6513,96.64041198153524,37.36519793813424,0.5135768867393443
05001,"Arkansas County, Arkansas",18352,8785,9567,23766,12722,1241,447,30,75,18112,905,616,1521,3735,1527,2208,7763,63,6.39,90.5,3.007846556233653,20.352005231037488,552,98.6922406277245,42.30056669572799,0.4786944202266783
05003,"Ashley County, Arkansas",20771,10126,10645,20703,14166,1333,462,57,47,20610,1128,1163,2291,4368,1998,2370,7782,187,9.56,92.3,2.724953059554186,21.02931972461605,566,99.2248808434837,37.46569736652063,0.48750661980646093
05005,"Baxter County, Arkansas",41093,19857,21236,24737,31590,3914,1437,307,162,40681,1817,1257,3074,5117,2620,2497,15499,61,12.25,88.9,4.638259557588884,12.452242474387365,1906,98.9973961501959,37.716886087654835,0.48322098654272017
05007,"Benton County, Arkansas",251823,124632,127191,30611,163405,34624,13101,2769,1238,250348,13390,12457,25847,26096,11820,14276,118846,508,13.54,89.2,6.793660626710031,10.362834212919392,17108,99.41427113488442,47.194259460017555,0.49491905028531946
05009,"Boone County, Arkansas",37212,18198,19014,22288,25897,2721,1185,114,183,36790,1875,1384,3259,5767,2459,3308,15419,102,12.5,88.7,3.982586262495969,15.497688917553477,1482,98.86595721810168,41.4355584220144,0.48903579490486937
05011,"Bradley County, Arkansas",10994,5262,5732,21575,7530,736,304,29,18,10901,791,670,1461,2864,1142,1722,4033,111,8.37,92,3.192650536656358,26.05057303983991,351,99.15408404584319,36.6836456248863,0.47862470438420956
05013,"Calhoun County, Arkansas",5194,2693,2501,22866,3719,302,115,10,30,5136,290,239,529,986,466,520,2185,28,9.16,91.5,2.9842125529457064,18.983442433577203,155,98.88332691567193,42.06777050442819,0.5184828648440508
05015,"Carroll County, Arkansas",27782,13634,14148,21754,19549,2302,1058,145,277,27564,1736,1905,3641,4331,2020,2311,11076,31,12.31,88.7,5.327190267079404,15.58923043697358,1480,99.21531927147073,39.867540133899645,0.4907494060902743
05017,"Chicot County, Arkansas",11008,5401,5607,20560,7711,727,197,55,37,10332,545,642,1187,3041,1206,1835,3648,132,10.78,91.6,2.625363372093023,27.625363372093023,289,93.85901162790698,33.13953488372093,0.4906431686046512
05019,"Clark County, Arkansas",22495,10697,11798,20382,13186,2165,917,145,251,22138,1093,930,2023,4221,1645,2576,10178,59,8.87,91.6,5.836852633918649,18.76416981551456,1313,98.41298066236942,45.245610135585686,0.4755278950877973
05021,"Clay County, Arkansas",15190,7421,7769,19171,10667,725,337,65,10,15054,821,600,1421,3339,1466,1873,6169,31,8.94,90.3,2.7123107307439103,21.981566820276498,412,99.1046741277156,40.61224489795919,0.4885450954575379
05023,"Cleburne County, Arkansas",25361,12494,12867,26189,18802,1800,746,258,178,25022,1644,1210,2854,3829,1561,2268,9878,130,10.27,89.6,4.660699499231103,15.097985095224951,1182,98.66330192027128,38.949568234691064,0.492646189030401
05025,"Cleveland County, Arkansas",8332,4189,4143,23171,5735,641,257,65,12,8229,308,312,620,1589,768,821,3272,62,9.24,91,4.008641382621219,19.071051368218914,334,98.76380220835334,39.27028324531925,0.5027604416706674
05027,"Columbia County, Arkansas",23992,11498,12494,20296,14863,1997,940,102,151,23566,1036,1262,2298,5553,2335,3218,9672,16,8.15,91.3,4.972490830276759,23.145215071690565,1193,98.22440813604535,40.3134378126042,0.479243081027009
05029,"Conway County, Arkansas",20954,10313,10641,22365,14496,1500,599,89,109,20821,953,908,1861,3845,1770,2075,8324,99,9.14,92.3,3.8035697241576787,18.349718430848526,797,99.36527631955713,39.72511215042474,0.4921733320607044
05031,"Craighead County, Arkansas",104246,50774,53472,25594,66594,11235,4398,1108,928,103216,6427,4695,11122,18298,8154,10144,47487,197,8.94,90.4,6.171939450914183,17.5527118546515,6434,99.0119524969783,45.55282696698195,0.48705945551867696
05033,"Crawford County, Arkansas",62119,30587,31532,22104,41681,4184,1372,280,212,61510,3554,3075,6629,10196,4822,5374,25578,46,8.86,91.5,3.0006922197717283,16.413657657077543,1864,99.01962362562179,41.1758077238848,0.4923936315781001
05035,"Crittenden County, Arkansas",49278,23303,25975,20721,31104,3440,1370,279,173,48739,2378,2609,4987,11422,4884,6538,19901,386,6.86,91.2,3.697390316165429,23.178700434270873,1822,98.90620560899387,40.385161735460045,0.4728885100856366
05037,"Cross County, Arkansas",17164,8323,8841,22894,11552,905,556,99,29,16940,771,646,1417,3041,1263,1778,7191,113,9.19,90.6,3.9850850617571663,17.71731531111629,684,98.69494290375204,41.895828478210206,0.48491027732463293
05039,"Dallas County, Arkansas",7585,3639,3946,18309,5331,569,154,26,3,6944,412,332,744,906,382,524,2859,18,10.12,90.6,2.4126565589980222,11.944627554383652,183,91.54911008569545,37.692814765985496,0.4797626895187871
05041,"Desha County, Arkansas",12094,5547,6547,18187,7981,722,241,30,15,12026,578,642,1220,3886,1626,2260,4395,76,8.4,90.2,2.364808996196461,32.13163552174632,286,99.43773772118406,36.34033404994212,0.4586571853811808
05043,"Drew County, Arkansas",18620,9090,9530,20300,11647,1399,526,76,149,18211,969,594,1563,4246,1939,2307,7548,45,10.03,91.3,4.033297529538131,22.80343716433942,751,97.80343716433941,40.537056928034374,0.4881847475832438
05045,"Faulkner County, Arkansas",121282,59387,61895,25240,73744,13732,6045,924,1190,120096,7089,5862,12951,18989,8805,10184,56618,546,10.11,92.3,6.727296713444699,15.656898797843043,8159,99.02211375142231,46.682937286654244,0.48966046074438085
05047,"Franklin County, Arkansas",17803,8674,9129,19988,12127,1060,217,30,64,17492,720,709,1429,3829,1781,2048,6501,36,9.65,91.4,1.7468965904622817,21.507611076784812,311,98.25310340953772,36.516317474582934,0.4872212548446891
05049,"Fulton County, Arkansas",12092,5947,6145,19674,8828,687,359,17,9,11923,744,456,1200,2718,1362,1356,4112,49,10.24,89.4,3.1839232550446575,22.477671187562024,385,98.60238173999339,34.00595434998346,0.4918127687727423
05051,"Garland County, Arkansas",97994,47269,50725,25690,70624,9096,3656,855,618,96780,6842,5848,12690,18300,8685,9615,38978,218,8.89,91.1,5.2339939179949795,18.67461273139172,5129,98.76114864175358,39.7759046472233,0.4823662673224891
05053,"Grant County, Arkansas",18076,8829,9247,25814,12460,1577,616,60,114,17909,667,569,1236,2579,1139,1440,7486,66,8.35,91.8,4.370435937154237,14.267537065722506,790,99.07612303606993,41.414029652578,0.48843770745740206
05055,"Greene County, Arkansas",44197,21806,22391,22094,29424,3204,1216,175,152,43711,2116,1813,3929,6879,2833,4046,18401,110,9.08,90.2,3.491187184650542,15.564404823856822,1543,98.90037785370048,41.634047559789124,0.4933819037491232
05057,"Hempstead County, Arkansas",22154,10380,11774,18817,14441,1228,543,51,65,21909,1223,1037,2260,5539,2267,3272,8655,95,9.83,91.3,2.9746321206102735,25.002256928771327,659,98.89410490204929,39.06743703168728,0.468538412927688
05059,"Hot Spring County, Arkansas",33480,17294,16186,20868,23757,2077,1031,98,76,31439,1608,1863,3471,4941,2185,2756,12982,63,8.17,91.6,3.599163679808841,14.758064516129032,1205,93.90382317801672,38.775388291517324,0.516547192353644
05061,"Howard County, Arkansas",13472,6582,6890,23627,8938,1023,293,51,0,13296,822,742,1564,2790,1169,1621,5438,25,9.95,90.6,2.553444180522565,20.709619952494062,344,98.6935866983373,40.36520190023753,0.4885688836104513
05063,"Independence County, Arkansas",37097,18054,19043,23056,25097,2861,1153,281,227,36603,2177,2012,4189,6628,2594,4034,15116,215,10.36,89.4,4.477451006819958,17.866673855028708,1661,98.6683559317465,40.74723023425075,0.4866700811386365
05065,"Izard County, Arkansas",13521,6971,6550,19737,10150,874,379,23,31,12641,523,508,1031,2238,977,1261,4533,53,9.65,88.1,3.202425856075734,16.552030175282894,433,93.49160565046964,33.525626802751276,0.5155683751201834
05067,"Jackson County, Arkansas",17429,8575,8854,19458,12454,755,361,0,34,14320,1008,681,1689,3592,1794,1798,5612,55,9.93,90.6,2.266337713007057,20.609329278788227,395,82.16191405129382,32.19920821619141,0.4919960984565953
05069,"Jefferson County, Arkansas",71373,35154,36219,20371,47738,5136,2102,405,380,66984,3081,2929,6010,16140,6973,9167,26354,613,7.62,91,4.044946968741681,22.613593375646253,2887,93.85061577907612,36.92432712650442,0.4925391954940944
05071,"Johnson County, Arkansas",26155,12977,13178,18757,17133,1714,818,52,113,25958,1666,1199,2865,5733,2655,3078,10240,188,9.41,90.2,3.7583636016058115,21.9193270885108,983,99.2467979353852,39.151213917033076,0.4961575224622443
05073,"Lafayette County, Arkansas",7051,3460,3591,25140,5088,612,87,40,23,6918,432,406,838,1632,685,947,2489,31,7.23,91.8,2.1273578215855906,23.145653098851227,150,98.11374273152744,35.29995745284357,0.49071053751240956
05075,"Lawrence County, Arkansas",16777,8285,8492,19422,11386,1198,485,22,56,16483,824,767,1591,2976,1438,1538,6249,61,9.75,90.4,3.355784705251237,17.73857066221613,563,98.2476008821601,37.24742206592359,0.4938308398402575
05077,"Lee County, Arkansas",9614,5455,4159,15610,6893,395,167,15,2,7998,582,325,907,2173,818,1355,2747,36,8.13,90.7,1.9138755980861244,22.6024547534845,184,83.19117952985229,28.572914499687954,0.5674017058456418
05079,"Lincoln County, Arkansas",13885,8643,5242,13142,10268,576,181,26,32,9086,382,484,866,1620,701,919,3147,9,7.89,90.5,1.7212819589485056,11.66726683471372,239,65.43752250630176,22.664746128916097,0.6224702916816709
05081,"Little River County, Arkansas",12494,6157,6337,23412,8956,661,237,18,5,12333,781,585,1366,2291,1040,1251,4500,11,10.37,91.9,2.080998879462142,18.336801664799104,260,98.71138146310228,36.01728829838322,0.49279654234032333
05083,"Logan County, Arkansas",21802,10764,11038,19708,15234,1324,440,55,16,21550,913,952,1865,4326,2048,2278,8198,68,8.14,92,2.343821667736905,19.842216310430235,511,98.84414273919823,37.602054857352535,0.4937161728281809
05085,"Lonoke County, Arkansas",71568,35222,36346,25184,46871,6732,2150,388,163,69999,3110,3108,6218,8709,3731,4978,32903,172,9.51,91.3,3.774033087413369,12.168846411804159,2701,97.80767940979209,45.97445785826068,0.492147328414934
05087,"Madison County, Arkansas",15907,8005,7902,23203,10914,793,287,80,101,15829,1055,947,2002,2797,1218,1579,6520,76,9.84,87.2,2.942100961840699,17.583453825359904,468,99.50964983969321,40.988244169233674,0.5032375683661281
05089,"Marion County, Arkansas",16374,8050,8324,19200,12502,1270,594,84,56,16244,717,664,1381,3165,1433,1732,5251,0,12.58,89.1,4.4827165017711,19.32942469769146,734,99.2060583852449,32.069133992915596,0.49163307682911933
05091,"Miller County, Arkansas",43760,21581,22179,22227,29694,3211,1104,218,148,42566,2840,2701,5541,8891,3644,5247,17919,130,7.93,92,3.359232175502742,20.31764168190128,1470,97.27148080438756,40.94835466179159,0.4931672760511883
05093,"Mississippi County, Arkansas",43534,21030,22504,20378,27903,2227,767,173,228,42774,2335,2255,4590,10921,4714,6207,16713,103,6.68,90.2,2.682960444709882,25.08613956907245,1168,98.25423806679837,38.39068314420913,0.48307070335829466
05095,"Monroe County, Arkansas",7420,3435,3985,20486,5193,379,88,17,0,7346,412,393,805,2098,920,1178,2762,16,6.92,90.6,1.4150943396226414,28.274932614555254,105,99.00269541778975,37.22371967654986,0.46293800539083557
05097,"Montgomery County, Arkansas",9059,4487,4572,21480,6762,511,259,31,30,8922,671,440,1111,1613,629,984,3149,9,9.85,91.3,3.5323987195054642,17.80549729550723,320,98.48769179821173,34.76101114913346,0.4953085329506568
05099,"Nevada County, Arkansas",8528,4444,4084,18644,5855,676,245,43,33,8360,539,411,950,1920,1067,853,3218,61,9.31,91.4,3.7640712945590993,22.5140712945591,321,98.03001876172608,37.73452157598499,0.5211069418386491
05101,"Newton County, Arkansas",7898,3979,3919,18053,5795,582,264,27,36,7835,368,334,702,1392,617,775,2995,40,9.41,86.6,4.140288680678653,17.62471511775133,327,99.20232970372246,37.9209926563687,0.503798429982274
05103,"Ouachita County, Arkansas",24378,11547,12831,19780,16834,1549,849,106,72,23997,1290,1021,2311,6231,2477,3754,9178,64,9.59,91.2,4.212814833046189,25.559931085404873,1027,98.43711543194684,37.648699647222905,0.47366477971941917
05105,"Perry County, Arkansas",10320,5116,5204,21781,7202,692,192,21,27,10209,431,404,835,1808,731,1077,3890,16,9.05,91.9,2.3255813953488373,17.51937984496124,240,98.92441860465117,37.6937984496124,0.49573643410852714
05107,"Phillips County, Arkansas",19518,9210,10308,17287,12482,863,368,106,76,19349,1390,1137,2527,6363,2689,3674,6620,116,7.08,90.5,2.8179116712777947,32.600676298801105,550,99.13413259555283,33.91740957065273,0.47187211804488166
05109,"Pike County, Arkansas",10893,5415,5478,20180,7609,609,428,51,45,10747,685,600,1285,1852,827,1025,4365,115,10.47,90.9,4.810428715688975,17.00174423941981,524,98.65968970898743,40.071605618286974,0.497108234646103
05111,"Poinsett County, Arkansas",24098,11808,12290,18361,16332,1160,326,43,68,23782,1677,1472,3149,5036,2277,2759,9257,43,8.91,90.8,1.8134285002904806,20.89799983401112,437,98.68868785791352,38.41397626359034,0.4899991700556063
05113,"Polk County, Arkansas",20212,9869,10343,18735,14096,1110,496,77,85,20081,1423,1407,2830,5326,2600,2726,7138,43,7.43,90.1,3.2554917870571938,26.35068276271522,658,99.35187017613299,35.31565406689096,0.48827429249950527
05115,"Pope County, Arkansas",63372,31373,31999,21650,39964,5826,2168,525,358,62737,3376,3290,6666,11841,5766,6075,26658,372,8.48,90.2,4.8144290854004925,18.68490816133308,3051,98.99798018052137,42.06589661049044,0.49506091018115256
05117,"Prairie County, Arkansas",8309,4132,4177,22653,6009,602,165,57,7,8175,515,336,851,1364,640,724,3342,91,9.01,90.6,2.756047659164761,16.415934528824167,229,98.38729088939704,40.221446624142494,0.497292092911301
05119,"Pulaski County, Arkansas",392848,188310,204538,29855,264775,55304,21634,7320,4890,386754,21857,17258,39115,67056,30469,36587,181793,1264,9.83,91.6,8.615036859039629,17.069197246772287,33844,98.44876389850528,46.275658778967944,0.47934570113631736
05121,"Randolph County, Arkansas",17514,8664,8850,20932,12164,1182,503,15,61,17157,1062,658,1720,3557,1772,1785,6392,80,9.53,91.1,3.305926687221651,20.30946671234441,579,97.96163069544365,36.49651707205664,0.4946899623158616
05123,"St. Francis County, Arkansas",26688,14664,12024,16518,18484,998,624,88,49,23288,1701,1151,2852,6363,2913,3450,8448,207,7.58,90.6,2.851468824940048,23.842176258992804,761,87.26019184652279,31.654676258992804,0.5494604316546763
05125,"Saline County, Arkansas",116252,57280,58972,28410,80044,13140,5372,1127,794,115077,5397,3379,8776,9210,4498,4712,55059,437,9.08,91.3,6.273440456938375,7.922444345043526,7293,98.98926470082235,47.361765819082684,0.4927227058459209
05127,"Scott County, Arkansas",10584,5290,5294,18077,7143,368,259,60,42,10518,508,384,892,2142,1045,1097,3865,40,6.76,91.2,3.4108087679516252,20.238095238095237,361,99.37641723356009,36.51738473167045,0.49981103552532125
05129,"Searcy County, Arkansas",7925,4030,3895,21475,5841,429,299,24,13,7837,540,372,912,1364,660,704,3018,43,9.47,87.5,4.239747634069401,17.21135646687697,336,98.88958990536278,38.08201892744479,0.5085173501577287
05131,"Sebastian County, Arkansas",127362,62180,65182,23916,84291,11009,3301,1041,696,126347,7946,7808,15754,28211,12920,15291,54532,450,7.6,92.4,3.955653962720435,22.150248896845213,5038,99.20305899718912,42.81653868500809,0.4882146951209937
05133,"Sevier County, Arkansas",17206,8612,8594,18388,10640,699,366,28,40,17064,1408,1472,2880,3597,1557,2040,6966,36,10.35,91.4,2.5223759153783565,20.905498082064398,434,99.17470649773335,40.48587701964431,0.500523073346507
05135,"Sharp County, Arkansas",17041,8336,8705,20078,12317,762,404,85,40,16863,980,790,1770,3904,1616,2288,5757,72,10.4,89.3,3.104277917962561,22.90945367055924,529,98.9554603603075,33.78322868376269,0.4891731705885805
05137,"Stone County, Arkansas",12443,6242,6201,19881,9127,698,328,193,0,12342,678,558,1236,2983,1376,1607,4253,70,9.65,87.8,4.187093144740015,23.97331833159206,521,99.18829864180664,34.17986016234027,0.5016475126577192
05139,"Union County, Arkansas",40022,19451,20571,23463,27264,3928,1123,315,120,39634,2441,2342,4783,7936,3369,4567,15433,30,8.3,92.2,3.8928589275898258,19.829093998300934,1558,99.0305332067363,38.56129128979062,0.486007695767328
05141,"Van Buren County, Arkansas",16751,8356,8395,20568,12321,946,416,173,54,16559,1099,1032,2131,3250,1349,1901,5575,97,9.1,89.1,3.838576801384992,19.401826756611545,643,98.85379977314787,33.28159512864904,0.4988358903946033
05143,"Washington County, Arkansas",223683,111839,111844,26371,134615,25446,11114,3649,2753,221806,15815,12225,28040,38855,18202,20653,105525,428,11.2,88.6,7.830724730980897,17.37056459364368,17516,99.16086604703979,47.17613765909792,0.49998882346892703
05145,"White County, Arkansas",78706,38653,40053,23120,50686,6153,2969,553,865,78113,4239,3762,8001,12354,5621,6733,32157,67,10.94,90.7,5.5739079612736004,15.696389093588799,4387,99.24656315909841,40.85711381597337,0.49110614184433204
05147,"Woodruff County, Arkansas",6763,3193,3570,19987,4827,436,106,8,0,6646,454,285,739,1721,686,1035,2511,27,10.19,90.6,1.6856424663610823,25.447286707082657,114,98.26999852136626,37.128493272216474,0.4721277539553453
05149,"Yell County, Arkansas",21601,10722,10879,20209,14546,1415,421,94,57,21293,1217,1044,2261,3792,1589,2203,8630,171,6.89,91.9,2.6480255543724827,17.554742835979816,572,98.57414008610712,39.95185408082959,0.4963659089856951
06001,"Alameda County, California",1629615,799649,829966,41363,1139149,293137,149371,34121,32665,1619367,62633,48988,111621,181194,81395,99799,753329,8533,9.38,86.8,13.264298622680817,11.11882254397511,216157,99.37113980909601,46.227421814354926,0.49069810967621186
06003,"Alpine County, California",1203,664,539,27448,811,121,57,10,20,1203,85,60,145,235,131,104,364,1,22.13,77.6,7.231920199501247,19.534497090606816,87,100,30.257689110556942,0.5519534497090607
06005,"Amador County, California",37306,20005,17301,29628,28953,4285,1240,584,289,33587,1215,661,1876,3564,1706,1858,12847,101,18.68,94.7,5.663968262477885,9.55342304186994,2113,90.03109419396344,34.43681981450705,0.5362408191711789
06007,"Butte County, California",225207,111587,113620,26304,145918,25811,8343,3253,1440,222635,10569,8067,18636,44977,21771,23206,90376,604,16.25,96.2,5.7884524015683345,19.97140408601864,13036,98.85793958447117,40.130191335082834,0.4954863747574454
06009,"Calaveras County, California",45057,22292,22765,31652,34250,4306,1705,383,210,44675,1583,1368,2951,5676,2489,3187,16310,61,17.72,94.4,5.100206405220055,12.597376656235435,2298,99.15218501009832,36.198592893446076,0.4947510930599019
06011,"Colusa County, California",21479,11157,10322,25676,13509,1524,338,226,36,21299,1665,1226,2891,2979,1436,1543,9262,96,10.07,97.7,2.7934261371572235,13.869360770985613,600,99.16197215885283,43.121188137250336,0.5194375902043856
06013,"Contra Costa County, California",1123678,548675,575003,42898,767132,198521,76942,22425,14617,1118246,43999,36147,80146,108630,48236,60394,520162,5758,10.68,90,10.143831239910366,9.667360222412471,113984,99.51658749214633,46.291019313362014,0.488284900122633
06015,"Del Norte County, California",27442,15008,12434,20809,19424,1695,666,298,145,24226,1154,797,1951,5571,2537,3034,8223,68,22.11,83.6,4.041250637708622,20.30099846949931,1109,88.28073755557175,29.965017127031558,0.5468989140733183
06017,"El Dorado County, California",185015,92304,92711,38156,132744,28348,10599,3416,1885,183777,6254,4758,11012,17996,8156,9840,78495,372,24.56,89.3,8.593897792070914,9.726778909818123,15900,99.33086506499473,42.426289760289706,0.4989000891819582
06019,"Fresno County, California",971616,484667,486949,22234,588491,78378,25209,9767,5035,960471,64946,47168,112114,243040,112508,130532,379219,5628,12.17,91.9,4.117984882916708,25.0139972993446,40011,98.85294190297401,39.02971955999078,0.4988256677535158
06021,"Glenn County, California",27935,14213,13722,21029,17927,1819,291,150,68,27636,1845,1427,3272,5404,2505,2899,10337,91,10.5,96.4,1.8220869876499015,19.344907821729013,509,98.92965813495614,37.00375872561303,0.5087882584571326
06023,"Humboldt County, California",135490,67508,67982,25208,91359,17668,5838,2115,1263,134525,9201,7280,16481,27481,13683,13798,57251,298,20.69,84.9,6.801978005756882,20.282677688390287,9216,99.28777031515241,42.25477895047605,0.4982507934164883
06025,"Imperial County, California",179957,91963,87994,17303,108522,10692,3877,742,187,170512,10430,9737,20167,40376,17934,22442,58660,1055,1.11,108.5,2.6706379857410383,22.436470934723296,4806,94.75152397517185,32.596675872569556,0.511027634379324
06027,"Inyo County, California",18195,9172,9023,30323,13230,2103,915,160,166,17785,694,667,1361,1806,820,986,8078,29,3.87,99.4,6.820555097554273,9.925803792250619,1241,97.74663369057433,44.39681231107447,0.5040945314646881
06029,"Kern County, California",878744,450393,428351,21716,526286,55523,19285,5010,3263,850055,53399,42051,95450,191123,85135,105988,329269,6312,5.12,98.2,3.1360669318937027,21.74956528863924,27558,96.73522664166128,37.470412315759766,0.512541764154293
06031,"Kings County, California",150183,82982,67201,19835,91889,8518,2203,1018,252,132483,7832,5843,13675,28013,12846,15167,55539,430,3.74,100.9,2.3125120686096294,18.652577189162557,3473,88.21437845828089,36.980883322346735,0.5525392354660648
06033,"Lake County, California",64095,31788,32307,23345,46386,4588,1678,577,273,63433,4159,3355,7514,14398,6950,7448,21813,83,22.13,92.5,3.944145409158281,22.4635306966222,2528,98.96715812465871,34.03229581090569,0.49595132225602623
06035,"Lassen County, California",31470,20786,10684,20974,22422,1761,652,248,120,21739,766,766,1532,3155,1597,1558,8737,46,7.83,87.7,3.2411820781696856,10.025421035907213,1020,69.07848744836352,27.762948840165237,0.6605020654591675
06037,"Los Angeles County, California",10105722,4979641,5126081,30798,6801851,1384333,492924,158811,88238,10038224,737616,598980,1336596,1688505,768481,920024,4685201,51580,7.83,91.9,7.322317000210376,16.708405396467466,739973,99.332081369347,46.36186311081979,0.49275459981978526
06039,"Madera County, California",154440,74583,79857,19975,96096,8945,2836,913,602,146644,10297,6847,17144,32244,14592,17652,50407,736,11.94,92.7,2.817275317275317,20.87801087801088,4351,94.95208495208495,32.63856513856514,0.48292540792540795
06041,"Marin County, California",260814,127423,133391,66748,191055,62021,29375,12594,5886,256100,7189,6065,13254,20515,9153,11362,127260,670,17.01,76.8,18.34832485986182,7.865758739944941,47855,98.1925816865659,48.793392992707446,0.4885588963782619
06043,"Mariposa County, California",17658,8863,8795,28241,13656,2017,933,253,132,17489,498,363,861,2629,1231,1398,6789,92,14.89,92.3,7.46403896250991,14.88843583644807,1318,99.0429267187677,38.447162759089366,0.5019254728734851
06045,"Mendocino County, California",87497,43668,43829,27093,61673,10117,3237,1179,752,86720,5640,4050,9690,16448,7555,8893,35736,116,20.27,87.4,5.9064882224533415,18.798358800873174,5168,99.11196955324182,40.84254317290878,0.49907996845606134
06047,"Merced County, California",267390,135045,132345,20120,156562,14006,5063,1337,1135,264519,17105,12284,29389,60861,29079,31782,95151,2907,5.81,97.7,2.8179812259246795,22.76113542017278,7535,98.92628744530461,35.585100415123975,0.5050488051161225
06049,"Modoc County, California",9017,4659,4358,22052,6852,859,227,50,0,8784,732,677,1409,1584,710,874,3085,20,4.59,88.5,3.071975158034823,17.566818232228012,277,97.41599201508262,34.21315293334812,0.5166906953532217
06051,"Mono County, California",14058,7433,6625,30888,9692,2250,614,164,29,13968,1125,1220,2345,1378,626,752,7781,47,10.09,82.8,5.740503627827572,9.802247830416844,807,99.35979513444302,55.34926732109831,0.5287380850761132
06053,"Monterey County, California",433168,221016,212152,27168,273560,39587,17199,5241,3414,416786,31701,25230,56931,60933,27961,32972,185131,14549,12.07,89.3,5.968584937022126,14.066828574594615,25854,96.2180955195213,42.73884497469804,0.5102315960551103
06055,"Napa County, California",141005,70311,70694,40632,97924,22344,7116,2977,1418,139208,5497,4872,10369,11285,5359,5926,69406,413,17.81,92.2,8.163540299989362,8.003262295663275,11511,98.72557710719478,49.22236800113471,0.4986418921314847
06057,"Nevada County, California",98838,48732,50106,35581,75012,17134,6643,2156,941,97938,5556,3957,9513,11861,5197,6664,40996,617,26.44,88.6,9.854509399218925,12.000445172909204,9740,99.08941904935348,41.47797405856047,0.4930492320767316
06059,"Orange County, California",3155816,1558245,1597571,37603,2132158,537600,202104,60031,33381,3139021,176261,150983,327244,378459,173050,205409,1529381,13021,8.31,85.6,9.364170788157484,11.992429216405519,295516,99.46780800908545,48.462299449651056,0.4937692818592719
06061,"Placer County, California",374985,183021,191964,39734,260802,65212,22438,7136,2985,372281,13025,9730,22755,30473,14231,16242,167691,1290,25.03,89.6,8.682747309892395,8.126458391669,32559,99.27890448951291,44.719388775551025,0.48807552302092083
06063,"Plumas County, California",18724,9432,9292,32056,14480,1806,1114,271,80,18571,737,492,1229,2439,1076,1363,7061,40,20.55,86,7.82418286690878,13.0260628070925,1465,99.18286690878017,37.71095919675283,0.5037385174108097
06065,"Riverside County, California",2355002,1171711,1183291,25700,1500538,205329,83333,21150,13123,2333253,156847,131132,287979,362215,165932,196283,954390,9368,4.09,102.3,4.993881109230481,15.380666343383147,117606,99.07647636817293,40.52608023262825,0.49754140336186553
06067,"Sacramento County, California",1495400,730680,764720,29693,996195,196514,67958,22412,10702,1480422,68981,55027,124008,246203,114915,131288,650426,5881,10.18,98.2,6.758860505550355,16.464023003878562,101072,98.99839507823994,43.4951183629798,0.48861842985154474
06069,"San Benito County, California",58671,29208,29463,30012,37357,4980,1476,453,261,58511,3281,2362,5643,5670,2386,3284,26596,139,9.17,91.9,3.7326788362223247,9.66405890473999,2190,99.72729287041298,45.330742615602254,0.49782686506110346
06071,"San Bernardino County, California",2121220,1055170,1066050,22867,1313298,168511,66158,15271,9730,2070914,128479,110851,239330,374810,167531,207279,856541,5165,2.91,102.9,4.297479752218063,17.669548655962135,91159,97.62844023722198,40.37964001847993,0.49743543809694424
06073,"San Diego County, California",3283665,1651147,1632518,34350,2197045,505483,209580,60233,45618,3186685,179613,151936,331549,427031,198045,228986,1575008,13964,5.78,92.4,9.60606517412708,13.004706631157564,315431,97.04659275535111,47.964941612497014,0.5028366170117841
06075,"San Francisco County, California",864263,440633,423630,59508,683074,228294,100265,33789,18718,859959,27399,20144,47543,99096,46675,52421,495315,6221,10.63,77.7,17.67656373117905,11.465954229210322,152772,99.50200344108217,57.31067973521949,0.5098367047993493
06077,"San Joaquin County, California",724153,360247,363906,24694,450857,55477,17720,5374,2932,715502,39912,29142,69054,121296,56415,64881,286690,2052,7.4,98,3.5939918774071224,16.750051439405762,26026,98.80536295506613,39.58969996671974,0.4974736001922246
06079,"San Luis Obispo County, California",280119,142182,137937,33972,185803,39299,15447,4622,3809,273626,13267,10137,23404,36420,17513,18907,128290,545,10.07,92.4,8.524234343261258,13.001617169845673,23878,97.68205655453575,45.798392825906134,0.5075771368596917
06081,"San Mateo County, California",763450,376145,387305,53516,544336,153522,71057,21924,17695,759448,24475,19718,44193,54981,25039,29942,396443,3929,13.98,79.3,14.496823629576266,7.201650402776868,110676,99.4758006418233,51.92782762459886,0.4926910734167267
06083,"Santa Barbara County, California",442996,221955,221041,32872,272818,54031,23123,7370,6240,435899,29146,23298,52444,65493,31277,34216,207428,1272,9.26,85.2,8.291948460031241,14.784106402766616,36733,98.39795393186394,46.82389908712494,0.5010316120235848
06085,"Santa Clara County, California",1911226,963317,947909,48689,1310623,351778,220693,35568,47562,1902184,65408,52258,117666,162525,74003,88522,937067,7006,12.68,86.4,15.896759462250932,8.503703905241975,303823,99.52690053400278,49.02962810258965,0.504030920466758
06087,"Santa Cruz County, California",273263,135654,137609,36388,177627,41971,18611,5156,4869,271860,12743,9741,22484,38605,17603,21002,130571,3603,19.27,83.1,10.479281863991831,14.12741571306763,28636,99.4865752041074,47.78217321774262,0.49642286002861713
06089,"Shasta County, California",178919,87753,91166,26455,125093,17495,6099,2400,721,177505,9332,7366,16698,31967,14991,16976,70647,539,14.71,94.7,5.153169870164711,17.866744169149168,9220,99.20969824333916,39.48546548997032,0.4904621644431279
06091,"Sierra County, California",2885,1488,1397,31750,2313,344,114,20,17,2858,207,62,269,351,183,168,1101,0,25.17,84.2,5.233968804159446,12.166377816291162,151,99.06412478336222,38.1629116117851,0.5157712305025997
06093,"Siskiyou County, California",43530,21706,21824,24605,31749,4777,1720,524,183,43402,2089,1511,3600,8915,4156,4759,16073,69,11.9,87.3,5.575465196416265,20.480128646910178,2427,99.70594991959568,36.923960487020445,0.49864461291063633
06095,"Solano County, California",434981,216074,218907,31934,295232,52721,15710,4602,2444,422306,17378,13859,31237,48623,21805,26818,194308,1017,12.48,92.7,5.231492869803509,11.178189392180348,22756,97.08607962186854,44.670456870529975,0.4967435359245576
06097,"Sonoma County, California",500943,245381,255562,37767,355303,77016,28192,9981,5073,496690,23338,18612,41950,52707,24150,28557,243493,1471,19.58,83.5,8.63291831605592,10.521556344733831,43246,99.1510012117147,48.6069273350461,0.48983816522039436
06099,"Stanislaus County, California",535684,264824,270860,24007,336086,38138,11704,4612,1748,532471,28256,20525,48781,91210,41063,50147,212692,1888,6.98,97.1,3.3721373048289665,17.026829250080272,18064,99.40020609165104,39.704751308607314,0.49436608149580724
06101,"Sutter County, California",95583,47613,47970,24849,61768,7398,2344,817,258,94357,6057,5104,11161,15805,7502,8303,37474,189,9.03,99.4,3.5769959093144177,16.535367167801805,3419,98.71734513459506,39.20571649770357,0.4981325131037946
06103,"Tehama County, California",63247,31452,31795,22631,43113,4202,1350,521,122,62714,2774,2758,5532,13009,6215,6794,23284,192,11.81,95.6,3.1511376033645866,20.56856451689408,1993,99.15727228168925,36.814394358625705,0.49728840893639226
06105,"Trinity County, California",13037,6603,6434,23575,10098,1556,306,52,52,12863,958,854,1812,2545,1381,1164,4610,49,18.77,92.3,3.144895297998006,19.521362276597376,410,98.66533711743499,35.36089591163611,0.5064815525044105
06107,"Tulare County, California",458809,229488,229321,18962,266582,24752,8504,2505,1130,454868,32208,23072,55280,122724,58836,63888,168712,2296,12.91,89,2.645763269683027,26.748385493745765,12139,99.141036902066,36.771728540634555,0.500181992942597
06109,"Tuolumne County, California",53899,28029,25870,31570,40935,5362,2045,717,296,50891,1905,1478,3383,6875,3087,3788,19680,205,22.84,85,5.673574648880313,12.75533868902948,3058,94.41919145067627,36.512736785469116,0.5200282008942652
06111,"Ventura County, California",847834,419536,428298,35771,562386,114671,46109,13277,9202,841387,50593,40592,91185,85816,38880,46936,401262,2064,10.18,87.4,8.089791161949154,10.121792709421891,68588,99.23959171252864,47.327896734502275,0.49483271489466096
06113,"Yolo County, California",212605,103617,108988,30615,124232,25761,13161,4996,6487,211123,9460,6824,16284,39686,18079,21607,93885,641,12.72,97.1,11.591448931116389,18.666541238446886,24644,99.30293266856377,44.15935655323252,0.48736859434161944
06115,"Yuba County, California",74644,38081,36563,22814,46582,5573,1565,406,84,72464,4177,3226,7403,13598,6448,7150,28425,201,17.58,97.2,2.7530678956111676,18.217137345265527,2055,97.0794705535609,38.08075665827126,0.5101682653662719
08001,"Adams County, Colorado",487850,245840,242010,27487,310590,48993,17687,2969,1964,484371,36123,28767,64890,59050,25856,33194,242724,1600,3.93,91.2,4.636671107922517,12.104130367940966,22620,99.28687096443579,49.753817771856106,0.5039253869017116
08003,"Alamosa County, Colorado",16345,8085,8260,19217,9411,1542,667,76,184,15903,1224,890,2114,4239,1894,2345,6417,34,3.63,81.1,5.671459161823187,25.934536555521568,927,97.2958091159376,39.25971245029061,0.49464668094218417
08005,"Arapahoe County, Colorado",626612,309190,317422,36951,421551,112863,46501,10257,5645,620873,33306,27249,60555,61463,27167,34296,326575,2530,3.67,90,9.958794277798702,9.808781191550752,62403,99.08412223193938,52.117578341940465,0.49343134188301535
08007,"Archuleta County, Colorado",12592,6400,6192,29344,9489,2312,889,129,178,12489,1133,822,1955,1446,684,762,5444,58,5.2,79.4,9.498094027954256,11.483481575603557,1196,99.18202033036849,43.23379923761118,0.5082592121982211
08009,"Baca County, Colorado",3581,1732,1849,22853,2608,416,90,43,9,3479,215,167,382,674,280,394,1609,9,5.2,91.7,3.965372800893605,18.821558223959787,142,97.15163362189332,44.9315833566043,0.4836637810667411
08011,"Bent County, Colorado",5806,3767,2039,14028,4572,319,132,8,10,3880,310,232,542,948,469,479,1325,36,5.63,93.2,2.5835342748880468,16.327936617292455,150,66.82741991043748,22.82121942817775,0.6488115742335515
08013,"Boulder County, Colorado",316782,159112,157670,42119,205757,67026,38265,8023,10905,314665,10629,8881,19510,39882,19356,20526,167328,1414,5.04,81.2,18.05437177617415,12.589730477110441,57193,99.33171707988458,52.8211830217626,0.5022760131573132
08014,"Broomfield County, Colorado",64283,31920,32363,43736,44055,14915,6638,1057,931,63952,2002,1364,3366,3340,1306,2034,34408,447,4.94,89.9,13.418788793304607,5.195774932719382,8626,99.48508937044008,53.525815534433676,0.4965542989592894
08015,"Chaffee County, Colorado",18818,10056,8762,28907,14907,2983,1210,464,166,17649,1288,934,2222,1686,765,921,8135,14,3.23,73.2,9.777872249973429,8.959506855138697,1840,93.78786268466362,43.22988627909449,0.5343819747050697
08017,"Cheyenne County, Colorado",2127,1086,1041,23698,1325,247,43,0,0,2086,198,145,343,245,106,139,927,27,6.66,91.5,2.0216267042783262,11.51857075693465,43,98.07240244475787,43.58251057827927,0.5105782792665726
08019,"Clear Creek County, Colorado",9257,4752,4505,41257,7106,2134,885,134,147,9149,544,337,881,622,284,338,5087,108,4.58,70.5,12.595873393107919,6.719239494436643,1166,98.83331532894026,54.953008534082315,0.5133412552662849
08021,"Conejos County, Colorado",8147,4084,4063,19047,5278,741,224,25,23,8109,581,569,1150,1709,859,850,2830,46,4.15,75,3.3386522646372896,20.97704676568062,272,99.5335706394992,34.73671290045416,0.5012888179698048
08023,"Costilla County, Colorado",3628,1958,1670,20737,2650,266,233,30,24,3628,293,248,541,1073,538,535,1222,0,3.95,77.6,7.910694597574421,29.575523704520396,287,100,33.68246968026461,0.539691289966924
08025,"Crowley County, Colorado",5514,3752,1762,14393,3926,202,96,21,0,4246,214,172,386,1054,497,557,1767,2,4.35,92.5,2.121871599564744,19.114980050779835,117,77.00398984403337,32.04570184983678,0.680449764236489
08027,"Custer County, Colorado",4505,2200,2305,26032,3546,831,257,38,54,4492,294,247,541,693,366,327,1326,0,4.24,75.8,7.7469478357380686,15.382907880133185,349,99.71143174250832,29.433962264150942,0.48834628190899
08029,"Delta County, Colorado",30217,15221,14996,25546,21983,2782,1091,307,84,29167,2044,1724,3768,4795,2077,2718,10953,41,3.15,84.8,4.904523943475527,15.868550815765959,1482,96.52513485786147,36.24780752556508,0.5037230697951485
08031,"Denver County, Colorado",678467,339400,339067,38991,483128,137052,59213,19312,9049,672437,44728,32775,77503,100611,47150,53461,367420,2687,4.58,90.2,12.907628521357708,14.829166341177979,87574,99.11123164428041,54.15443934634993,0.5002454061877734
08033,"Dolores County, Colorado",1736,946,790,23190,1312,179,75,6,0,1736,74,53,127,245,146,99,779,1,4.88,79,4.6658986175115205,14.112903225806452,81,100,44.87327188940092,0.5449308755760369
08035,"Douglas County, Colorado",320940,159804,161136,48725,209032,78801,32860,5787,3728,319951,6197,5225,11422,11636,5294,6342,167671,1612,4.16,83.1,13.203402505141147,3.6255998005857792,42375,99.6918427120334,52.24372156789431,0.4979248457655637
08037,"Eagle County, Colorado",53726,28560,25166,40450,37519,12498,3093,1048,298,53658,5069,3993,9062,4128,1927,2201,32881,126,4.22,76.7,8.26229386144511,7.6834307411681495,4439,99.87343185794587,61.20128057179019,0.5315861966273313
08039,"Elbert County, Colorado",24553,12442,12111,42522,17308,4205,1407,293,152,24469,770,980,1750,1160,520,640,12925,99,4.15,87.6,7.542866452164705,4.724473587748951,1852,99.65788294709404,52.64122510487517,0.5067405205066591
08041,"El Paso County, Colorado",674826,340118,334708,31217,432176,97863,49795,7707,5738,642935,28542,22313,50855,72699,32750,39949,327422,2539,4.99,85.9,9.37130460296432,10.772999262031991,63240,95.27418919840078,48.51947020417115,0.5040084406943419
08043,"Fremont County, Colorado",46601,27073,19528,20919,36356,3885,1791,315,210,35935,1548,1528,3076,5654,2530,3124,14227,210,4.27,82,4.969850432394154,12.132786850067594,2316,77.11207913993262,30.52938778137808,0.5809531984292182
08045,"Garfield County, Colorado",57945,29334,28611,31483,38287,7509,2979,719,364,57305,6021,5318,11339,5449,2504,2945,29983,298,3.61,80.9,7.010095780481491,9.403744930537579,4062,98.89550435758046,51.74389507291397,0.5062386746052291
08047,"Gilpin County, Colorado",5793,3108,2685,45110,4492,1089,422,16,116,5744,282,257,539,315,157,158,3365,25,4.44,73.1,9.563266010702572,5.4375970999482135,554,99.15415156223028,58.08734679785949,0.5365095805282237
08049,"Grand County, Colorado",14793,7997,6796,32919,11139,3212,764,231,66,14734,1481,1123,2604,1927,1058,869,8639,54,3.95,74.8,7.172311228283648,13.026431420266341,1061,99.60116271209355,58.39924288514838,0.540593523964037
08051,"Gunnison County, Colorado",16215,8795,7420,27669,10354,4036,1144,231,152,16170,1286,824,2110,2170,956,1214,9240,41,5.66,74.5,9.417206290471785,13.382670366944188,1527,99.72247918593895,56.984273820536544,0.5423990132593278
08053,"Hinsdale County, Colorado",820,384,436,29574,664,211,22,17,21,820,45,31,76,98,47,51,393,0,6.21,68.4,7.317073170731708,11.951219512195122,60,100,47.926829268292686,0.4682926829268293
08055,"Huerfano County, Colorado",6498,3230,3268,25547,5142,777,349,73,16,6348,473,317,790,937,457,480,2320,22,4.55,82.1,6.740535549399815,14.419821483533395,438,97.69159741458911,35.70329332102185,0.49707602339181284
08057,"Jackson County, Colorado",1372,676,696,24299,993,138,7,16,3,1367,72,54,126,175,69,106,703,25,4.64,75.2,1.8950437317784257,12.755102040816327,26,99.63556851311954,51.23906705539358,0.49271137026239065
08059,"Jefferson County, Colorado",564029,280635,283394,40187,402392,109340,47996,9203,7011,557612,21834,16788,38622,43339,19822,23517,301322,2096,4.11,81.8,11.384166416975013,7.683824767875411,64210,98.86229254169555,53.42313959034021,0.49755420377321025
08061,"Kiowa County, Colorado",1368,687,681,23621,911,134,54,0,3,1343,53,40,93,142,53,89,630,25,6.61,92,4.166666666666667,10.380116959064328,57,98.17251461988305,46.05263157894737,0.5021929824561403
08063,"Kit Carson County, Colorado",7846,4392,3454,26125,5572,595,225,42,20,7123,576,412,988,814,307,507,3512,27,4.69,90.6,3.6579148610757075,10.37471322967117,287,90.78511343359673,44.76166199337242,0.5597756818761153
08065,"Lake County, Colorado",7481,4079,3402,28492,5420,1298,233,36,122,7426,705,491,1196,939,419,520,4124,60,5,69.2,5.2265739874348345,12.55179788798289,391,99.26480417056543,55.12632001069376,0.5452479615024729
08067,"La Plata County, Colorado",54469,27424,27045,34501,38496,10263,3818,1307,1216,54008,3470,2495,5965,5045,2048,2997,28416,226,4.56,80.6,11.641484146945968,9.262149112339129,6341,99.15364702858507,52.16912372174998,0.5034790431254476
08069,"Larimer County, Colorado",330976,164920,166056,34087,215266,59389,27593,4598,7219,328531,13725,10138,23863,40006,18688,21318,169516,1395,4.39,79.9,11.907207773373296,12.087281253021366,39410,99.26127574204776,51.217006671178574,0.4982838634825486
08071,"Las Animas County, Colorado",14151,7323,6828,24268,10322,1319,650,93,21,13582,737,660,1397,2266,1098,1168,5899,23,5.01,87.5,5.398911737686382,16.01300261465621,764,95.97908275033566,41.686099922266976,0.5174899300402799
08073,"Lincoln County, Colorado",5520,3522,1998,14765,4057,386,117,18,16,3517,101,98,199,492,211,281,1437,12,4.36,90.4,2.7355072463768115,8.91304347826087,151,63.71376811594203,26.032608695652176,0.6380434782608696
08075,"Logan County, Colorado",21885,11723,10162,24595,14592,1927,666,99,84,21357,1387,953,2340,3500,1819,1681,10118,69,3.26,93.3,3.879369431117204,15.992689056431345,849,97.58738862234406,46.23257939227781,0.5356636965958419
08077,"Mesa County, Colorado",148798,73478,75320,27612,101365,18357,6396,1656,1117,147646,9015,8076,17091,23238,10725,12513,67675,857,2.51,86.7,6.162045188779419,15.617145391739136,9169,99.22579604564578,45.481122058092176,0.4938104006774285
08079,"Mineral County, Colorado",834,433,401,33018,726,177,73,16,19,834,36,19,55,100,41,59,361,0,6.21,69.5,12.949640287769784,11.990407673860911,108,100,43.28537170263789,0.5191846522781774
08081,"Moffat County, Colorado",13056,6772,6284,27331,8853,1055,418,25,21,12930,1034,865,1899,1305,570,735,6296,15,2.47,86.1,3.553921568627451,9.995404411764707,464,99.03492647058823,48.22303921568628,0.5186887254901961
08083,"Montezuma County, Colorado",25770,12664,13106,24440,18102,3149,1433,297,193,25595,2107,1822,3929,4275,2031,2244,10987,56,3.68,86.8,7.462165308498254,16.589057043073343,1923,99.3209157935584,42.6348467209934,0.49142413659293754
08085,"Montrose County, Colorado",40908,20182,20726,24308,28958,4533,1774,309,174,40539,2843,2447,5290,7189,3087,4102,16677,150,2.67,86.4,5.517258237997457,17.573579739904176,2257,99.09797594602523,40.76708712232326,0.4933509338026792
08087,"Morgan County, Colorado",28123,13997,14126,24077,18183,1967,845,247,61,27764,1162,1064,2226,2579,890,1689,13001,64,3.54,93,4.0998471002382395,9.170429897237137,1153,98.72346477971767,46.22906517796821,0.4977065035735875
08089,"Otero County, Colorado",18325,8957,9368,20358,12283,1412,577,103,87,18138,1026,854,1880,4085,1887,2198,7084,37,5.09,92.4,4.185538881309686,22.291950886766713,767,98.97953615279673,38.65757162346521,0.4887858117326057
08091,"Ouray County, Colorado",4653,2198,2455,35544,3748,1092,532,126,102,4653,297,242,539,484,248,236,2210,24,3.95,78.1,16.333548248441865,10.401891252955084,760,100,47.49623898560069,0.4723834085536213
08093,"Park County, Colorado",16900,8935,7965,34377,13259,2682,766,107,227,16780,943,581,1524,1098,484,614,8942,147,3.72,73.5,6.508875739644971,6.497041420118343,1100,99.28994082840237,52.9112426035503,0.528698224852071
08095,"Phillips County, Colorado",4327,2249,2078,27790,2910,439,123,39,29,4253,321,250,571,345,129,216,2069,11,3.56,93,4.414143748555581,7.973191587705108,191,98.2898081811879,47.81603882597643,0.5197596487173561
08097,"Pitkin County, Colorado",17747,9363,8384,65800,13579,5933,1546,670,166,17692,1282,1059,2341,1250,593,657,11092,145,5.98,74,13.421986814672902,7.043443962359835,2382,99.69008846565617,62.50070434439623,0.5275821265566011
08099,"Prowers County, Colorado",12084,6111,5973,22033,7831,870,343,24,18,11900,900,565,1465,2147,933,1214,5370,65,6.1,92.9,3.186031115524661,17.767295597484278,385,98.47732538894405,44.438927507447865,0.5057100297914597
08101,"Pueblo County, Colorado",163368,80330,83038,23110,110442,15277,6901,1096,734,159796,7670,5318,12988,31467,14210,17257,64897,305,3.67,91.2,5.344375887566721,19.261422065520787,8731,97.81352529259097,39.72442583614906,0.4917119631751628
08103,"Rio Blanco County, Colorado",6557,3325,3232,28185,4260,576,259,20,37,6445,424,277,701,733,290,443,2987,4,2.75,84.4,4.819277108433735,11.178892786335215,316,98.2919017843526,45.55436937623914,0.5070916577703218
08105,"Rio Grande County, Colorado",11430,5729,5701,22412,7804,1175,439,174,58,11236,795,699,1494,2018,962,1056,4502,39,2.74,76,5.8705161854768155,17.655293088363955,671,98.30271216097988,39.38757655293088,0.5012248468941383
08107,"Routt County, Colorado",24359,12675,11684,38111,17841,6090,2247,660,212,24223,1196,994,2190,2567,1423,1144,14234,64,4.28,78.9,12.804302311260725,10.538199433474281,3119,99.44168479822653,58.434254279732336,0.5203415575352026
08109,"Saguache County, Colorado",6338,3141,3197,22267,4551,774,295,46,69,6320,621,619,1240,1327,573,754,2461,21,3,74.4,6.468917639633954,20.937204165351847,410,99.71599873777217,38.82928368570527,0.4955822025875671
08111,"San Juan County, Colorado",569,301,268,28889,433,109,17,0,3,569,35,33,68,19,8,11,305,0,9.9,65.2,3.51493848857645,3.3391915641476273,20,100,53.60281195079086,0.5289982425307557
08113,"San Miguel County, Colorado",7804,4150,3654,42015,5843,2278,611,196,76,7778,496,323,819,815,331,484,4669,137,3.24,81.7,11.314710404920554,10.443362378267555,883,99.6668375192209,59.82829318298309,0.5317785750896976
08115,"Sedgwick County, Colorado",2357,1176,1181,24666,1656,223,101,10,10,2327,146,75,221,392,174,218,962,1,3.16,92.9,5.133644463300806,16.63131098854476,121,98.72719558761138,40.81459482392872,0.4989393296563428
08117,"Summit County, Colorado",29722,16218,13504,37192,22379,7963,2097,378,256,29644,3689,2657,6346,3063,1559,1504,18796,89,5.09,70.6,9.188479913868514,10.305497611197094,2731,99.73756813135051,63.23935132225288,0.5456564161227374
08119,"Teller County, Colorado",23769,11926,11843,34974,17929,3780,1884,283,175,23535,1173,1043,2216,1760,772,988,11553,218,5.45,75.1,9.853170095502545,7.4046026336825275,2342,99.01552442256721,48.605326265303546,0.5017459716437377
08121,"Washington County, Colorado",4809,2485,2324,26279,3377,428,102,21,8,4521,165,104,269,443,187,256,2174,12,3.28,92.4,2.724059055936785,9.211894364732792,131,94.01122894572676,45.20690372218756,0.5167394468704513
08123,"Weld County, Colorado",285729,143783,141946,29226,181832,33853,11609,1918,1667,283372,13230,12201,25431,31353,13771,17582,136910,984,3.93,90.7,5.317626142253674,10.972984891278099,15194,99.17509248273714,47.9160323243353,0.5032145844489009
08125,"Yuma County, Colorado",10109,5010,5099,24789,6649,924,425,24,24,9967,708,622,1330,1425,669,756,4918,7,3.44,92.6,4.6789989118607185,14.096349787318232,473,98.59531110891285,48.64971807300425,0.495597981996241
09001,"Fairfield County, Connecticut",947328,461380,485948,53433,642401,165926,97357,24568,10645,938998,51283,39330,90613,81422,35594,45828,464718,2935,7.21,82.5,13.994097081475477,8.594911160653966,132570,99.12068470476963,49.055659708147545,0.48703300229698687
09003,"Hartford County, Connecticut",897417,435729,461688,37817,622863,132166,73605,18361,8559,883429,26376,19817,46193,97996,43115,54881,436724,2954,8.81,83,11.201593016401517,10.919784225170684,100525,98.44130432117956,48.66455616508268,0.48553682401826576
09005,"Litchfield County, Connecticut",184454,91198,93256,40619,135410,27496,15326,2795,1747,183145,5355,3754,9109,12400,5986,6414,95797,703,7.73,80.1,10.771249200342632,6.722543289925944,19868,99.2903379704425,51.935441898793194,0.49442137335053726
09007,"Middlesex County, Connecticut",164110,80227,83883,43695,118781,27082,15729,3308,2287,162181,3669,2977,6646,11433,4897,6536,86920,789,8.28,81.9,12.993723721893852,6.9666686978246295,21324,98.82456888672232,52.964475047224425,0.48886112973005913
09009,"New Haven County, Connecticut",862127,415863,446264,35085,595779,111795,64560,17317,12706,851682,28445,22613,51058,100732,44632,56100,417961,2443,8.48,82.4,10.970889439722917,11.684125424676411,94583,98.78846156076773,48.48021231210715,0.4823686069453804
09011,"New London County, Connecticut",270772,135581,135191,36881,188628,34115,21043,3979,3011,258628,7144,4616,11760,25689,11292,14397,138125,812,8.4,80.7,10.352990708049576,9.487317743341261,28033,95.51504586884907,51.01155215458024,0.5007201630892412
09013,"Tolland County, Connecticut",151596,76162,75434,37830,95679,21525,12436,2009,2034,148725,3005,2264,5269,8798,4151,4647,77021,538,8.73,81.3,10.870339586796485,5.803583208000211,16479,98.10615055806221,50.806749518456954,0.5024011187630281
09015,"Windham County, Connecticut",116674,57906,58768,29993,80756,11950,6007,902,853,114975,3366,2728,6094,12313,5016,7297,56733,426,8.81,80.7,6.652724685876888,10.553336647410735,7762,98.54380581792002,48.62522927130295,0.4963059464833639
10001,"Kent County, Delaware",173145,83544,89601,27420,114160,16509,7513,1501,1314,169720,7320,5550,12870,21743,9226,12517,78253,514,8.12,87.1,5.964942678102169,12.557682866961217,10328,98.02188916803836,45.195067717808776,0.48250887984059604
10003,"New Castle County, Delaware",555036,268818,286218,34541,377959,77875,40364,8320,8338,546567,17895,14731,32626,64082,27791,36291,264579,1696,6.72,86.3,10.27356784064457,11.545557405285424,57022,98.4741530279117,47.668799861630596,0.48432534105895836
10005,"Sussex County, Delaware",215551,104514,111037,31874,159421,23094,12765,2482,1694,212852,9362,7236,16598,25479,10698,14781,92519,834,9.39,88.4,7.859392904695408,11.820404451846663,16941,98.74786013518842,42.92209268340207,0.48486901011825506
12001,"Alachua County, Florida",259865,125712,134153,26431,156332,32960,17680,6608,7422,257247,15319,12138,27457,57060,27367,29693,118344,1192,14.33,90.5,12.202489754295499,21.95755488426683,31710,98.99255382602504,45.540569141669714,0.4837588748003771
12003,"Baker County, Florida",27537,14422,13115,22440,18290,1689,481,137,88,25058,1711,1319,3030,4277,2096,2181,10222,228,10.59,92.3,2.563823219668083,15.531829901586956,706,90.99756690997567,37.120964520463374,0.5237317064313469
12005,"Bay County, Florida",180117,89542,90575,26742,125643,18081,7349,1635,1020,175626,14080,12232,26312,27248,12137,15111,81647,662,11.61,91.4,5.55416756885802,15.127944613778821,10004,97.50662069654724,45.32997995747209,0.49713241948289166
12007,"Bradford County, Florida",26775,14754,12021,19656,19351,1480,405,97,34,23490,2005,1525,3530,4394,1852,2542,9076,127,14.32,91,2.0018674136321195,16.41083099906629,536,87.73109243697479,33.89729225023343,0.5510364145658263
12009,"Brevard County, Florida",568183,277666,290517,29405,418908,73154,35542,5320,4845,563561,36075,31778,67853,75104,34590,40514,236201,3210,17.21,90.4,8.044415267616243,13.218276505984868,45707,99.18652969201824,41.571289531717774,0.4886911435224215
12011,"Broward County, Florida",1890416,920265,970151,30109,1327173,266661,103605,32909,14677,1878890,159681,147249,306930,262306,116979,145327,912672,10548,13.37,91.8,7.997763455239482,13.875570244856158,151191,99.39029293023334,48.27889734323027,0.4868055496779545
12013,"Calhoun County, Florida",14458,7872,6586,15927,10281,755,189,21,17,12431,1142,1222,2364,1591,632,959,4621,130,12.41,91.8,1.5700650159081477,11.004288283303362,227,85.98008023239728,31.96154378198921,0.5444736478074422
12015,"Charlotte County, Florida",173236,84432,88804,29243,141419,19864,8793,1975,1011,169791,11517,10061,21578,20274,9370,10904,57316,958,13.61,92.8,6.799395044909834,11.703110208039899,11779,98.01138331524625,33.08550185873606,0.48738137569558293
12017,"Citrus County, Florida",141373,68487,72886,25034,112033,12905,5055,1315,719,139310,8381,7643,16024,24123,10271,13852,44034,871,8.73,91.7,5.014394544927249,17.06337136511215,7089,98.54073974521302,31.147390237174,0.4844418665516046
12019,"Clay County, Florida",203291,100119,103172,28599,137354,22532,7511,1404,1109,200260,11631,10289,21920,20998,9584,11414,91495,1181,14.15,91.5,4.930862655011781,10.329035717272285,10024,98.50903384803065,45.00691127497036,0.4924910596140508
12021,"Collier County, Florida",356774,175608,181166,41239,268314,55109,25467,8859,4295,354838,33326,29277,62603,45385,21209,24176,146557,1844,16.87,91.9,10.825060122094099,12.720938184957424,38621,99.45735956095456,41.07838575680963,0.4922107552680408
12023,"Columbia County, Florida",68484,35425,33059,22855,47213,5077,1950,495,229,63751,4238,4248,8486,10649,4619,6030,25516,76,10.37,91.7,3.904561649436365,15.5496174288885,2674,93.088896676596,37.25833771391858,0.5172741078208049
12027,"DeSoto County, Florida",35675,20184,15491,17892,25193,2002,705,135,53,33928,5235,2074,7309,10086,5700,4386,12477,64,13.87,92.6,2.503153468815697,28.2718990889979,893,95.1030133146461,34.97407147862649,0.5657743517869657
12029,"Dixie County, Florida",16323,9048,7275,19342,12309,782,201,91,52,14786,1366,1219,2585,3471,1610,1861,4640,83,12.61,91,2.1074557373031917,21.264473442381917,344,90.5838387551308,28.426147154322123,0.5543098695092814
12031,"Duval County, Florida",912043,442115,469928,28593,617788,120073,41312,10789,4947,892880,61734,52896,114630,143014,62638,80376,434581,4630,11.16,91.5,6.2549682416289585,15.680620321629572,57048,97.89889292500463,47.64917882161258,0.4847523636495209
12033,"Escambia County, Florida",309924,153834,156090,25666,206004,35438,13034,3146,1847,294389,17978,14713,32691,42457,19734,22723,141080,1066,17.5,90.8,5.816587292368451,13.699164956569998,18027,94.98748080174495,45.520837366580196,0.4963603980330662
12035,"Flagler County, Florida",105015,50436,54579,25741,79267,11826,5183,1153,524,104651,7308,6553,13861,13839,6692,7147,38746,258,11.68,91.3,6.5324001333142885,13.178117411798315,6860,99.65338285006904,36.895681569299626,0.4802742465362091
12037,"Franklin County, Florida",11675,6727,4948,23524,8891,994,495,62,88,10009,935,956,1891,2012,953,1059,4232,119,16.12,91.2,5.524625267665953,17.23340471092077,645,85.73019271948608,36.24839400428265,0.5761884368308351
12039,"Gadsden County, Florida",46113,21869,24244,19252,31955,3391,1395,167,244,43233,3793,2826,6619,10495,4806,5689,16174,363,11.16,91.3,3.91646607247414,22.75930865482619,1806,93.75447270834688,35.07470778305467,0.4742480428512567
12041,"Gilchrist County, Florida",17191,8983,8208,21145,11602,985,336,76,39,15895,1589,1290,2879,3124,1532,1592,6331,57,12.16,90.9,2.6234657669710897,18.172299459019253,451,92.46117154324938,36.827409691117445,0.5225408644057937
12043,"Glades County, Florida",13197,7479,5718,20476,9894,745,301,5,26,11921,1482,1092,2574,2140,1130,1010,3990,81,10.97,93.1,2.5157232704402515,16.215806622717285,332,90.33113586421156,30.234144123664468,0.5667197090247783
12045,"Gulf County, Florida",16018,9595,6423,21085,12127,1527,434,222,66,13612,1124,775,1899,2029,1127,902,5843,194,15.34,91.4,4.507429142215008,12.6669996254214,722,84.97939817705081,36.47771257335498,0.5990136096890998
12047,"Hamilton County, Florida",14238,8228,6010,16109,9895,737,193,65,14,10897,771,711,1482,2896,1239,1657,3777,21,9.16,91.6,1.9103806714426184,20.33993538418317,272,76.53462564966989,26.527602191319005,0.577890153111392
12049,"Hardee County, Florida",27326,14716,12610,18643,17288,1210,484,99,26,25591,2072,1901,3973,6248,2756,3492,9722,30,15.33,92.8,2.228646710092952,22.864671009295176,609,93.65073556319989,35.577837956524924,0.538534728829686
12051,"Hendry County, Florida",39064,20716,18348,18426,24397,1298,626,69,68,38293,6325,4138,10463,9739,4998,4741,15975,505,13.56,92.6,1.953204996928118,24.93088265410608,763,98.02631578947368,40.89442965390129,0.5303092361253328
12053,"Hernando County, Florida",179144,85782,93362,23495,133405,15106,5925,903,846,177193,12618,10820,23438,25322,11556,13766,62684,870,10.25,91.6,4.283704729156433,14.134997543875318,7674,98.91093198767472,34.99084535345867,0.47884383512704864
12055,"Highlands County, Florida",100177,48518,51659,23020,76171,8281,3464,754,554,99076,7614,6486,14100,18495,8596,9899,31391,204,13.8,93,4.763568483783703,18.462321690607624,4772,98.90094532677162,31.335536101101052,0.4843227487347395
12057,"Hillsborough County, Florida",1351087,658639,692448,29806,912588,186135,73698,19769,12010,1339107,101021,85619,186640,208195,94491,113704,642522,5708,11.81,91.5,7.8068251711399785,15.40944439551265,105477,99.11330654502633,47.55593089120094,0.4874882224460749
12059,"Holmes County, Florida",19483,10449,9034,18402,13927,1121,341,108,30,17661,1714,1593,3307,4679,2148,2531,6311,62,11.13,91.2,2.4585536108402195,24.015808653698095,479,90.64825745521738,32.39234204178001,0.5363137093876713
12061,"Indian River County, Florida",147981,71064,76917,33122,112585,19263,8313,2485,1269,146713,10392,9751,20143,18617,8008,10609,54944,524,15.65,91.2,8.154425230266048,12.580669139957157,12067,99.14313324007811,37.12909089680432,0.4802238125164717
12063,"Jackson County, Florida",48571,26887,21684,18126,35379,2813,1588,294,260,40961,2707,2171,4878,8792,4228,4564,16062,229,11.78,91.9,4.410038912108048,18.101336188260486,2142,84.33221469601203,33.06911531572337,0.5535607667126474
12065,"Jefferson County, Florida",14085,7554,6531,22452,10932,1390,600,158,165,11547,418,481,899,1601,638,963,4783,0,9.98,90.6,6.553070642527511,11.36670216542421,923,81.98083067092652,33.958111466098686,0.5363152289669861
12067,"Lafayette County, Florida",8684,5104,3580,21955,6159,420,266,174,0,7127,901,501,1402,1264,505,759,2419,0,12.1,91.6,5.066789497927222,14.555504375863658,440,82.07047443574389,27.855826807922615,0.5877475817595578
12069,"Lake County, Florida",326215,157897,168318,25991,239378,34652,14252,3038,1578,322861,21224,18051,39275,41353,19298,22055,128861,1076,12.55,92.4,5.78391551584078,12.67660898487194,18868,98.97184372269822,39.501862268749136,0.4840274052388762
12071,"Lee County, Florida",700165,342731,357434,30233,521569,89211,35957,10984,5864,694456,58393,49711,108104,102539,46691,55848,281958,5213,14.56,92,7.541793720051702,14.64497654124385,52805,99.18462076796183,40.2702220190955,0.48950033206458476
12073,"Leon County, Florida",285890,135980,149910,28548,167484,42853,20979,6265,6136,282509,14499,11279,25778,56180,27034,29146,141046,1268,10.61,90.8,11.675819371086781,19.650914687467207,33380,98.81737731295253,49.33575850851726,0.47563748294798697
12075,"Levy County, Florida",39713,19415,20298,21043,28851,2183,883,175,204,39408,3347,3204,6551,8595,4015,4580,14051,78,11.65,90.4,3.1778007201671996,21.642786996701332,1262,99.23198952484073,35.38136126709138,0.4888827336136781
12077,"Liberty County, Florida",8347,5216,3131,16937,5655,397,124,32,77,6919,936,568,1504,1230,678,552,2418,112,13.8,91.7,2.7914220678087935,14.735833233497065,233,82.89205702647658,28.968491673655205,0.6248951719180544
12079,"Madison County, Florida",18518,9804,8714,17192,13354,993,548,38,92,16500,1359,946,2305,5241,2469,2772,5816,102,10.03,91,3.661302516470461,28.30219246138892,678,89.10249486985636,31.407279403823306,0.5294308240630737
12081,"Manatee County, Florida",363542,175761,187781,30477,268791,47990,21951,4748,3487,360684,26252,23853,50105,48234,21184,27050,148023,1234,14.96,91.9,8.303304707571614,13.267792992281498,30186,99.21384599303519,40.71689103322312,0.4834682100004951
12083,"Marion County, Florida",343778,164984,178794,23598,255204,32915,12020,3216,1261,335286,25331,19934,45265,58762,26807,31955,117635,1303,11.5,91.7,4.798736393835557,17.093007696827605,16497,97.52980120891971,34.218303672719024,0.4799143633391316
12085,"Martin County, Florida",155719,77098,78621,38021,119437,23988,9700,3183,1712,152694,11353,7476,18829,16624,7622,9002,63371,852,14.87,92.3,9.372652020626898,10.675640095299867,14595,98.05739826225445,40.6957404041896,0.49510978108002235
12086,"Miami-Dade County, Florida",2702602,1311997,1390605,25481,1906299,339002,119394,50889,20911,2676045,287986,264816,552802,505182,222637,282545,1251193,11478,11.93,92,7.0744415936937814,18.692430479959683,191194,99.01735438662445,46.295865983966564,0.485456978127005
12087,"Monroe County, Florida",76745,40218,36527,39176,59730,11850,4737,1420,985,74716,7533,6858,14391,9562,4617,4945,40401,915,11.03,91.6,9.306143722718092,12.45944361196169,7142,97.35617955567137,52.643168936087044,0.5240471691966904
12089,"Nassau County, Florida",78435,38706,39729,33337,56914,9931,4003,1002,523,77522,5395,4194,9589,8866,3942,4924,34360,326,9.8,92.2,7.047874035825843,11.303627207241664,5528,98.83597883597884,43.80697392745586,0.49347867661120676
12091,"Okaloosa County, Florida",197591,100239,97352,30775,134736,25077,11567,1869,1599,185509,13470,11726,25196,21997,9972,12025,93255,1804,16.71,90.5,7.6091522387153265,11.132592071501232,15035,93.88534902905496,47.19597552520105,0.5073054946834623
12093,"Okeechobee County, Florida",40228,21767,18461,18611,27884,2200,641,169,52,37383,4003,2964,6967,8273,3958,4315,13963,69,14.9,92.4,2.14278611912101,20.565277915879488,862,92.9278114745948,34.70965496668987,0.5410907825395247
12095,"Orange County, Florida",1290216,633835,656381,27394,853821,187206,66342,17582,8420,1278710,109785,97378,207163,209366,95723,113643,631669,7621,13.37,92.2,7.157251188948207,16.22720536716333,92344,99.10821133825654,48.95839146313485,0.4912627032992925
12097,"Osceola County, Florida",325168,160216,164952,20165,212567,28215,9030,1945,1201,323420,31624,27773,59397,57416,26655,30761,143390,914,14.99,92.3,3.7445259066082763,17.657334055011564,12176,99.46243172759927,44.09720513703685,0.49271761058898783
12099,"Palm Beach County, Florida",1426772,691154,735618,36303,1037150,225909,88362,31251,15224,1414266,112943,96966,209909,189156,84155,105001,644526,7218,12.96,92.3,9.450493842043437,13.257619297266837,134837,99.12347593028178,45.17372081874329,0.4844179728786379
12101,"Pasco County, Florida",498136,242448,255688,26624,360564,54229,21120,4012,2434,492284,33688,29446,63134,66457,29897,36560,200176,2407,10.58,91.6,5.533830118682448,13.341135754091253,27566,98.82522042173221,40.185009716222076,0.4867104565821382
12103,"Pinellas County, Florida",949842,456017,493825,32120,722933,141166,51953,15712,8434,938695,62802,55582,118384,127948,57221,70727,433140,5505,12.11,91.4,8.011753533745612,13.47045087498763,76099,98.8264363967902,45.60126842148484,0.4800977425719225
12105,"Polk County, Florida",652256,319775,332481,22579,448680,58147,22271,4096,2891,643984,48905,43944,92849,110557,49520,61037,259176,2695,12.95,92.7,4.485662071333954,16.949939900897807,29258,98.73178629249865,39.73531864789285,0.490259959279792
12107,"Putnam County, Florida",72435,35683,36752,18950,51221,4042,1651,415,292,71289,6536,5418,11954,19546,8660,10886,24682,165,14.99,91.3,3.255332366949679,26.98419272451163,2358,98.41789190308552,34.07468765099745,0.4926209705252985
12109,"St. Johns County, Florida",226578,110112,116466,39563,159705,43552,17785,4622,2662,224907,9845,9928,19773,20330,9055,11275,101802,1095,13.09,90.9,11.06418098844548,8.972627527827061,25069,99.26250562720122,44.93022270476392,0.4859783385853878
12111,"St. Lucie County, Florida",298763,146025,152738,24940,214460,27447,10928,2402,1205,296498,23740,22081,45821,49214,22431,26783,119494,1836,17.92,91.7,4.86506026516001,16.472588640494305,14535,99.24187399376764,39.996251209152405,0.48876534242861397
12113,"Santa Rosa County, Florida",166778,85374,81404,28908,115208,20652,8098,1536,961,157339,9674,8094,17768,18073,7891,10182,72276,427,17.32,90.6,6.3527563587523534,10.836561177133675,10595,94.340380625742,43.336651117053805,0.51190204943098
12115,"Sarasota County, Florida",404839,193328,211511,37054,321126,64876,29833,8665,5406,401034,25790,22712,48502,41926,18572,23354,157707,1004,17.03,92.3,10.844804971853009,10.356215680801505,43904,99.06012019592974,38.955486008018,0.47754292447120955
12117,"Seminole County, Florida",449260,217099,232161,31363,313146,79651,27710,6425,3895,446400,26565,23885,50450,52509,23946,28563,218473,2283,13.02,92.2,8.46503138494413,11.687886747095224,38030,99.3633975871433,48.62952410630815,0.48323687842229446
12119,"Sumter County, Florida",116754,58883,57871,33168,104244,18855,10335,1684,1354,107584,3324,3656,6980,9895,4068,5827,22900,1490,10.79,92.1,11.453997293454615,8.475084365417887,13373,92.14587937029995,19.61388903163917,0.5043338986244582
12121,"Suwannee County, Florida",43814,22204,21610,21565,30583,2955,989,94,159,42328,3618,2434,6052,8576,4183,4393,16195,290,10.74,91.8,2.834710366549505,19.573652257269366,1242,96.60839001232483,36.963071164467976,0.5067786552243575
12123,"Taylor County, Florida",22350,12547,9803,16979,16155,953,349,57,31,18413,1315,975,2290,2992,1320,1672,6729,138,11.23,90.8,1.9552572706935123,13.387024608501118,437,82.3847874720358,30.107382550335572,0.5613870246085011
12125,"Union County, Florida",15300,9922,5378,13485,11304,723,172,26,16,9967,567,662,1229,2134,894,1240,3741,57,12.48,91,1.3986928104575163,13.947712418300654,214,65.14379084967321,24.45098039215686,0.6484967320261438
12127,"Volusia County, Florida",518660,252651,266009,25871,381262,56598,20769,5171,3978,513218,40288,32495,72783,81729,37395,44334,208891,2446,11.22,91.8,5.768326071029191,15.757721821617244,29918,98.95075772182162,40.27513207110631,0.4871225851232021
12129,"Wakulla County, Florida",31586,17528,14058,22846,22804,2733,1046,141,128,28013,1827,1329,3156,3540,1520,2020,13426,62,11.69,91,4.163236877097448,11.207496992338378,1315,88.68802634078389,42.50617362122459,0.5549293991008675
12131,"Walton County, Florida",63457,32216,31241,30853,46316,8178,2933,828,442,61322,5876,4127,10003,10410,5480,4930,27272,475,14.9,90.4,6.623382763130939,16.404809556077343,4203,96.63551696424351,42.97713412231905,0.5076823675875002
12133,"Washington County, Florida",24472,13300,11172,18718,17464,1251,554,52,116,22045,1513,1424,2937,4636,2463,2173,8770,184,10.43,91.6,2.950310559006211,18.944099378881987,722,90.08254331480876,35.836874795684864,0.5434782608695652
13001,"Appling County, Georgia",18471,9090,9381,19936,12366,819,425,122,59,18020,1641,1512,3153,4435,1905,2530,6891,43,7.58,92.6,3.280818580477505,24.010611228412106,606,97.55833468680635,37.30713009582589,0.49212278707162577
13003,"Atkinson County, Georgia",8313,4112,4201,19904,5242,252,129,23,24,8288,1090,965,2055,2262,944,1318,3219,72,8.06,92.2,2.1171658847588115,27.21039335979791,176,99.69926620955131,38.72248285817395,0.49464693853001324
13005,"Bacon County, Georgia",11279,5599,5680,18856,7454,535,274,70,0,10637,1030,951,1981,2466,1081,1385,4335,56,8.33,92.8,3.0499157726748827,21.86364039365192,344,94.30800602890328,38.43425835623726,0.4964092561397287
13007,"Baker County, Georgia",3251,1547,1704,22270,2308,138,102,12,3,3251,342,209,551,634,302,332,1238,7,9.22,90.6,3.598892648415872,19.501691787142416,117,100,38.08059058751154,0.4758535835127653
13009,"Baldwin County, Georgia",45527,22893,22634,20114,28061,3013,1651,325,450,43600,3124,2287,5411,11610,5263,6347,16917,191,10.14,91.5,5.328706042568147,25.50135084675028,2426,95.7673468491225,37.15816987721572,0.5028444659213214
13011,"Banks County, Georgia",18363,9245,9118,19451,12610,923,403,119,58,18359,1637,1479,3116,2629,1300,1329,7674,23,7.26,89,3.15852529543103,14.31683276153134,580,99.97821706692807,41.79055709851332,0.5034580406251702
13013,"Barrow County, Georgia",75099,37033,38066,22978,48812,5756,1921,493,251,74958,6136,5509,11645,9829,4055,5774,33729,177,7.97,89.2,3.5486491164995537,13.08805709796402,2665,99.81224783286062,44.91271521591499,0.4931224117498236
13015,"Bartow County, Georgia",102623,50888,51735,24931,68263,8715,3312,918,283,101698,8096,7247,15343,14417,6324,8093,45999,560,8.22,88.9,4.397649649688666,14.048507644485154,4513,99.09864260448437,44.82328522845756,0.4958732447891798
13017,"Ben Hill County, Georgia",17272,8259,9013,16635,11412,709,334,84,41,16949,1503,1601,3104,5139,2088,3051,6094,114,7.96,91.3,2.65748031496063,29.753358036127835,459,98.12992125984252,35.28253821213525,0.47817276516905977
13019,"Berrien County, Georgia",19014,9297,9717,18064,12923,943,424,113,34,18757,2120,2092,4212,4445,1973,2472,7022,94,7.64,90.7,3.0030503839276323,23.377511307457663,571,98.64836436310087,36.93068265488587,0.48895550646891767
13021,"Bibb County, Georgia",153923,72312,81611,23426,99658,14848,6656,2289,1471,150403,10925,10697,21622,39473,16316,23157,59270,934,10.49,91.7,6.76701987357315,25.644640502069215,10416,97.71314228542843,38.50626612007302,0.4697933382275553
13023,"Bleckley County, Georgia",12779,5909,6870,20667,8035,748,409,102,122,12424,792,656,1448,2591,1106,1485,4126,9,10.1,91.7,4.953439236246967,20.27545191329525,633,97.22200485170984,32.287346427733,0.4623992487675092
13025,"Brantley County, Georgia",18411,9070,9341,18220,12397,543,275,98,56,18354,1775,2100,3875,3970,1646,2324,6345,45,7.16,93.4,2.3301287273912337,21.56319591548531,429,99.69040247678019,34.463092716310904,0.49264026940416056
13027,"Brooks County, Georgia",15629,7531,8098,20964,11034,1056,349,76,17,15564,1581,1444,3025,3641,1467,2174,5681,117,8.82,90.2,2.8280760125407896,23.296436112355238,442,99.584106468744,36.349094631774264,0.48186064367521914
13029,"Bryan County, Georgia",34883,17313,17570,29880,21990,4517,2085,267,265,33781,2167,1969,4136,4897,2194,2703,15955,274,7.54,91.9,7.50222171258206,14.038356792707049,2617,96.84086804460625,45.738611931313244,0.4963162572026489
13031,"Bulloch County, Georgia",73742,36288,37454,20526,40497,6282,3229,678,1100,72880,4850,5439,10289,20153,9325,10828,32205,222,6.59,91.3,6.789889072712972,27.329066203791598,5007,98.83105964036777,43.672533969786556,0.49209405766049197
13033,"Burke County, Georgia",22645,10752,11893,19720,14663,1046,440,174,55,22413,1741,1614,3355,6504,2663,3841,8594,46,8.86,91.8,2.954294546257452,28.72157209096931,669,98.97549127842791,37.95098255685582,0.47480680061823805
13035,"Butts County, Georgia",23556,12464,11092,21236,16454,1169,299,193,71,20914,1533,1189,2722,4892,2124,2768,8549,46,7.81,91.1,2.39004924435388,20.767532688062488,563,88.78417388351163,36.29223976906096,0.5291220920359994
13037,"Calhoun County, Georgia",6503,3915,2588,13865,4864,290,131,23,15,4642,387,484,871,1474,605,869,1594,3,10.95,90.3,2.5988005535906504,22.666461633092418,169,71.38243887436568,24.511763801322466,0.602029832385053
13039,"Camden County, Georgia",52252,26821,25431,26854,32402,4836,2136,390,284,48460,3363,2559,5922,6413,2803,3610,24097,294,7.81,91.9,5.377784582408329,12.273214422414453,2810,92.7428615172625,46.11689504707954,0.5133009262803337
13043,"Candler County, Georgia",10894,5353,5541,18233,7228,681,167,121,73,10621,1074,980,2054,3341,1506,1835,4186,13,6.61,91,3.3137506884523593,30.668257756563246,361,97.49403341288783,38.424821002386636,0.4913713970993207
13045,"Carroll County, Georgia",114898,56032,58866,23139,71749,8691,3486,1062,829,113725,8712,6982,15694,20705,8667,12038,48713,584,9.28,89.8,4.679802955665025,18.02033107625894,5377,98.97909450120977,42.39673449494334,0.487667322320667
13047,"Catoosa County, Georgia",65870,31953,33917,25643,45081,6169,2076,679,210,65387,4527,3986,8513,7045,2892,4153,30985,121,8.56,88.8,4.501290420525277,10.695308941855169,2965,99.26673751328374,47.03962350083498,0.48509184757856383
13049,"Charlton County, Georgia",12963,7393,5570,19102,8975,250,284,105,131,11868,1187,1128,2315,2719,1519,1200,4358,76,8.73,93.5,4.0114171102368275,20.97508292833449,520,91.55288127748206,33.61876108925403,0.5703155133842475
13051,"Chatham County, Georgia",285506,137781,147725,28765,189667,38595,17130,4190,3143,277596,22049,20876,42925,47119,19643,27476,132581,1247,9.26,91.5,8.568296287993947,16.50368118358283,24463,97.22948029113223,46.43720272078345,0.4825853046871169
13053,"Chattahoochee County, Georgia",11096,7455,3641,22774,4948,1224,305,54,50,6395,375,207,582,1139,657,482,6526,79,11.14,89.6,3.6860129776496033,10.264960346070657,409,57.633381398702234,58.813987022350396,0.6718637346791637
13055,"Chattooga County, Georgia",24880,12730,12150,17716,17190,1015,569,115,36,23173,1755,1872,3627,5152,2193,2959,8687,44,7.51,89,2.8938906752411575,20.707395498392284,720,93.13906752411576,34.915594855305464,0.5116559485530546
13057,"Cherokee County, Georgia",235896,116132,119764,33466,156284,38336,12712,2999,1716,234834,15566,12095,27661,22072,10613,11459,115442,1627,8.89,87.4,7.387577576559162,9.35666564926917,17427,99.54980160748805,48.93766744667141,0.4923016922711703
13059,"Clarke County, Georgia",123554,58788,64766,21203,68176,14124,8355,1770,3890,122682,9095,8907,18002,38618,18177,20441,56169,535,8.25,89.7,11.34321834987131,31.255969049970055,14015,99.29423571879502,45.46109393463587,0.47580814866374216
13061,"Clay County, Georgia",3024,1495,1529,14559,2063,61,103,11,8,2968,435,302,737,1230,466,764,857,0,12.77,91.3,4.034391534391534,40.67460317460318,122,98.14814814814815,28.33994708994709,0.49437830687830686
13063,"Clayton County, Georgia",274150,129364,144786,19498,168512,21663,7919,1569,1002,270576,28842,27940,56782,58701,24813,33888,118585,1473,8.2,90.4,3.8263724238555534,21.41200072952763,10490,98.69633412365494,43.25551705270837,0.4718730621922305
13065,"Clinch County, Georgia",6788,3411,3377,17145,4475,335,182,22,10,6688,665,803,1468,2641,1273,1368,2064,8,7.49,93.4,3.152622274602239,38.90689451974072,214,98.52681202121391,30.406599882144963,0.5025044195639363
13067,"Cobb County, Georgia",739072,357252,381820,36587,490883,145159,57686,12924,7583,734497,53775,49928,103703,79127,35390,43737,375583,5879,8.13,88.9,10.579889374783512,10.706264071700728,78193,99.38098047280914,50.818188214409425,0.4833791565639072
13069,"Coffee County, Georgia",43048,22105,20943,18945,27849,2373,1048,347,154,39620,4541,3966,8507,9348,4072,5276,16044,302,7.95,92.1,3.598308864523323,21.71529455491544,1549,92.03679613454749,37.27002415907824,0.5134965619773276
13071,"Colquitt County, Georgia",45890,22806,23084,18121,29544,2089,1156,382,78,45329,6293,5364,11657,11444,5272,6172,18401,222,8.77,89.8,3.521464371322728,24.937894966223578,1616,98.77751144040096,40.09806057964698,0.49697101765090435
13073,"Columbia County, Georgia",143723,70172,73551,31720,94536,20098,8046,2578,1795,139660,5932,5565,11497,12269,5543,6726,65574,369,9.32,91,8.64092733939592,8.536559910383168,12419,97.17303423947455,45.625265267215404,0.4882447485788635
13075,"Cook County, Georgia",17190,8275,8915,17587,11247,1048,418,151,48,17079,1496,2028,3524,4099,1707,2392,6821,25,8.28,90.2,3.5892961023851075,23.845258871436883,617,99.3542757417103,39.68004653868528,0.4813845258871437
13077,"Coweta County, Georgia",138015,67326,70689,31548,91386,18032,6433,1306,765,137378,7187,6761,13948,15900,6485,9415,65750,1042,9.15,90.1,6.1616490961127415,11.520486903597435,8504,99.53845596493134,47.63974930261203,0.4878165416802521
13079,"Crawford County, Georgia",12385,6303,6082,22212,8781,652,354,109,44,12233,869,637,1506,2207,963,1244,4504,44,9.41,91.1,4.093661687525232,17.81994348001615,507,98.77270892208317,36.36657246669358,0.5089220831651191
13081,"Crisp County, Georgia",23005,10813,12192,21225,15148,1286,484,175,116,22589,2020,2015,4035,7025,2944,4081,8130,54,10.38,91.1,3.368832862421213,30.536839817430995,775,98.19169745707455,35.34014344707672,0.4700282547272332
13083,"Dade County, Georgia",16282,7956,8326,23184,11143,1013,415,56,68,16085,1387,1067,2454,2619,1055,1564,7512,32,8.33,86.7,3.310404127257094,16.08524751259059,539,98.79007492936985,46.13683822626213,0.4886377594890063
13085,"Dawson County, Georgia",23397,11529,11868,31954,16644,3226,1518,290,139,23182,1357,1332,2689,2729,1258,1471,10631,67,9.37,86.3,8.321579689703809,11.66388853271787,1947,99.08107877078258,45.43744924562978,0.4927554814719836
13087,"Decatur County, Georgia",27023,13037,13986,19650,17863,1447,807,200,204,25776,2601,2193,4794,6233,2515,3718,9785,421,10.13,91.2,4.481367723790845,23.06553676497798,1211,95.38541242645154,36.20989527439588,0.48244088369167004
13089,"DeKalb County, Georgia",736066,348949,387117,32110,497255,121254,59455,16253,12580,730052,61000,56039,117039,127299,56919,70380,357323,2736,8.44,90,11.994576573296417,17.294508916320005,88288,99.18295370252125,48.54496743498545,0.4740729771515054
13091,"Dodge County, Georgia",21063,11024,10039,18563,14874,1261,611,237,66,19187,1380,1145,2525,4229,1904,2325,7554,347,9.17,91.3,4.339362863789583,20.07786165313583,914,91.09338650714523,35.863837060247825,0.523382234249632
13093,"Dooly County, Georgia",14053,7631,6422,16867,10097,675,232,66,29,12259,1106,973,2079,2837,1091,1746,4735,31,10.22,91.2,2.3269052871273037,20.187860243364405,327,87.23404255319149,33.69387319433573,0.5430157261794635
13095,"Dougherty County, Georgia",91522,42377,49145,20292,58166,6848,3193,1322,692,89580,8373,7794,16167,26759,11282,15477,33910,243,8.91,90.6,5.6893424531806565,29.237778894691985,5207,97.87810581062477,37.05120080417823,0.46302528353838424
13097,"Douglas County, Georgia",140152,66926,73226,25449,90072,14692,7113,1586,645,138979,10162,9858,20020,19690,8243,11447,65368,1057,8.49,89.7,6.667047205890747,14.049032479022776,9344,99.1630515440379,46.64078999942919,0.47752440207774416
13099,"Early County, Georgia",10405,4817,5588,17972,6965,699,427,43,13,10255,981,867,1848,2812,1039,1773,3669,88,10.5,91,4.641999038923594,27.02546852474772,483,98.55838539163864,35.26189332051898,0.46295050456511294
13101,"Echols County, Georgia",4011,2012,1999,20589,2631,127,33,10,11,4011,556,455,1011,1130,593,537,1652,0,8.14,92.2,1.3462976813762153,28.17252555472451,54,100,41.18673647469459,0.5016205435053602
13103,"Effingham County, Georgia",57087,28260,28827,26765,36802,4802,1730,487,61,56487,2978,3216,6194,5405,2022,3383,26583,366,8.16,91.4,3.990400616602729,9.468004974862929,2278,98.94897262073677,46.565768038257396,0.4950338956329812
13105,"Elbert County, Georgia",19288,9218,10070,21138,13469,856,467,137,29,19061,1349,1401,2750,4246,1908,2338,7240,0,6.65,90.8,3.2818332642057237,22.01368726669432,633,98.82310244711738,37.536291995022815,0.47791372874326005
13107,"Emanuel County, Georgia",22502,11183,11319,17944,14815,1001,489,240,120,21788,2432,1872,4304,6329,3050,3279,8025,53,6.61,91.1,3.7729979557372677,28.12638876544307,849,96.82694871566972,35.66349657808195,0.49697804639587595
13109,"Evans County, Georgia",10757,5093,5664,20736,7155,714,266,63,68,10236,719,888,1607,2657,1185,1472,4122,327,6.63,91.9,3.6906200613553963,24.700195221716093,397,95.15664218648323,38.319233987171145,0.4734591428837036
13111,"Fannin County, Georgia",24480,11852,12628,24845,18656,2216,778,402,151,24327,1656,1716,3372,3806,1412,2394,9006,142,8.1,84.4,5.437091503267974,15.547385620915033,1331,99.375,36.78921568627451,0.4841503267973856
13113,"Fayette County, Georgia",110306,53551,56755,39936,74267,21811,9202,2423,1244,109570,3957,4033,7990,6907,2640,4267,51042,858,8.38,90.5,11.666636447700034,6.261672075861694,12869,99.33276521676065,46.27309484524867,0.4854767646365565
13115,"Floyd County, Georgia",96471,46770,49701,23929,63693,7793,3316,1407,531,94340,7417,6279,13696,16774,7864,8910,40855,359,7.64,89.9,5.446196266235449,17.387608711426232,5254,97.791046013828,42.349514361828945,0.4848089063034487
13117,"Forsyth County, Georgia",211300,104886,106414,39896,136116,45515,18472,2612,1680,210703,10040,9951,19991,13643,5964,7679,101713,886,8.7,87.7,10.77330809275911,6.456696639848556,22764,99.71746332229058,48.136772361571225,0.4963842877425461
13119,"Franklin County, Georgia",22328,10852,11476,19663,15254,1243,436,193,80,22121,2059,1846,3905,5503,2378,3125,8110,70,6.47,89.8,3.175385166606951,24.6461841633823,709,99.0729129344321,36.32210677176639,0.4860265137943389
13121,"Fulton County, Georgia",1010420,489797,520623,41041,674996,201680,98386,25993,12681,1001021,62577,59530,122107,156519,67517,89002,492154,4974,7.61,89.5,13.564656281546288,15.490489103541101,137060,99.06979275944657,48.707864056530944,0.4847459472298648
13123,"Gilmer County, Georgia",29614,14950,14664,23688,21559,2494,1026,346,139,29413,3586,2592,6178,5520,2799,2721,11883,190,9.44,84.7,5.1023164719389476,18.639832511649896,1511,99.32126696832579,40.12629161882893,0.504828797190518
13125,"Glascock County, Georgia",3027,1464,1563,19815,2067,148,37,0,9,2939,152,176,328,339,149,190,1297,16,9.36,90.7,1.5196564255037992,11.199207135777998,46,97.09283118599274,42.84770399735712,0.4836471754212091
13127,"Glynn County, Georgia",83467,39362,44105,29209,57587,10305,4522,1248,600,82462,6422,6351,12773,15773,6636,9137,36295,467,6.88,91.7,7.631758659110786,18.89728874884685,6370,98.79593132615285,43.484251260977395,0.4715875735320546
13129,"Gordon County, Georgia",56424,27913,28511,21208,37612,3033,1492,399,223,55913,4567,4616,9183,10466,4764,5702,24783,504,7.5,89,3.7466326385935065,18.548844463348928,2114,99.09435701120091,43.922798809017436,0.4947008365234652
13131,"Grady County, Georgia",25048,12247,12801,20864,16885,1418,706,131,62,24860,2437,2312,4749,6284,2938,3346,10008,40,9.4,90.3,3.589108910891089,25.08783136378154,899,99.24944107313958,39.95528585116576,0.4889412328329607
13133,"Greene County, Georgia",16732,8142,8590,32890,12443,1733,847,472,134,16566,1318,1200,2518,3623,1719,1904,6044,247,6.94,90.9,8.683958881185752,21.653119770499643,1453,99.00788907482668,36.1224001912503,0.48661247908199856
13135,"Gwinnett County, Georgia",889954,435401,454553,27945,562979,131038,50418,9748,7616,884817,83490,78330,161820,107267,48546,58721,429297,3844,7.38,89,7.616348710158053,12.053094879061165,67782,99.42277915487767,48.23811118327464,0.48923989329785583
13137,"Habersham County, Georgia",43878,20824,23054,20656,29498,2982,1651,496,284,41951,3617,3733,7350,7114,3264,3850,16945,177,7.38,87.1,5.540361912575778,16.213136423720314,2431,95.60827749669538,38.61844204384885,0.4745886321163225
13139,"Hall County, Georgia",192865,96103,96762,26283,124695,18303,7415,2416,1173,191800,18162,16895,35057,30634,14381,16253,88487,1004,8.65,88,5.7055453296347185,15.883649184662847,11004,99.44780027480363,45.88027895159827,0.4982915510849558
13141,"Hancock County, Georgia",8667,5258,3409,15454,6709,330,141,83,30,6021,174,371,545,1804,694,1110,2112,0,9.22,91,2.9306565132110305,20.814584054459445,254,69.47040498442368,24.368293527172032,0.6066689742702204
13143,"Haralson County, Georgia",28722,13965,14757,23141,19468,1533,714,352,149,28388,2001,1670,3671,5064,2154,2910,11601,101,8.13,89.2,4.230206810110716,17.631084186337997,1215,98.8371283336815,40.390641320242324,0.48621265928556506
13145,"Harris County, Georgia",33198,16686,16512,32373,23065,3813,1702,551,244,32677,1755,1292,3047,2382,963,1419,15045,237,10.23,89.7,7.521537442014579,7.175131031989879,2497,98.43062835110548,45.318995120187964,0.5026206397975782
13147,"Hart County, Georgia",25535,12502,13033,21668,18073,1502,562,304,118,24722,1900,1469,3369,4642,2115,2527,9855,21,7.13,90.4,3.853534364597611,18.17897004112003,984,96.81613471705502,38.59408654787546,0.48960250636381436
13149,"Heard County, Georgia",11607,5762,5845,20946,7914,488,230,89,44,11458,849,978,1827,1975,818,1157,4592,36,11.12,90,3.1274231067459293,17.01559403808047,363,98.71629189282329,39.56233307486861,0.49642457137934004
13151,"Henry County, Georgia",217506,104175,113331,26924,138840,24882,10366,2353,1220,216285,12068,13187,25255,24638,10920,13718,96912,879,7.97,90.8,6.408558844353719,11.32750360909584,13939,99.43863617555378,44.556012247937986,0.4789523047640065
13153,"Houston County, Georgia",150341,73081,77260,26305,97589,15147,7621,1385,606,146927,10680,9679,20359,24745,10448,14297,66722,406,10.22,91.6,6.393465521713971,16.459249306576382,9612,97.72916237087688,44.38044179565122,0.4861015957057622
13155,"Irwin County, Georgia",9278,4767,4511,19429,6360,410,212,153,59,8996,869,704,1573,2204,1054,1150,3245,86,7.71,91.2,4.569950420349214,23.755119637852985,424,96.96055184306962,34.975210174606595,0.5137960767406768
13157,"Jackson County, Georgia",63851,31539,32312,25598,42968,5506,1974,657,325,63273,4215,4382,8597,7898,3583,4315,27766,167,7.42,89.1,4.629528120154736,12.369422561901928,2956,99.09476750559897,43.48561494729918,0.49394684499851216
13159,"Jasper County, Georgia",13732,6688,7044,19784,9416,539,336,67,47,13640,1092,814,1906,2623,1066,1557,5379,94,8.29,91.1,3.277017186134576,19.101369064957762,450,99.33003204194581,39.17127876492864,0.48703757646373436
13161,"Jeff Davis County, Georgia",14999,7403,7596,18550,9716,579,210,181,31,14911,1279,1367,2646,3079,1281,1798,5390,18,7.96,91.8,2.813520901393426,20.528035202346825,422,99.41329421961464,35.93572904860324,0.4935662377491833
13163,"Jefferson County, Georgia",15954,7691,8263,17485,10706,805,297,30,4,15477,1523,1266,2789,4162,1845,2317,5732,2,9.64,91.1,2.0747148050645605,26.08750156700514,331,97.01015419330575,35.92829384480381,0.48207346120095274
13165,"Jenkins County, Georgia",8929,4273,4656,15149,5838,294,159,29,0,8852,773,792,1565,2720,1102,1618,3154,0,6.89,91.3,2.1054989360510694,30.462537798185686,188,99.13764139321313,35.323104490984434,0.47855302945458617
13167,"Johnson County, Georgia",9800,5476,4324,19706,6970,418,146,7,97,9553,1007,661,1668,2037,970,1067,4058,46,9.57,91.5,2.5510204081632653,20.785714285714285,250,97.4795918367347,41.40816326530612,0.5587755102040817
13169,"Jones County, Georgia",28540,13864,14676,26098,19462,2393,1253,292,100,28202,1892,1414,3306,4001,1836,2165,12021,32,9.79,91.3,5.763840224246671,14.018920812894184,1645,98.8156972669937,42.119831814996495,0.48577435178696565
13171,"Lamar County, Georgia",18282,8800,9482,20458,11670,1499,409,104,135,18042,1458,1564,3022,3525,1597,1928,6840,90,7.82,90.6,3.54446997046275,19.281260255989498,648,98.68723334427305,37.41384968821792,0.4813477737665463
13173,"Lanier County, Georgia",10388,5208,5180,17739,6829,724,266,74,12,9812,820,899,1719,2875,1312,1563,3704,23,8.19,91.7,3.3885252214093184,27.67616480554486,352,94.45514054678475,35.65652676164805,0.5013477088948787
13175,"Laurens County, Georgia",47451,22542,24909,20687,31623,2645,1513,534,193,46458,3008,2970,5978,12683,5813,6870,16895,166,8.83,91.7,4.720659206339171,26.728625318749867,2240,97.90731491433267,35.60515057638406,0.4750584813807928
13177,"Lee County, Georgia",29216,14524,14692,28061,19114,2881,1592,281,154,28257,1790,1242,3032,3281,1664,1617,13333,11,9.68,90.4,6.937979189485214,11.230147864184008,2027,96.71755202628697,45.635952902519165,0.4971248630887185
13179,"Liberty County, Georgia",62120,31466,30654,20966,35487,4787,1611,294,209,56244,3808,3359,7167,9931,4291,5640,27213,237,7.99,92.1,3.403090792015454,15.986799742433998,2114,90.54088860270444,43.80714745653574,0.5065357372826786
13181,"Lincoln County, Georgia",7768,3651,4117,24529,5687,449,185,29,24,7689,543,469,1012,1773,735,1038,3166,52,7.1,90.8,3.063851699279094,22.824407826982494,238,98.98300720906282,40.75695159629248,0.470005149330587
13183,"Long County, Georgia",17857,8746,9111,20321,10865,1093,522,14,62,17064,1756,1313,3069,3530,1581,1949,6552,278,7.88,92.6,3.348826790614325,19.76815814526516,598,95.55916447331579,36.691493531948254,0.4897799182393459
13185,"Lowndes County, Georgia",113941,55796,58145,21199,66466,9903,4789,1187,901,108833,9538,8595,18133,27410,11856,15554,48568,335,7.9,90.9,6.035579817624911,24.05630984456868,6877,95.51697808514933,42.62556937362319,0.48969203359633495
13187,"Lumpkin County, Georgia",31567,15502,16065,23364,19786,2977,1688,373,236,31283,2164,2044,4208,6052,2896,3156,14359,44,8.77,86,7.276586308486711,19.171920043082967,2297,99.10032629011309,45.487376057275,0.4910824595305224
13189,"McDuffie County, Georgia",21488,10028,11460,20436,14103,1363,455,285,53,21098,1490,1715,3205,5503,2297,3206,8135,132,8.41,90.3,3.6904318689501117,25.6096425912137,793,98.18503350707371,37.85833953834698,0.46667907669396874
13191,"McIntosh County, Georgia",14061,6896,7165,25226,10558,877,464,45,88,13941,1150,1117,2267,2829,1200,1629,5463,11,7.17,91.9,4.245786217196501,20.11947941113719,597,99.14657563473438,38.85214422871773,0.4904345352393144
13193,"Macon County, Georgia",13675,7563,6112,15919,9658,504,211,22,93,11784,1350,1075,2425,3364,1417,1947,4355,154,9.57,90.6,2.3839122486288846,24.59963436928702,326,86.17184643510055,31.846435100548447,0.5530530164533821
13195,"Madison County, Georgia",28600,14345,14255,22885,19636,1827,1018,287,151,28410,2224,1925,4149,4977,2473,2504,11849,169,7.56,89.3,5.090909090909091,17.402097902097903,1456,99.33566433566433,41.430069930069934,0.5015734265734266
13197,"Marion County, Georgia",8558,4207,4351,20154,6102,426,244,68,23,8458,756,341,1097,1952,817,1135,3321,119,10.62,88.4,3.9144659967282074,22.80906753914466,335,98.83150268754382,38.80579574666978,0.4915868193503155
13199,"Meriwether County, Georgia",21152,10134,11018,19679,14731,943,468,111,48,21038,1609,1448,3057,4735,1988,2747,7962,42,9.02,90,2.9642586989409985,22.385590015128592,627,99.46104387291982,37.64183055975794,0.4791036308623298
13201,"Miller County, Georgia",5884,2885,2999,21002,4095,313,124,15,14,5722,400,376,776,1332,503,829,2347,42,10.36,91,2.600271923861319,22.637661454792656,153,97.24677090414684,39.88783140720598,0.49031271244051666
13205,"Mitchell County, Georgia",22574,11748,10826,16088,15298,1270,508,44,59,20373,1874,2117,3991,5438,2177,3261,7630,109,9.56,90.4,2.706653672366439,24.08966067156906,611,90.24984495437229,33.79994684149907,0.5204217241073802
13207,"Monroe County, Georgia",26795,13475,13320,30359,18924,2322,1316,384,272,25647,1651,1499,3150,3415,1436,1979,10712,97,8.58,91.1,7.359582011569323,12.74491509610002,1972,95.71561858555701,39.977607762642286,0.502892330658705
13209,"Montgomery County, Georgia",8962,4593,4369,20114,5966,525,280,62,57,8536,528,704,1232,1593,711,882,3430,49,7.4,91.5,4.452131220709663,17.77505021200625,399,95.24659674179871,38.27270698504798,0.5124972104440974
13211,"Morgan County, Georgia",18013,8558,9455,28830,12387,1671,710,317,35,17838,1115,1161,2276,2374,851,1523,7838,108,7.57,90.8,5.895741964137012,13.179370454671625,1062,99.02847943152167,43.51301837561761,0.475101315716427
13213,"Murray County, Georgia",39444,19397,20047,19084,26017,1448,641,256,153,39245,3651,3413,7064,7026,3267,3759,16474,134,9.08,87.9,2.66200182537268,17.812595071493764,1050,99.49548727309603,41.76554102018051,0.49176047054051314
13215,"Muscogee County, Georgia",198647,97309,101338,24604,127882,20489,8709,2562,1447,187695,13301,12441,25742,41295,18284,23011,84929,1167,10.87,90.1,6.402311638232644,20.788131711025084,12718,94.48670254270138,42.7537289765262,0.4898588954275675
13217,"Newton County, Georgia",105042,49940,55102,23611,66904,8455,3471,766,611,104152,6469,6927,13396,17328,7451,9877,45015,676,7.84,90.8,4.615296738447478,16.496258639401383,4848,99.15271986443518,42.854286856685896,0.47542887606862017
13219,"Oconee County, Georgia",35972,17661,18311,38639,23495,5398,3460,1131,1336,35778,1434,1295,2729,2476,1138,1338,16635,46,8.44,90.2,16.47670410319137,6.883131324363394,5927,99.46069164906038,46.24430112309574,0.4909651951517847
13221,"Oglethorpe County, Georgia",14654,7362,7292,21858,10457,999,460,95,72,14503,979,936,1915,2543,992,1551,6327,21,7.82,90.3,4.278695236795414,17.353623584004367,627,98.96956462399345,43.175924662208274,0.5023884263682271
13223,"Paulding County, Georgia",152399,74560,77839,26636,97288,15601,5950,1547,613,151710,8880,8715,17595,14716,6104,8612,73155,412,8.93,89.1,5.321557228065801,9.656231340100657,8110,99.54789729591401,48.00228347955039,0.4892420553940643
13225,"Peach County, Georgia",27027,12992,14035,22388,17205,2049,1120,172,152,26928,1987,1897,3884,4685,2067,2618,11119,22,10.17,91.3,5.342805342805343,17.334517334517333,1444,99.633699633699635,41.14034114034114,0.4807044807044807
13227,"Pickens County, Georgia",30343,15046,15297,29460,22087,3479,1592,311,110,30107,1960,1755,3715,2964,1283,1681,12804,185,8.77,85.9,6.634149556734667,9.768315591734503,2013,99.22222588405893,42.1975414428369,0.495863955442771
13229,"Pierce County, Georgia",19141,9640,9501,23754,12969,851,471,170,151,18993,1800,1441,3241,3994,1923,2071,7407,94,7.53,93.8,4.1377148529334935,20.866203437646934,792,99.22679065879525,38.697037772321195,0.503630949271198
13231,"Pike County, Georgia",17919,8817,9102,25176,12147,1346,376,163,116,17671,1463,1116,2579,2148,990,1158,7374,10,8.12,90.5,3.6553379094815557,11.987276075673865,655,98.6159941961047,41.151849991629,0.49204754729616607
13233,"Polk County, Georgia",41444,20231,21213,22314,27250,2045,957,313,143,41217,3813,2792,6605,7781,3153,4628,17240,147,7.41,89.9,3.409419940160216,18.774732168709583,1413,99.45227294662678,41.59830132226619,0.4881526879644822
13235,"Pulaski County, Georgia",11396,4942,6454,18623,8466,570,372,67,56,9855,857,851,1708,2143,965,1178,3725,0,10.27,91.7,4.343629343629344,18.804843804843806,495,86.47771147771148,32.68690768690769,0.43366093366093367
13237,"Putnam County, Georgia",21430,10410,11020,27498,15663,2284,779,246,49,21260,1990,1411,3401,3425,1677,1748,8911,230,8.92,91.2,5.011665888940738,15.982267848810078,1074,99.20671955202987,41.581894540363976,0.4857676154923005
13239,"Quitman County, Georgia",2140,1024,1116,18921,1658,87,37,14,0,2140,229,166,395,488,184,304,719,7,12.31,91.5,2.383177570093458,22.80373831775701,51,100,33.598130841121495,0.4785046728971963
13241,"Rabun County, Georgia",16354,8126,8228,26942,12302,1741,839,269,264,16141,1946,1578,3524,3259,1535,1724,6205,17,9.39,85,8.389384859973095,19.927846398434635,1372,98.69756634462517,37.94178794178794,0.4968814968814969
13243,"Randolph County, Georgia",7206,3574,3632,19781,4982,344,150,30,78,7090,786,468,1254,2449,1183,1266,2630,64,12.33,90,3.5803497085761866,33.98556758257008,258,98.3902303635859,36.497363308354146,0.49597557590896474
13245,"Richmond County, Georgia",201568,97435,104133,21464,130545,16928,6393,2560,1590,191995,14486,13206,27692,46692,20497,26195,82121,1344,10.04,92.1,5.230492935386569,23.164391173202095,10543,95.25073424353072,40.74108985553262,0.48338525956501033
13247,"Rockdale County, Georgia",88482,41755,46727,24254,57669,9998,3586,656,620,87695,6686,6909,13595,14232,6362,7870,38112,234,7.62,90.7,5.494902918107638,16.084627381840374,4862,99.11055355891594,43.07316742388282,0.4719038900567347
13249,"Schley County, Georgia",5168,2496,2672,19761,3346,271,145,18,24,5168,409,445,854,1148,408,740,1956,11,9.93,89,3.6184210526315788,22.21362229102167,187,100,37.84829721362229,0.48297213622291024
13251,"Screven County, Georgia",14037,6896,7141,20255,9671,919,358,100,47,13645,1178,975,2153,3092,1438,1654,5502,35,6.3,91.4,3.5976348222554675,22.027498753294864,505,97.20738049440763,39.1964094892071,0.49127306404502386
13253,"Seminole County, Georgia",8549,4003,4546,21257,5940,554,240,62,39,8448,754,765,1519,2149,850,1299,2805,41,11.92,91.8,3.988770616446368,25.13744297578664,341,98.81857527196163,32.81085507076851,0.4682418996373845
13255,"Spalding County, Georgia",64192,31075,33117,21675,43193,4527,1458,524,489,63180,5405,4476,9881,13624,5590,8034,24245,272,8.05,90.7,3.8493893320039883,21.22382851445663,2471,98.42347956131606,37.76950398803589,0.48409459122632104
13257,"Stephens County, Georgia",25625,11930,13695,21657,17196,1824,977,513,60,25619,2131,1767,3898,4504,1851,2653,10028,51,7.38,89.5,6.048780487804878,17.57658536585366,1550,99.97658536585367,39.133658536585365,0.4655609756097561
13259,"Stewart County, Georgia",5832,3618,2214,14954,4316,416,99,20,0,3965,370,230,600,1640,681,959,1376,0,11.61,89.9,2.040466392318244,28.12071330589849,119,67.98696844993141,23.593964334705074,0.6203703703703703
13261,"Sumter County, Georgia",30687,14492,16195,18785,19209,1683,918,393,233,29786,2349,1847,4196,9560,4125,5435,11137,41,9.96,89.7,5.031446540880503,31.153257079545085,1544,97.06390328151986,36.29224101411021,0.47225209372046795
13263,"Talbot County, Georgia",6423,3030,3393,21351,4775,393,139,20,44,6405,333,536,869,1070,488,582,2561,112,9.23,89.5,3.1605168924178733,16.658882142301106,203,99.7197571228398,39.872333800404796,0.4717421765530126
13265,"Taliaferro County, Georgia",1844,938,906,17939,1361,75,9,4,5,1844,212,117,329,571,248,323,627,15,6.96,90.4,0.9761388286334056,30.96529284164859,18,100,34.00216919739697,0.5086767895878525
13267,"Tattnall County, Georgia",25402,14892,10510,16279,17799,1310,641,199,34,19121,1487,1462,2949,4553,1736,2817,7292,369,6.68,92.1,3.440673962680104,17.923785528698527,874,75.27360050389733,28.70640107078183,0.5862530509408708
13269,"Taylor County, Georgia",8267,4047,4220,18482,5741,419,193,30,10,8100,837,703,1540,2285,1064,1221,2928,51,9.18,89.7,2.8184347405346557,27.64001451554373,233,97.9799201645095,35.417926696504175,0.4895367122293456
13271,"Telfair County, Georgia",16339,9532,6807,13594,12318,513,353,86,46,13035,1034,946,1980,3608,1556,2052,4794,60,7.48,91.6,2.9683579166411653,22.08213476956974,485,79.77844421323215,29.34084093273762,0.5833894363180121
13273,"Terrell County, Georgia",8978,4229,4749,17562,6069,351,178,73,53,8659,889,902,1791,3047,1182,1865,3230,0,10.64,89.8,3.386054800623747,33.938516373357096,304,96.44687012697706,35.97683225662731,0.471040320784139
13275,"Thomas County, Georgia",44909,21200,23709,24047,30451,3643,2102,442,570,44220,3551,3474,7025,8580,3755,4825,18035,110,9.22,90,6.934022133648043,19.105301832594805,3114,98.4657863679886,40.15898817608942,0.4720657329265849
13277,"Tift County, Georgia",40531,19502,21029,20800,25690,2154,1402,322,442,40137,4050,3861,7911,10725,4714,6011,16645,198,8.26,90.1,5.344057634896746,26.461227208803138,2166,99.02790456687474,41.06733117860403,0.4811625669240828
13279,"Toombs County, Georgia",27160,12706,14454,21309,17485,1709,804,142,117,26883,2906,2722,5628,6532,2954,3578,10379,222,6.98,91.7,3.913843888070692,24.050073637702504,1063,98.98011782032401,38.214285714285715,0.467820324005891
13281,"Towns County, Georgia",11173,5272,5901,22301,8133,1232,541,176,133,10996,638,775,1413,1516,648,868,3901,75,7.8,84.1,7.6076255258211765,13.568423878994004,850,98.41582386109371,34.91452608968048,0.47185178555446167
13283,"Treutlen County, Georgia",6752,3394,3358,20775,4764,455,212,33,39,6404,705,488,1193,1347,720,627,2626,45,6.93,91.3,4.206161137440758,19.949644549763033,284,94.84597156398104,38.89218009478673,0.5026658767772512
13285,"Troup County, Georgia",69433,33345,36088,22091,44844,5136,2244,570,368,68018,4642,4396,9038,14430,5653,8777,28833,353,10.41,90,4.5828352512494055,20.782624976596143,3182,97.96206414817162,41.52636354471217,0.4802471447294514
13287,"Turner County, Georgia",8036,3937,4099,20302,5555,473,133,119,25,7685,699,573,1272,2137,965,1172,3149,64,9.22,90.4,3.446988551518168,26.59283225485316,277,95.63215530114485,39.18616226978596,0.48992035838725734
13289,"Twiggs County, Georgia",8323,4101,4222,17485,6007,350,140,49,16,8241,787,573,1360,2244,1008,1236,2517,13,10.45,91.7,2.4630541871921183,26.961432175898114,205,99.01477832512315,30.241499459329567,0.4927309864231647
13291,"Union County, Georgia",22262,10855,11407,26755,17387,2091,1378,224,131,21757,1416,1208,2624,2788,1421,1367,7844,84,7.63,84.1,7.784565627526727,12.523582786811607,1733,97.73156050669301,35.23492947623753,0.4876021920761836
13293,"Upson County, Georgia",26241,12568,13673,19624,18022,1425,617,202,84,25695,1786,2043,3829,5817,2692,3125,9615,118,7.83,90.6,3.4411798330856294,22.167600320109752,903,97.91928661255288,36.64113410312107,0.47894516215083266
13295,"Walker County, Georgia",68609,33911,34698,22564,48020,4981,1738,413,306,67252,4402,5198,9600,11523,5454,6069,28506,145,6.89,87.8,3.5811628212042153,16.795172644988266,2457,98.02212537713712,41.54848489265257,0.49426460085411533
13297,"Walton County, Georgia",88695,43120,45575,25184,58380,7718,2295,798,263,87884,5422,5254,10676,11200,4478,6722,38463,308,7.07,90,3.783753311911607,12.627543829979142,3356,99.08563053159705,43.36546592254355,0.48616043745419696
13299,"Ware County, Georgia",35688,17900,17788,19246,24214,1912,803,379,165,33350,2556,2924,5480,8240,3212,5028,13027,95,7.02,94,3.7743779421654335,23.088993499215423,1347,93.44877830082942,36.502465814839724,0.5015691548980049
13301,"Warren County, Georgia",5410,2534,2876,20712,3962,336,151,53,4,5336,361,515,876,1427,579,848,2044,14,8.15,90.2,3.844731977818854,26.377079482439925,208,98.63216266173752,37.781885397412196,0.46839186691312384
13303,"Washington County, Georgia",20506,10343,10163,19238,14069,1244,507,76,13,18795,1362,1351,2713,5074,2083,2991,7469,102,10.51,91.5,2.906466400078026,24.743977372476348,596,91.65610065346728,36.423485809031504,0.5043889593289769
13305,"Wayne County, Georgia",29833,15206,14627,19188,20139,1504,692,242,124,27735,2319,2897,5216,5863,2371,3492,10266,252,7.32,93,3.546408339757986,19.652733550095533,1058,92.96751919015855,34.41155767103543,0.5097040190393188
13307,"Webster County, Georgia",2627,1329,1298,22206,1804,116,78,5,4,2622,54,200,254,509,199,310,1113,21,10.94,88.9,3.311762466692044,19.375713741910925,87,99.80966882375333,42.36771983250856,0.5059002664636467
13309,"Wheeler County, Georgia",7952,5132,2820,11192,5426,381,41,16,0,6121,678,660,1338,1780,840,940,1839,23,7.11,91.7,0.7168008048289738,22.38430583501006,57,76.97434607645876,23.12625754527163,0.6453722334004024
13311,"White County, Georgia",28509,13814,14695,23630,20066,2396,1212,297,154,28317,1923,2001,3924,4981,2155,2826,11654,5,7.4,86.2,5.833245641727174,17.471675611210493,1663,99.32652846469536,40.87831912729314,0.4845487389947034
13313,"Whitfield County, Georgia",103963,51566,52397,22262,66225,6158,2211,1033,244,103153,10267,10027,20294,19710,8780,10930,45859,285,7.58,88.9,3.3550397737656668,18.958667987649452,3488,99.2208766580418,44.110885603532026,0.4960033858199552
13315,"Wilcox County, Georgia",8896,5248,3648,15119,6390,390,199,48,35,6829,463,658,1121,1491,632,859,2359,25,9.92,91.2,3.1699640287769784,16.760341726618705,282,76.7648381294964,26.517535971223023,0.5899280575539568
13317,"Wilkes County, Georgia",9905,4749,5156,21957,6979,541,214,109,135,9809,904,674,1578,2595,1108,1487,3809,21,6.41,90.4,4.623927309439677,26.198889449772842,458,99.03079252902575,38.45532559313478,0.479454820797577
13319,"Wilkinson County, Georgia",9147,4385,4762,19823,6253,345,186,18,12,9058,496,420,916,2112,955,1157,3144,16,10.51,91.8,2.361429977041653,23.089537553296164,216,99.02700338908932,34.37192522138406,0.4793921504318356
13321,"Worth County, Georgia",20809,10171,10638,20783,14137,954,473,68,64,20647,1896,1698,3594,4447,2019,2428,8075,113,8.58,90.1,2.90739583833918,21.370560815031958,605,99.22149070113893,38.80532461915517,0.48877889374789757
16001,"Ada County, Idaho",435117,217999,217118,31642,289374,73092,24666,6660,4485,428436,21045,18018,39063,50474,23748,26726,212225,1334,3.1,96.3,8.23020015306228,11.60009836434798,35811,98.46455091389213,48.774237733758966,0.5010123713851676
16003,"Adams County, Idaho",3946,2021,1925,24315,3041,359,208,40,9,3919,279,340,619,541,306,235,1518,16,7.13,86.8,6.512924480486569,13.710086163203243,257,99.31576279776989,38.46933603649265,0.5121642169285352
16005,"Bannock County, Idaho",84113,41867,42246,23872,52599,9807,3102,986,861,82996,4199,3709,7908,14445,6747,7698,36153,299,4.91,88.1,5.883751619844733,17.17332635858904,4949,98.67202453841855,42.981465409627525,0.49774707833509685
16007,"Bear Lake County, Idaho",5942,2928,3014,24411,3904,646,105,23,18,5904,320,275,595,853,432,421,2453,0,6.03,82.3,2.457085156512959,14.355435880175024,146,99.36048468529114,41.28239649949512,0.49276337933355774
16009,"Benewah County, Idaho",9050,4568,4482,23120,6422,617,210,43,33,8966,820,539,1359,1418,664,754,3296,63,7.27,86.1,3.160220994475138,15.668508287292818,286,99.07182320441989,36.41988950276243,0.5047513812154696
16011,"Bingham County, Idaho",45369,22732,22637,20720,27152,3747,1110,251,124,45076,2963,2810,5773,5905,2857,3048,18881,217,2.98,89.4,3.273160087284269,13.015495161894686,1485,99.35418457537085,41.61652229495911,0.5010469703982896
16013,"Blaine County, Idaho",21583,11040,10543,32736,15157,4166,1334,307,313,21557,1957,1535,3492,3180,1542,1638,11712,174,6.81,85.7,9.053421674466016,14.733818282907844,1954,99.87953481907057,54.264930732520966,0.5115136913311402
16015,"Boise County, Idaho",6968,3678,3290,29648,5350,1026,380,65,89,6944,454,272,726,782,422,360,2694,3,8.59,85.6,7.663605051664753,11.222732491389207,534,99.65556831228473,38.662456946039036,0.527841561423651
16017,"Bonner County, Idaho",41855,20980,20875,25909,30832,4627,1393,507,393,41541,2847,2788,5635,5752,2619,3133,16676,152,7.42,83.4,5.4784374626687375,13.742683072512245,2293,99.24979094492892,39.842312746386334,0.5012543304264724
16019,"Bonneville County, Idaho",110404,55082,55322,25706,66489,13665,4014,850,944,109149,5844,4973,10817,12919,5469,7450,47910,416,3.99,84.2,5.260678960907214,11.70156878373972,5808,98.86326582370204,43.3951668417811,0.4989130828593167
16021,"Boundary County, Idaho",11323,5655,5668,24606,7869,1029,243,128,32,11245,1142,1343,2485,2040,940,1100,3944,29,11.2,81,3.5591274397244548,18.0164267420295,403,99.31113662456946,34.8317583679237,0.49942594718714123
16023,"Butte County, Idaho",2613,1350,1263,26227,1897,227,55,7,5,2572,182,157,339,416,228,188,973,10,3.42,86.4,2.5641025641025643,15.92039800995025,67,98.43092231151932,37.236892460773056,0.5166475315729047
16025,"Camas County, Idaho",886,443,443,29193,611,91,25,6,4,886,90,90,180,198,86,112,394,7,8.58,83,3.950338600451467,22.34762979683973,35,100,44.46952595936794,0.5
16027,"Canyon County, Idaho",207027,102480,104547,19765,125936,16252,5251,516,725,205466,16518,14881,31399,34812,15973,18839,86387,833,2.49,96.9,3.1358228636844467,16.815198017649873,6492,99.24599206866738,41.72740753621508,0.49500789752061325
16029,"Caribou County, Idaho",6862,3483,3379,25669,4413,675,106,22,83,6793,287,231,518,633,288,345,2901,9,5.56,83.7,3.074905275429904,9.224715826289712,211,98.99446225590206,42.27630428446517,0.5075779656076945
16031,"Cassia County, Idaho",23472,11966,11506,20007,13738,1786,476,161,68,23123,2093,1869,3962,3393,1572,1821,9752,10,3.73,88.4,3.0035787321063396,14.455521472392638,705,98.51312201772325,41.54737559645535,0.5097989093387867
16033,"Clark County, Idaho",1055,566,489,15283,587,65,16,0,19,1055,204,100,304,255,157,98,428,0,3.12,83.4,3.3175355450236967,24.170616113744074,35,100,40.56872037914692,0.5364928909952607
16035,"Clearwater County, Idaho",8533,4742,3791,22169,6659,824,221,80,33,7535,393,443,836,1048,478,570,2719,49,9.79,84.3,3.914215399039025,12.281729755068557,334,88.30423063400914,31.864525958045235,0.5557248330012892
16037,"Custer County, Idaho",4141,2164,1977,23290,3235,511,197,12,11,4115,205,352,557,773,359,414,1650,59,6.61,80,5.312726394590679,18.66698865008452,220,99.37213233518474,39.84544795943009,0.5225790871770104
16039,"Elmore County, Idaho",26232,13651,12581,23029,16039,2046,586,121,70,23957,1501,1836,3337,3783,1733,2050,11610,132,5.55,90.8,2.962031107044831,14.42131747483989,777,91.32738639829216,44.258920402561756,0.5203949374809393
16041,"Franklin County, Idaho",13120,6686,6434,20454,7619,1085,290,68,95,13083,808,796,1604,1601,684,917,5557,27,6.21,87.1,3.4527439024390243,12.202743902439025,453,99.71798780487805,42.355182926829265,0.5096036585365854
16043,"Fremont County, Idaho",12889,6685,6204,21611,8210,1220,346,77,90,12337,715,834,1549,1458,643,815,5098,77,3.49,83.2,3.9801381022577393,11.311971448521996,513,95.717278299325,39.553107300799134,0.5186593219023974
16045,"Gem County, Idaho",16850,8331,8519,20041,11696,1355,453,100,63,16717,1484,1415,2899,3455,1737,1718,6322,86,4.45,92.4,3.655786350148368,20.504451038575667,616,99.2106824925816,37.519287833827896,0.4944213649851632
16047,"Gooding County, Idaho",15110,7737,7373,20821,9639,984,283,80,70,15024,1483,1300,2783,2392,1166,1226,6821,81,2.62,94,2.8656518861681004,15.830575777630708,433,99.43084050297816,45.14228987425546,0.5120450033090669
16049,"Idaho County, Idaho",16275,8509,7766,20741,11941,1596,445,126,115,15648,939,968,1907,2105,941,1164,6208,53,7.52,84.3,4.21505376344086,12.93394777265745,686,96.14746543778801,38.144393241167435,0.522826420890937
16051,"Jefferson County, Idaho",27410,13911,13499,21519,15686,2398,666,172,96,27376,1775,1405,3180,2596,1086,1510,11708,152,2.33,90.8,3.40751550529004,9.470995986866107,934,99.87595767967895,42.714337832907695,0.5075155052900401
16053,"Jerome County, Idaho",23039,11619,11420,19329,13837,1299,299,131,76,22919,2576,2302,4878,3693,1517,2176,9814,20,2.23,94.2,2.196275880029515,16.02934155128261,506,99.47914406007204,42.59733495377404,0.5043187638352359
16055,"Kootenai County, Idaho",150128,74161,75967,28275,102732,17039,5911,1511,755,148871,8960,8376,17336,18668,8359,10309,66606,661,7.86,84.9,5.446685495044229,12.434722370244058,8177,99.16271448364063,44.36614089310455,0.49398513268677396
16057,"Latah County, Idaho",38697,19813,18884,24166,21464,5765,2556,618,1029,38531,1299,1609,2908,7980,4168,3812,18389,89,7.79,86.8,10.861307078068068,20.621753624311964,4203,99.57102617773988,47.52047962374344,0.5120035144843269
16059,"Lemhi County, Idaho",7755,3906,3849,22489,5950,934,285,70,38,7680,628,475,1103,1306,615,691,3036,58,3.24,81.4,5.067698259187621,16.840747904577693,393,99.03288201160541,39.148936170212764,0.5036750483558994
16061,"Lewis County, Idaho",3824,1918,1906,23285,2692,329,104,3,4,3780,281,352,633,575,251,324,1474,24,6.32,85.3,2.9027196652719667,15.036610878661088,111,98.84937238493724,38.54602510460251,0.5015690376569037
16063,"Lincoln County, Idaho",5296,2735,2561,19095,3237,222,60,8,4,5248,645,614,1259,601,304,297,2336,72,3.39,93,1.3595166163141994,11.348187311178247,72,99.09365558912387,44.10876132930514,0.5164274924471299
16065,"Madison County, Idaho",38241,19272,18969,15257,16168,4042,1240,352,423,38032,1467,1468,2935,11974,5819,6155,16643,161,2.61,85.4,5.269213671190607,31.311942679323238,2015,99.45346617504772,43.52135142909443,0.5039617164823096
16067,"Minidoka County, Idaho",20448,10304,10144,21887,12715,1272,440,66,24,20371,2214,2148,4362,3623,1626,1997,9125,21,2.81,92.8,2.5919405320813773,17.718114241001565,530,99.62343505477308,44.625391236306726,0.5039123630672926
16069,"Nez Perce County, Idaho",40014,19811,20203,26799,27742,4538,1215,331,202,39392,2063,1919,3982,5579,2700,2879,18402,155,5.99,90,4.368471035137702,13.94262008297096,1748,98.44554405957915,45.988903883640724,0.49510171439996004
16071,"Oneida County, Idaho",4284,2136,2148,21360,2643,300,69,3,28,4253,197,212,409,535,280,255,1672,0,5.23,89.4,2.3342670401493932,12.488328664799253,100,99.27637721755369,39.028944911297856,0.49859943977591037
16073,"Owyhee County, Idaho",11384,5817,5567,19909,7334,555,128,14,13,11256,1594,1345,2939,2622,1357,1265,4580,70,2.4,91.8,1.3615600843288826,23.03232607167955,155,98.8756148981026,40.231904427266336,0.5109803232607167
16075,"Payette County, Idaho",22839,11451,11388,23361,14877,1546,318,185,61,22694,1689,1608,3297,3468,1529,1939,9649,109,3.64,95.6,2.4694601339813476,15.184552738736372,564,99.36512106484523,42.24790927798941,0.5013792197556811
16077,"Power County, Idaho",7667,3951,3716,21513,4663,502,99,129,7,7608,462,648,1110,879,387,492,2924,0,4.57,89.8,3.0650841267770965,11.464718925264119,235,99.23046824051129,38.13747228381375,0.5153254206338855
16079,"Shoshone County, Idaho",12490,6245,6245,23834,9109,803,245,62,19,12327,927,937,1864,2140,960,1180,4872,102,10.68,82.6,2.610088070456365,17.133706965572458,326,98.69495596477182,39.00720576461169,0.5
16081,"Teton County, Idaho",10776,5692,5084,28004,7054,2116,698,93,93,10776,574,560,1134,888,418,470,5521,19,4.83,81.6,8.203414996288048,8.240534521158128,884,100,51.23422420193022,0.5282108389012621
16083,"Twin Falls County, Idaho",82248,40454,41794,22723,52179,6656,2216,728,382,81298,5295,5320,10615,11651,5094,6557,38132,208,2.17,91.1,4.043867328080926,14.165693998638265,3326,98.84495671627273,46.36222157377687,0.491853905262134
16085,"Valley County, Idaho",10104,5148,4956,28515,7748,1705,565,35,79,10026,600,567,1167,1042,608,434,4216,30,9.47,83,6.720110847189232,10.312747426761678,679,99.22802850356294,41.72604908946952,0.5095011876484561
16087,"Washington County, Idaho",9996,4940,5056,20435,7074,784,331,46,0,9863,881,780,1661,1549,702,847,3637,93,4.18,91.4,3.7715086034413767,15.496198479391756,377,98.66946778711484,36.38455382152861,0.49419767907162865
17001,"Adams County, Illinois",66787,32698,34089,27256,46161,6821,3105,574,283,65509,2142,1548,3690,8513,3880,4633,31875,328,6.72,88.6,5.9322922125563355,12.746492580891491,3962,98.08645395061913,47.726353931154264,0.4895862967343944
17003,"Alexander County, Illinois",6776,3258,3518,18564,4625,374,95,23,5,6642,360,225,585,2212,957,1255,2130,27,8.41,89.6,1.8152302243211333,32.64462809917355,123,98.02243211334121,31.4344746162928,0.480814639905549
17005,"Bond County, Illinois",17034,8767,8267,24473,11904,1492,647,54,103,15779,593,398,991,2399,1027,1372,7371,4,7.58,90,4.719971821063755,14.083597510860631,804,92.63238229423506,43.27227897146883,0.5146765292943525
17007,"Boone County, Illinois",53638,26755,26883,29029,34783,4580,2066,673,242,53247,1952,1886,3838,5617,2401,3216,24765,47,8.63,82.2,5.557627055445766,10.47205339498117,2981,99.27103918863493,46.17062530295686,0.49880681606323873
17009,"Brown County, Illinois",6791,4360,2431,21906,5047,489,143,26,6,4809,97,134,231,557,235,322,2400,15,7.33,88.4,2.5769400677367105,8.202032101310557,175,70.8143130614048,35.34089235753203,0.6420262111618318
17011,"Bureau County, Illinois",33619,16506,17113,28332,23618,2971,1050,298,136,33253,1038,790,1828,4175,1701,2474,16042,220,7.06,83.6,4.414170558315238,12.418572830839704,1484,98.91132990273357,47.71706475504923,0.49097236681638357
17013,"Calhoun County, Illinois",4897,2453,2444,25660,3524,278,187,8,11,4818,97,68,165,601,275,326,2137,16,8.75,89.6,4.206657137022667,12.272820093935062,206,98.38676740861752,43.638962630181744,0.5009189299571166
17015,"Carroll County, Illinois",14704,7288,7416,27605,10746,1208,486,108,67,14535,537,463,1000,1634,720,914,6654,41,9.48,83.8,4.49537540805223,11.112622415669206,661,98.8506528835691,45.252992383025024,0.4956474428726877
17017,"Cass County, Illinois",12880,6529,6351,25451,8729,832,275,52,14,12727,581,471,1052,1666,727,939,6058,71,7.68,89,2.6475155279503104,12.934782608695652,341,98.81211180124224,47.03416149068323,0.5069099378881987
17019,"Champaign County, Illinois",207946,103843,104103,28463,119960,26436,16371,3442,6453,205992,6921,5008,11929,41088,19856,21232,101462,747,5.96,86.3,12.631163859848229,19.758975887970916,26266,99.0603329710598,48.79247496946323,0.4993748376982486
17021,"Christian County, Illinois",33562,17040,16522,25614,23940,2650,973,164,132,31656,1034,747,1781,4033,1667,2366,14755,75,7.03,88.5,3.7810619152613074,12.01656635480603,1269,94.32095822656576,43.96341100053632,0.507717060961802
17023,"Clark County, Illinois",15924,7827,8097,28495,11047,1272,466,57,99,15699,477,444,921,2232,873,1359,7442,38,6.89,87.1,3.906053755337855,14.016578749058025,622,98.58703843255464,46.734488821904044,0.4915222305953278
17025,"Clay County, Illinois",13393,6602,6791,25700,9445,1037,279,60,32,13227,500,474,974,1842,758,1084,6299,34,8.2,88.6,2.7701037855596207,13.75345329649817,371,98.76054655417009,47.032031658328975,0.49294407526319717
17027,"Clinton County, Illinois",37640,19549,18091,30382,26627,4136,1477,203,69,35491,850,880,1730,3200,1286,1914,18365,146,8.24,91.2,4.6466524973432515,8.501594048884165,1749,94.29064824654623,48.79117959617428,0.5193676939426143
17029,"Coles County, Illinois",52540,25395,27145,26060,32910,4849,2655,309,756,51845,2407,1747,4154,10212,4650,5562,24342,73,7.11,87.1,7.0803197563760945,19.43661971830986,3720,98.67719832508566,46.33041492196422,0.4833460220784164
17031,"Cook County, Illinois",5238541,2540704,2697837,33722,3578782,796547,379704,102530,52175,5192360,321239,254129,575368,821572,363333,458239,2472281,21331,8.64,83,10.201485489948443,15.683221721467866,534409,99.11843774822036,47.19407560234806,0.48500221722040543
17033,"Crawford County, Illinois",19214,10067,9147,25955,13948,1630,554,109,58,17334,707,566,1273,2056,981,1075,7937,26,6.41,87.2,3.7524721557197878,10.70053086291246,721,90.21546788799833,41.30842094306235,0.5239408764442594
17035,"Cumberland County, Illinois",10899,5453,5446,24956,7630,773,306,33,36,10773,357,285,642,1533,712,821,5005,24,7.51,87.2,3.4406826314340764,14.065510597302504,375,98.84393063583815,45.92164418754014,0.5003211303789339
17037,"DeKalb County, Illinois",104473,51739,52734,26511,61324,11634,5628,510,978,103721,3782,3633,7415,17944,7928,10016,50519,388,8.32,82.2,6.811329242962296,17.175729614350118,7116,99.28019679725863,48.35603457352617,0.4952380040776086
17039,"De Witt County, Illinois",16176,8085,8091,27866,11463,1717,513,65,31,15900,669,282,951,2108,893,1215,8055,56,5.17,86.5,3.7648367952522257,13.031651829871414,609,98.29376854599407,49.795994065281896,0.49981454005934717
17041,"Douglas County, Illinois",19830,9780,10050,26284,13199,1849,498,94,53,19665,1521,1457,2978,2379,1065,1314,9024,158,6.52,86.5,3.252647503782148,11.99697428139183,645,99.1679273827534,45.50680786686838,0.49319213313161875
17043,"DuPage County, Illinois",931826,457327,474499,42050,632912,183959,89435,19196,11317,925989,33731,27883,61614,62247,27077,35170,477749,2462,9.18,83.1,12.87236029044049,6.6801098059079695,119948,99.37359549958897,51.270194220809465,0.49078583340666604
17045,"Edgar County, Illinois",17603,8643,8960,26344,12639,1495,658,62,14,17320,576,622,1198,2655,1201,1454,7809,26,7.05,86.1,4.169743793671533,15.082656365392262,734,98.39231949099586,44.36175651877521,0.49099585297960574
17047,"Edwards County, Illinois",6570,3218,3352,26549,4568,400,140,24,7,6538,267,133,400,746,322,424,3088,18,7.58,89.5,2.6027397260273974,11.354642313546423,171,99.51293759512937,47.00152207001522,0.4898021308980213
17049,"Effingham County, Illinois",34164,17021,17143,29300,23094,3741,1167,228,82,33765,1064,741,1805,3798,1756,2042,17008,141,8.39,87.6,4.323264254771104,11.116965226554267,1477,98.83210396909027,49.783397728603205,0.49821449478983726
17051,"Fayette County, Illinois",21980,11751,10229,21844,15451,1316,461,51,15,20167,1242,803,2045,3564,1715,1849,8702,64,8.43,89.4,2.397634212920837,16.2147406733394,527,91.7515923566879,39.590536851683346,0.5346223839854413
17053,"Ford County, Illinois",13470,6647,6823,26611,9393,1330,426,29,14,13062,538,363,901,2044,914,1130,6084,29,5.15,85,3.48181143281366,15.174461766889383,469,96.97104677060133,45.16703786191537,0.49346696362286563
17055,"Franklin County, Illinois",39302,19302,20000,22346,27627,2724,1200,177,99,38825,1681,1516,3197,7635,3444,4191,15169,174,12.77,88.7,3.755534069513002,19.42649229046868,1476,98.78632130680373,38.59600020355198,0.49112004478143606
17057,"Fulton County, Illinois",35733,18673,17060,24269,25732,3121,1137,186,105,33129,1609,898,2507,5146,2219,2927,14820,90,6.32,87.5,3.9963059356896986,14.401253743038648,1428,92.71261858785996,41.47426748383847,0.5225701732292278
17059,"Gallatin County, Illinois",5226,2475,2751,24538,3751,358,91,3,29,5226,176,95,271,862,390,472,2045,32,8.14,89,2.35361653272101,16.494450822809032,123,100,39.13126674320704,0.473593570608496
17061,"Greene County, Illinois",13311,6682,6629,22836,9378,827,227,48,23,13022,537,496,1033,2306,1058,1248,5723,58,8.86,89.3,2.238749906092705,17.324017729697243,298,97.82886334610473,42.99451581398843,0.5019908346480355
17063,"Grundy County, Illinois",50333,25154,25179,31914,33231,4949,2200,227,127,50055,1259,1255,2514,4669,1879,2790,24139,179,6.19,84.1,5.074205789442314,9.276220372320347,2554,99.44767846144677,47.95859575228975,0.4997516539844635
17065,"Hamilton County, Illinois",8259,4045,4214,25945,5818,592,340,18,33,8179,420,355,775,1134,549,585,3648,17,10.1,88.9,4.734229325584211,13.730475844533236,391,99.03135972878073,44.16999636759898,0.4897687371352464
17067,"Hancock County, Illinois",18264,9083,9181,26118,13130,1809,563,81,140,18086,443,412,855,2029,818,1211,8190,56,5.43,87.5,4.292597459483137,11.10928602715725,784,99.02540516863776,44.842312746386334,0.49731712658782307
17069,"Hardin County, Illinois",4161,2171,1990,20025,3129,280,47,18,2,4080,277,115,392,676,286,390,1274,9,6.03,89.6,1.6101898582071617,16.246094688776736,67,98.0533525594809,30.617639990386927,0.5217495794280221
17071,"Henderson County, Illinois",6927,3404,3523,27949,5114,588,126,8,4,6866,272,224,496,774,323,451,3264,26,5.56,87.1,1.992204417496752,11.173668254655695,138,99.11938790241085,47.11996535296665,0.4914104229825321
17073,"Henry County, Illinois",49649,24610,25039,28443,34567,5307,1803,425,105,48907,1496,1026,2522,6109,2739,3370,22712,153,6.27,84.8,4.698986887953433,12.304376724606739,2333,98.5055086708695,45.745130818344784,0.49567967129247315
17075,"Iroquois County, Illinois",28457,13878,14579,26480,20091,1867,752,162,87,28018,1202,828,2030,4316,1941,2375,13044,194,5.39,84.8,3.5175879396984926,15.16674280493376,1001,98.45732157289946,45.83757950592121,0.48768317110025655
17077,"Jackson County, Illinois",59115,29460,29655,23455,35285,6092,4320,717,1650,58476,2442,1934,4376,15300,7335,7965,24829,156,12.7,89.2,11.311849784318701,25.881755899517888,6687,98.91905607713778,42.00118413262285,0.498350672418168
17079,"Jasper County, Illinois",9608,4776,4832,25806,6700,786,309,48,22,9547,364,255,619,1167,455,712,4471,15,6.67,86.7,3.944629475437136,12.146128226477934,379,99.36511240632807,46.53413821815154,0.4970857618651124
17081,"Jefferson County, Illinois",38358,19691,18667,24617,26760,2578,1198,345,197,35819,1446,1220,2666,6733,2851,3882,15526,94,9.23,89,4.536211481307681,17.553052818186558,1740,93.38078106262057,40.476562907346576,0.5133479326346525
17083,"Jersey County, Illinois",22215,10855,11360,27528,15267,1970,873,78,91,21860,617,712,1329,2009,788,1221,10024,36,9.34,89.5,4.690524420436642,9.043439117713257,1042,98.40198064370921,45.12266486608148,0.4886338059869458
17085,"Jo Daviess County, Illinois",22046,11081,10965,32401,16312,2453,1139,175,66,21888,639,471,1110,1658,689,969,10813,74,9.9,82.6,6.2596389367685745,7.5206386646103605,1380,99.28331670144244,49.04744624875261,0.5026308627415405
17087,"Johnson County, Illinois",12899,7342,5557,20726,9404,1022,401,76,23,10612,312,297,609,1472,632,840,4120,43,8.79,88.5,3.876269478254128,11.411737343980153,500,82.26994340646561,31.940460500814016,0.5691914101868362
17089,"Kane County, Illinois",529402,263392,266010,33486,340594,71465,30788,4721,3213,526131,28792,22863,51655,54558,24099,30459,256940,2037,9.11,82.4,7.3142904635796615,10.305590080883714,38722,99.38213304823178,48.53400629389387,0.4975273988386897
17091,"Kankakee County, Illinois",110801,54425,56376,26150,72871,9028,4382,656,387,108546,4748,2962,7710,16059,7366,8693,48762,850,7.64,84.2,4.896165197065009,14.49355150224276,5425,97.96481981209556,44.008628080974,0.4911959278345863
17093,"Kendall County, Illinois",122933,60801,62132,33369,77030,17324,8245,710,538,122623,3437,2219,5656,6889,2863,4026,62268,461,8.48,83.7,7.722092521942847,5.603865520242734,9493,99.74783011884523,50.651981160469525,0.49458648206746764
17095,"Knox County, Illinois",51374,26079,25295,23676,35756,4094,1695,407,201,48604,2093,1405,3498,8541,4069,4472,21089,145,5.7,85.9,4.482812317514696,16.625141121968312,2303,94.60816755557286,41.049947444232494,0.5076303188383229
17097,"Lake County, Illinois",704476,351847,352629,42388,455774,118151,60185,15091,8226,689014,30183,25363,55546,58251,26476,31775,352294,2932,8.86,81.2,11.853065257013723,8.268699004650266,83502,97.80517718133761,50.00794917073115,0.4994449775435927
17099,"LaSalle County, Illinois",111151,55819,55332,27959,77586,9067,3443,808,478,108005,3773,2939,6712,14617,6081,8536,49752,281,6.27,83.9,4.254572608433572,13.150578942159765,4729,97.16961610781729,44.76073089760776,0.5021907135338414
17101,"Lawrence County, Illinois",16457,9034,7423,21072,11891,1026,308,31,9,14017,640,593,1233,2286,907,1379,6206,52,6.68,88.1,2.1146016892507746,13.89074557938871,348,85.17348240870146,37.710396791638814,0.5489457373761925
17103,"Lee County, Illinois",34670,18375,16295,28179,24995,2727,1372,224,132,31602,1040,878,1918,3699,1701,1998,15087,96,8.65,83,4.984136140755696,10.669166426305162,1728,91.15085087972311,43.51600807614653,0.5299971156619556
17105,"Livingston County, Illinois",36812,18890,17922,27318,25661,2482,966,232,189,34348,1150,960,2110,4565,1918,2647,15800,261,4.86,84.5,3.767793110942084,12.40084754971205,1387,93.30653047919157,42.92078669998914,0.5131478865587309
17107,"Logan County, Illinois",29488,14420,15068,26479,20844,2965,862,150,140,25981,812,465,1277,2327,1066,1261,12381,22,6.1,87.2,3.906673901247965,7.891345632121541,1152,88.10702658708627,41.98657080846446,0.4890124796527401
17109,"McDonough County, Illinois",31597,15563,16034,22527,18357,3133,1943,178,739,31242,1174,798,1972,6212,2888,3324,13443,68,5.85,86.9,9.051492230275025,19.66009431275121,2860,98.87647561477355,42.5451783397158,0.4925467607684274
17111,"McHenry County, Illinois",308043,153503,154540,36208,205777,45497,18318,2843,1714,306816,9560,9148,18708,22339,10506,11833,159078,1023,8.44,81.7,7.425911317575793,7.251909635992377,22875,99.60167898637528,51.641491609937574,0.4983167934346828
17113,"McLean County, Illinois",173231,84327,88904,32943,104486,31061,11421,2054,2154,172081,4498,3149,7647,24110,10786,13324,90064,424,4.86,85.8,9.022057253032079,13.917832258660402,15629,99.33614653266447,51.99069450617961,0.48678931600002306
17115,"Macon County, Illinois",107587,51439,56148,28280,73678,10855,4424,955,521,105020,3509,2550,6059,17246,7307,9939,47235,232,6.13,87.3,5.483933932538318,16.02981772890777,5900,97.61402399918205,43.904003271770755,0.47811538568786194
17117,"Macoupin County, Illinois",45960,22691,23269,27255,32422,4017,1559,316,119,45434,1541,1104,2645,5962,2449,3513,20539,125,8.46,88.4,4.338555265448216,12.972149695387293,1994,98.85552654482159,44.688859878154915,0.4937119234116623
17119,"Madison County, Illinois",266153,129987,136166,30278,184528,30349,13779,2529,1682,263563,8467,5991,14458,35099,15846,19253,123624,565,8.54,89.8,6.759270043922105,13.18752747479833,17990,99.02687551896841,46.44847136797256,0.4883920151191232
17121,"Marion County, Illinois",38305,18781,19524,24112,26532,2633,1159,189,58,37607,1679,1113,2792,6659,2996,3663,16445,53,8.69,89.5,3.6705390941130402,17.38415350476439,1406,98.17778357916721,42.931732149849886,0.4903015272157682
17123,"Marshall County, Illinois",11925,5938,5987,29025,8583,1144,281,50,20,11660,331,171,502,1194,440,754,5426,15,6.56,85.2,2.943396226415094,10.0125786163522,351,97.77777777777777,45.501048218029354,0.4979454926624738
17125,"Mason County, Illinois",13904,6948,6956,25952,10022,1046,405,34,58,13698,428,330,758,1897,860,1037,6081,33,6.98,88.2,3.574510932105869,13.64355581127733,497,98.51841196777906,43.73561565017261,0.49971231300345226
17127,"Massac County, Illinois",14594,7017,7577,23434,10348,937,270,26,23,14363,440,395,835,2635,1119,1516,5488,56,6.1,89.2,2.1858297930656434,18.055365218582978,319,98.41715773605591,37.60449499794436,0.4808140331643141
17129,"Menard County, Illinois",12416,6080,6336,32839,8740,1516,414,137,83,12264,217,180,397,1386,575,811,5990,26,7.08,88.1,5.106314432989691,11.163015463917526,634,98.77577319587628,48.24420103092783,0.4896907216494845
17131,"Mercer County, Illinois",15794,7830,7964,27844,11246,1480,522,79,24,15545,310,208,518,1765,736,1029,7255,55,6,86.1,3.957198936304926,11.17512979612511,625,98.42345194377612,45.93516525262758,0.4957578827402811
17133,"Monroe County, Illinois",33739,16585,17154,37043,23611,4572,2077,300,276,33471,637,421,1058,1781,681,1100,17344,114,9.96,92.2,7.863303595245858,5.278757520969798,2653,99.2056670322179,51.4063843030321,0.49156762203977594
17135,"Montgomery County, Illinois",29173,15199,13974,23172,20954,1858,931,108,124,25244,736,734,1470,3916,1605,2311,10586,28,7.48,88.5,3.986562917766428,13.423370925170534,1163,86.53206732252426,36.286977684845574,0.5209954409899564
17137,"Morgan County, Illinois",34442,17319,17123,26253,23818,3430,1145,294,191,32406,986,754,1740,4611,2128,2483,15478,153,7.79,88.9,4.732593926020557,13.387724290110912,1630,94.08861274025898,44.939318274200104,0.5028453632193253
17139,"Moultrie County, Illinois",14711,7173,7538,26166,9931,1233,464,55,48,14407,1028,930,1958,1740,884,856,6903,142,6.35,87,3.8542587179661476,11.827883896404051,567,97.9335191353409,46.92407042349262,0.4875943171776222
17141,"Ogle County, Illinois",51619,25702,25917,29239,35732,4669,1981,221,152,51134,1606,1451,3057,5657,2453,3204,24332,216,9.62,83.1,4.560336310273349,10.959142951238885,2354,99.06042348747555,47.13768186133013,0.4979174335031674
17143,"Peoria County, Illinois",186145,90211,95934,29683,124320,23520,10462,2406,1154,183888,7221,4869,12090,28747,12174,16573,82599,677,6.68,86.8,7.5328373042520615,15.44333718337855,14022,98.78750436487684,44.37347229310484,0.4846275752773376
17145,"Perry County, Illinois",21467,11832,9635,23929,15244,1381,432,21,79,18847,564,345,909,2766,933,1833,8034,9,10.89,89.3,2.4782223878511203,12.884893091722178,532,87.79522057110914,37.424884706759215,0.5511715656589183
17147,"Piatt County, Illinois",16433,8122,8311,33672,11539,2214,790,133,150,16386,333,333,666,888,398,490,8625,33,5.84,86.6,6.5295442098217,5.403760725369683,1073,99.71399014178786,52.485851639992696,0.49424937625509646
17149,"Pike County, Illinois",15930,7907,8023,23218,11115,1350,373,29,38,15409,632,429,1061,2281,1058,1223,6848,77,7.8,89.3,2.7620841180163214,14.318895166352794,440,96.7294413057125,42.988072818581294,0.4963590709353421
17151,"Pope County, Illinois",4360,2322,2038,22191,3403,307,129,5,5,4178,156,39,195,531,241,290,1267,22,6.21,88.8,3.188073394495413,12.178899082568808,139,95.8256880733945,29.059633027522935,0.5325688073394496
17153,"Pulaski County, Illinois",5691,2760,2931,20195,4063,289,142,5,19,5685,205,136,341,966,379,587,1948,12,7.21,89.7,2.91688631172026,16.974169741697416,166,99.89457037427518,34.229485151994375,0.4849762783342119
17155,"Putnam County, Illinois",5771,2957,2814,33697,4235,410,156,45,20,5763,146,124,270,507,237,270,2896,17,6.03,84.1,3.829492289031364,8.78530583954254,221,99.86137584474095,50.181944203777505,0.512389533876278
17157,"Randolph County, Illinois",32829,18235,14594,24716,23893,2189,689,179,82,28914,860,809,1669,3531,1521,2010,13007,80,11.89,90.7,2.8937829358189404,10.755734259343873,950,88.0745682171251,39.62045752231259,0.5554540193121935
17159,"Richland County, Illinois",15953,7919,8034,25262,11155,1735,528,101,30,15750,474,341,815,2348,1011,1337,7041,46,6.75,88.3,4.130884473139848,14.718234814768381,659,98.72751206669592,44.13589920391149,0.4963956622578825
17161,"Rock Island County, Illinois",146205,72053,74152,27822,100347,14918,6126,1063,691,143569,5865,4356,10221,20597,8807,11790,67410,1104,6.96,85.1,5.38969255497418,14.087753496802435,7880,98.19705208440203,46.10649430594029,0.4928217229232926
17163,"St. Clair County, Illinois",264433,127649,136784,28643,177839,28056,15687,2289,1245,258591,11734,8649,20383,44376,18869,25507,118396,1080,9.43,91.6,7.268759950535674,16.781566597209878,19221,97.79074472550703,44.77353431682128,0.4827271936558599
17165,"Saline County, Illinois",24430,12028,12402,22725,17140,1865,797,75,80,23957,911,784,1695,4920,2275,2645,9455,35,9.67,88.7,3.896848137535817,20.139173147769135,952,98.06385591485878,38.70241506344658,0.49234547687269753
17167,"Sangamon County, Illinois",198134,95103,103031,33277,136402,29200,12268,3647,1484,196077,6071,3825,9896,30348,14073,16275,93968,754,7.18,88.3,8.781430748887116,15.316906739883109,17399,98.9618137220265,47.426489143710825,0.4799933378420665
17169,"Schuyler County, Illinois",7181,3894,3287,23670,5409,650,217,36,64,7103,962,194,1156,1511,1058,453,2883,4,6.78,87.9,4.414426960033421,21.041637654922713,317,98.91380030636401,40.14761175323771,0.542264308592118
17171,"Scott County, Illinois",5109,2503,2606,26918,3605,356,103,30,13,5059,207,106,313,738,339,399,2308,3,7.96,89.3,2.8577020943433156,14.44509688784498,146,99.0213348991975,45.17518105304365,0.4899197494617342
17173,"Shelby County, Illinois",21906,10885,11021,24808,15576,1768,647,55,17,21713,748,480,1228,2630,1268,1362,10223,56,7.14,88,3.2822057883684836,12.005843147995982,719,99.11896284123071,46.66757965854104,0.49689582762713413
17175,"Stark County, Illinois",5551,2739,2812,30009,3919,512,178,35,11,5451,257,126,383,763,279,484,2545,6,6.22,84.9,4.03530895334174,13.745271122320302,224,98.19852278868672,45.8475950279229,0.49342460817870654
17177,"Stephenson County, Illinois",45839,22183,23656,25792,32234,3909,1564,386,173,45092,1548,1058,2606,7254,3255,3999,20872,151,9.82,82.6,4.631427387159405,15.824952551320928,2123,98.37038329806497,45.53327952180458,0.48393289556927505
17179,"Tazewell County, Illinois",134695,66456,68239,32082,93706,17038,5801,910,619,132156,3251,2785,6036,10556,4592,5964,63092,247,6.12,86.9,5.441924347600134,7.836964994988678,7330,98.11500055681354,46.84063996436393,0.4933813430342626
17181,"Union County, Illinois",17267,8712,8555,24646,12359,1751,783,154,64,17116,754,572,1326,2870,1527,1343,7129,52,11.17,89.1,5.797185382521573,16.621300747089826,1001,99.1254995077315,41.28684774425204,0.5045462442809985
17183,"Vermilion County, Illinois",79207,39325,39882,23416,53825,5532,1973,281,85,76608,3492,2144,5636,15043,7002,8041,31623,200,6.6,85.6,2.953021828878761,18.99200828209628,2339,96.71872435517064,39.92450162233136,0.4964838966252983
17185,"Wabash County, Illinois",11568,5684,5884,25105,8038,1055,387,49,16,11491,331,362,693,1498,648,850,5107,33,7,88.7,3.9073305670816043,12.949515905947441,452,99.33437067773167,44.14764868603043,0.49135546334716457
17187,"Warren County, Illinois",17429,8439,8990,24840,11404,1959,566,101,149,17230,505,379,884,2238,884,1354,8090,60,5.52,86.2,4.6818520856044525,12.840667852429858,816,98.85822479775088,46.41689138791669,0.4841930116472546
17189,"Washington County, Illinois",14260,7182,7078,29687,10164,1381,529,81,62,14052,334,303,637,1364,599,765,6994,49,9.65,90,4.712482468443198,9.565217391304348,672,98.5413744740533,49.04628330995792,0.5036465638148667
17191,"Wayne County, Illinois",16569,8209,8360,25046,11631,1129,330,52,20,16528,759,630,1389,2594,1181,1413,7317,40,7.94,90.2,2.4262176353431104,15.65574265194037,402,99.75254994266402,44.16078218359587,0.49544329772466655
17193,"White County, Illinois",14186,6957,7229,26522,10088,1008,450,43,71,13848,447,258,705,1911,781,1130,5896,12,9.02,88.6,3.975750740166361,13.471027773861554,564,97.6173692372762,41.5621034823065,0.4904130833215847
17195,"Whiteside County, Illinois",56823,27990,28833,28188,39619,4647,1940,411,174,55940,1910,1426,3336,6207,2835,3372,26106,257,8.35,84.3,4.443623180754272,10.92339369621456,2525,98.44605177480949,45.94266406208754,0.4925822290269785
17197,"Will County, Illinois",687727,341719,346008,33731,444963,95679,42598,6403,4653,680356,25309,18891,44200,50149,21123,29026,336898,2915,7.38,83.7,7.801642221404714,7.291992316718698,53654,98.92820843154333,48.987170781429256,0.4968817568599168
17199,"Williamson County, Illinois",67477,33646,33831,26023,47536,6288,3218,728,455,65458,2682,1811,4493,9906,4347,5559,28437,146,13.62,88.3,6.522222386887384,14.680557819701528,4401,97.00786934807415,42.14324881070587,0.4986291625294545
17201,"Winnebago County, Illinois",287512,140454,147058,27297,194834,27530,12399,2508,1260,284338,11835,8583,20418,43159,18912,24247,129778,961,7.95,83.3,5.623069645788697,15.01119953254125,16167,98.89604607807674,45.138289880074574,0.4885152619716742
17203,"Woodford County, Illinois",38942,19374,19568,34198,25942,5802,1734,250,276,38365,865,658,1523,2793,1251,1542,18411,75,5.95,86,5.8035026449591705,7.17220481742078,2260,98.51830928046839,47.27800318422269,0.49750911612141135
18001,"Adams County, Indiana",35018,17361,17657,21534,21052,2116,794,177,42,34582,3693,3563,7256,6448,2845,3603,14656,219,8.3,82,2.892797989605346,18.41338740076532,1013,98.75492603803758,41.85276143697527,0.495773602147467
18003,"Allen County, Indiana",367747,179414,188333,26932,237509,42678,16841,3936,1748,364079,20330,19150,39480,53204,23423,29781,173295,902,8.15,82.6,6.125134943317009,14.467555139810793,22525,99.00257513997396,47.12342996679783,0.4878734564795906
18005,"Bartholomew County, Indiana",81024,40688,40336,29955,54857,10155,5811,454,721,80159,4241,3958,8199,9870,4378,5492,39137,483,7.29,85,8.622136650868878,12.181575829383887,6986,98.93241508688783,48.30297195892575,0.502172195892575
18007,"Benton County, Indiana",8685,4349,4336,23652,5841,744,196,29,11,8599,631,387,1018,1271,472,799,3982,25,6.79,83.5,2.717328727691422,14.634427173287277,236,99.0097869890616,45.84916522740357,0.500748416810593
18009,"Blackford County, Indiana",12214,6047,6167,22328,8610,506,355,40,59,12054,646,633,1279,1534,685,849,5160,48,7.59,83.2,3.7170460127722285,12.559358113640085,454,98.69002783690847,42.24660225970198,0.49508760438840677
18011,"Boone County, Indiana",63013,31211,31802,42844,41421,11596,5001,1721,1244,62385,2165,1900,4065,3820,1707,2113,32064,273,7.3,83,12.641835811657911,6.062241124847254,7966,99.00338025486805,50.88473806992208,0.49531049148588385
18013,"Brown County, Indiana",15007,7439,7568,31365,11254,1421,1176,180,88,14875,883,626,1509,1566,721,845,6643,13,7.42,84.8,9.622176317718399,10.435130272539482,1444,99.12041047511161,44.26600919570867,0.49570200573065903
18015,"Carroll County, Indiana",19994,9980,10014,26589,13909,1528,559,109,62,19882,1108,1056,2164,2015,926,1089,9327,67,7.33,83.4,3.6510953285985797,10.078023407022107,730,99.43983194958487,46.648994698409524,0.499149744923477
18017,"Cass County, Indiana",38248,19091,19157,23592,25935,2334,895,95,141,37521,2337,2144,4481,5170,2274,2896,16825,184,7.92,83.2,2.9570173603848566,13.517046642961724,1131,98.099247019452,43.9892281949383,0.49913720978874715
18019,"Clark County, Indiana",114893,55952,58941,26875,79085,10961,3736,657,432,113268,6398,4986,11384,10981,4876,6105,55221,304,7.01,87.7,4.199559590227429,9.557588364826403,4825,98.58564055251408,48.062980338227746,0.4869922449583525
18021,"Clay County, Indiana",26375,12903,13472,24339,18220,2031,756,183,59,25958,1031,924,1955,3584,1521,2063,12050,57,6.17,86.1,3.7838862559241706,13.588625592417062,998,98.41895734597156,45.687203791469194,0.4892132701421801
18023,"Clinton County, Indiana",32455,16044,16411,23722,21277,2297,899,115,26,31850,1795,1837,3632,4187,1793,2394,14729,265,8.53,83.2,3.204436912648282,12.90093976274842,1040,98.13588044985364,45.3828377753813,0.49434601756277924
18025,"Crawford County, Indiana",10598,5355,5243,19424,7473,486,226,52,15,10532,402,444,846,1851,803,1048,4195,44,7.65,86.9,2.764672579732025,17.46555953953576,293,99.37724098886582,39.58294017739196,0.5052840158520475
18027,"Daviess County, Indiana",32777,16600,16177,21794,20237,1875,837,103,51,32308,3722,3571,7293,4184,2070,2114,14009,231,6.66,87.5,3.0234615736644597,12.765048662171644,991,98.56911858925466,42.740336211367726,0.5064526954876896
18029,"Dearborn County, Indiana",49564,24774,24790,30228,33999,4855,2007,387,130,49016,1925,1637,3562,4925,2346,2579,24429,214,7.39,85,5.09240577838754,9.936647566782343,2524,98.89435880881285,49.28778952465499,0.499838592526834
18031,"Decatur County, Indiana",26480,13112,13368,25548,17757,2281,928,217,75,26154,1284,1261,2545,2957,1235,1722,12834,80,7.31,83.3,4.6072507552870094,11.16691842900302,1220,98.76888217522658,48.46676737160121,0.49516616314199396
18033,"DeKalb County, Indiana",42524,21161,21363,26057,28431,3503,1275,202,87,42171,2324,2086,4410,5262,2338,2924,20730,123,7.98,82.5,3.677923055215878,12.374188693443703,1564,99.1698805380491,48.748941774057,0.49762487066127364
18035,"Delaware County, Indiana",115938,55903,60035,23271,71195,9852,5111,835,1250,114544,6390,4932,11322,23018,10021,12997,51668,485,7.47,83.8,6.206765685107557,19.85371491659335,7196,98.79763321775431,44.56519864065276,0.4821801307595439
18037,"Dubois County, Indiana",42379,21223,21156,28302,28458,4394,1346,260,91,41577,1472,1220,2692,4150,1862,2288,21820,41,9.13,87.3,4.004341773047972,9.792585950588736,1697,98.10755326930791,51.48776516670993,0.5007904858538427
18039,"Elkhart County, Indiana",202924,100359,102565,23817,128152,15620,6368,1385,600,200465,16960,16855,33815,27452,11733,15719,92386,569,5.98,82.8,4.116319410222546,13.528217460724212,8353,98.78821627801541,45.52738956456604,0.494564467485364
18041,"Fayette County, Indiana",23426,11562,11864,22428,16358,1228,462,89,33,23090,1409,1462,2871,4188,1637,2551,9564,79,8.83,83.5,2.492956544010928,17.877571928626313,584,98.56569623495261,40.82643216938445,0.49355417057969775
18043,"Floyd County, Indiana",76481,37092,39389,30663,52041,9263,4232,850,415,75442,2636,2463,5099,8104,3454,4650,37203,128,6.47,87.5,7.187406022410795,10.596095762346204,5497,98.64149265830729,48.643453929734186,0.484983198441443
18045,"Fountain County, Indiana",16620,8272,8348,25383,11545,1074,473,89,21,16430,957,523,1480,2047,942,1105,7157,44,6.6,84.4,3.507821901323706,12.316486161251504,583,98.85679903730446,43.06257521058965,0.4977135980746089
18047,"Franklin County, Indiana",22835,11415,11420,26267,15509,2001,829,68,154,22750,899,660,1559,2248,924,1324,10849,71,7.88,84.1,4.602583753010729,9.844536895117145,1051,99.62776439675936,47.51040070067878,0.49989051894022335
18049,"Fulton County, Indiana",20296,9992,10304,23557,14015,1166,575,28,28,20081,1149,1188,2337,2655,1211,1444,9324,99,7.01,82.9,3.1089869925108395,13.081395348837209,631,98.94067796610169,45.9400867165944,0.492313756405203
18051,"Gibson County, Indiana",33596,16841,16755,27342,22827,2568,1016,121,124,33011,1547,1170,2717,3497,1595,1902,15984,141,7.88,88.5,3.75342302655078,10.408977259197524,1261,98.25872127634243,47.57709251101321,0.501279914275509
18053,"Grant County, Indiana",67615,32360,35255,21024,44546,4637,2282,330,366,66755,3568,3213,6781,11878,5027,6851,28823,196,8.43,83.3,4.404348147600385,17.56710789026104,2978,98.72809287879909,42.628115063225614,0.47859202839606596
18055,"Greene County, Indiana",32431,16040,16391,24744,22716,2102,957,197,38,32132,1817,1356,3173,4114,1633,2481,14099,80,6.94,86.5,3.6754956677253245,12.685393604884215,1192,99.07804261354876,43.473836761123614,0.49458851099256884
18057,"Hamilton County, Indiana",309687,151395,158292,44443,199803,73578,28561,7898,4837,308195,9241,8303,17544,15322,6407,8915,161902,680,8.52,83.2,13.334754122710995,4.947576101031041,41296,99.5182232383019,52.279236777778856,0.4888645632525744
18059,"Hancock County, Indiana",72776,35716,37060,31428,49508,10029,3942,653,284,72176,2560,2698,5258,5037,1956,3081,36792,141,8.73,83.5,6.704133230735407,6.921237770693636,4879,99.17555237990547,50.555128064196985,0.4907661866549412
18061,"Harrison County, Indiana",39450,19790,19660,25993,27639,2893,1520,127,42,39182,1725,1331,3056,5005,2265,2740,17436,109,7.1,87.4,4.281368821292776,12.686945500633714,1689,99.32065906210393,44.19771863117871,0.5016476552598226
18063,"Hendricks County, Indiana",158170,78924,79246,33031,104392,24513,9660,1530,1130,155413,5645,5107,10752,7832,3037,4795,80694,662,7.32,83.4,7.789087690459632,4.95163431750648,12320,98.25693873680217,51.017259910223174,0.4989821078586331
18065,"Henry County, Indiana",48649,25252,23397,23293,34455,3791,1474,259,170,45400,2405,2104,4509,7253,3315,3938,19777,133,8.46,83,3.9116939710990977,14.90883676951222,1903,93.32154823326276,40.65242862134885,0.5190651400850994
18067,"Howard County, Indiana",82457,39889,42568,26294,56980,7467,3283,668,180,81532,4011,3637,7648,13400,6094,7306,36073,336,8.05,83.2,5.009883939507865,16.250894405568964,4131,98.87820318469021,43.747650290454416,0.48375516936100027
18069,"Huntington County, Indiana",36520,17917,18603,24222,24887,2771,1406,144,192,36082,1805,1574,3379,4057,1714,2343,17953,53,8.85,82.4,4.76998904709748,11.108981380065718,1742,98.800657174151155,49.15936473165389,0.4906078860898138
18071,"Jackson County, Indiana",43779,21861,21918,23260,29579,3112,1299,172,110,43125,2361,2084,4445,6650,2754,3896,19900,390,7.11,85.6,3.6113204961282808,15.189931245574362,1581,98.50613307750291,45.45558372735787,0.4993490029466182
18073,"Jasper County, Indiana",33448,16568,16880,24953,22258,2132,932,179,72,33093,1244,1403,2647,2898,1273,1625,14889,112,6.2,83.4,3.536833293470462,8.664195168619948,1183,98.93865104042095,44.513872279359006,0.49533604400861037
18075,"Jay County, Indiana",21107,10360,10747,20193,13871,916,442,41,51,20901,1338,1063,2401,3705,1637,2068,9217,145,8.05,82.9,2.5299663618704695,17.553418297247358,534,99.0240204671436,43.667977448239924,0.4908324252617615
18077,"Jefferson County, Indiana",32293,15417,16876,25429,22097,2324,1225,115,187,30590,1392,1387,2779,4055,1643,2412,14232,183,8.97,85.7,4.728578948998235,12.556900876350912,1527,94.72641129656581,44.07147059734308,0.47740996500789645
18079,"Jennings County, Indiana",27840,13983,13857,22901,18680,1375,587,16,21,27599,1443,1551,2994,3815,1856,1959,12863,159,7.72,85,2.2413793103448274,13.70330459770115,624,99.13433908045977,46.20330459770115,0.5022629310344827
18081,"Johnson County, Indiana",149359,73340,76019,31101,98960,20575,7799,1334,843,147386,6143,5588,11731,13820,6239,7581,73684,449,7.3,84.2,6.6792091537838365,9.252873948004472,9976,98.67902168600486,49.33348509296393,0.49103167535936904
18083,"Knox County, Indiana",37763,19265,18498,23441,24759,2532,1101,148,194,36959,1882,1783,3665,5512,2715,2797,17797,190,6.8,88.2,3.8212006461351056,14.596297963615179,1443,97.87093186452347,47.12814130233297,0.5101554431586474
18085,"Kosciusko County, Indiana",78720,39206,39514,27884,52041,7526,3248,494,314,78008,4640,4549,9189,8600,3544,5056,37459,247,7.17,82.7,5.152439024390244,10.924796747967479,4056,99.09552845528455,47.58511178861789,0.4980436991869919
18087,"LaGrange County, Indiana",38720,19659,19061,22780,22347,1556,590,29,36,38548,7625,7660,15285,3489,1520,1969,16225,341,6.38,82.7,1.6916322314049588,9.010847107438016,655,99.55578512396694,41.90340909090909,0.5077221074380165
18089,"Lake County, Indiana",488694,236337,252357,26590,326499,47030,17903,3469,1567,485186,26060,23391,49451,80849,35033,45816,210968,2733,7.23,83.3,4.6939393567344805,16.54389045087519,22939,99.2821683916725,43.16975448849382,0.48360937519183783
18091,"LaPorte County, Indiana",110839,57212,53627,25004,77203,8931,3592,803,432,102536,4882,5012,9894,16924,7206,9718,46403,362,6.68,82.4,4.354965310044299,15.268993765732278,4827,92.50895442939759,41.86522794323298,0.5161721054863361
18093,"Lawrence County, Indiana",45669,22621,23048,25036,32030,3195,1576,186,191,45029,2039,2247,4286,5150,2230,2920,20346,112,7.28,85.8,4.2764238323589305,11.2767960761129,1953,98.59861174976461,44.55100834263943,0.4953250563839804
18095,"Madison County, Indiana",129641,64805,64836,23680,89800,10584,4026,648,501,124831,7060,5848,12908,21454,9650,11804,54986,628,8.11,83.4,3.991792719895712,16.548777007273934,5175,96.28975401300515,42.41405111037403,0.49988043905863117
18097,"Marion County, Indiana",939964,452538,487426,26284,615756,118164,45341,12789,6730,929787,64660,52126,116786,182317,81417,100900,444556,3852,8.15,83.8,6.900264265439953,19.396168363894787,64860,98.91729896038572,47.29500278734079,0.48144184245354077
18099,"Marshall County, Indiana",46752,23252,23500,24289,30831,3823,1795,364,112,46257,3076,3041,6117,5302,2269,3033,20897,174,6.73,82.7,4.857546201232033,11.34069130732375,2271,98.94122176591375,44.697553045859,0.4973477070499658
18101,"Martin County, Indiana",10219,5146,5073,25138,7106,457,241,33,51,10015,482,434,916,1330,519,811,4830,61,9.06,86.9,3.180350327820726,13.014972110774048,325,98.00371856346023,47.26489871807418,0.5035717780604756
18103,"Miami County, Indiana",36035,19016,17019,22890,24872,1944,989,114,90,33829,2015,1300,3315,5363,2548,2815,14998,168,6.96,83.2,3.3106701817677258,14.882752879145276,1193,93.87817399750243,41.62064659358956,0.5277091716386846
18105,"Monroe County, Indiana",144436,72005,72431,26738,81878,19422,11985,2113,3978,143445,6387,5610,11997,31974,15442,16532,69908,298,7.46,85.1,12.514885485613005,22.1371403251267,18076,99.31388296546568,48.400675731812015,0.49852529840206045
18107,"Montgomery County, Indiana",38288,19432,18856,25519,25785,3270,996,238,169,37742,2253,1723,3976,3734,1511,2223,18133,54,7.23,83.8,3.6643334726285,9.752402841621397,1403,98.57396573338904,47.35948600083577,0.5075219389887171
18109,"Morgan County, Indiana",69533,34307,35226,27402,47577,5093,2099,322,127,68698,3050,3016,6066,8073,3110,4963,32794,210,7.69,84.2,3.6644470970618266,11.610314526915278,2548,98.79913134770541,47.16321746508852,0.4933916269972531
18111,"Newton County, Indiana",14056,7041,7015,24315,9859,744,272,45,20,13840,874,871,1745,1932,735,1197,6193,216,6.39,83.9,2.3975526465566306,13.745019920318725,337,98.46328969834946,44.05947638019351,0.5009248719408081
18113,"Noble County, Indiana",47421,23797,23624,25260,31331,3051,1020,175,127,46634,2202,2109,4311,4295,1883,2412,22301,145,7.48,82.3,2.787794437063748,9.057168764893191,1322,98.34039771409292,47.0276881550368,0.5018240863752346
18115,"Ohio County, Indiana",5911,2967,2944,27715,4388,384,197,20,20,5860,198,196,394,288,112,176,2970,20,7.81,85.6,4.009473862290645,4.872272035188631,237,99.13720182710202,50.24530536288276,0.5019455252918288
18117,"Orange County, Indiana",19623,9687,9936,22715,13461,960,543,46,41,19371,971,853,1824,2892,1246,1646,8337,101,9.35,86.6,3.210518269377771,14.737807674667483,630,98.7157926922489,42.485858431432504,0.4936554043724201
18119,"Owen County, Indiana",20957,10629,10328,24220,14921,1024,671,158,38,20801,1540,1096,2636,3230,1360,1870,9338,104,6.95,85.8,4.137042515627237,15.41251133272892,867,99.25561864770721,44.55790428019277,0.5071813713794914
18121,"Parke County, Indiana",17062,8178,8884,21636,12051,1056,396,30,35,15620,1126,1019,2145,2153,940,1213,6546,114,6.45,85.2,2.7019106787012075,12.618684796624077,461,91.54847028484352,38.36595944203493,0.4793107490329387
18123,"Perry County, Indiana",19229,10336,8893,23003,13635,1002,741,153,54,17575,656,654,1310,2529,1035,1494,8069,30,6.62,86.8,4.930053564927974,13.152009984918612,948,91.39840865359614,41.96266056477196,0.5375214519735816
18125,"Pike County, Indiana",12471,6256,6215,25648,8795,739,364,40,9,12250,338,388,726,1300,572,728,5870,32,5.85,88,3.3116831048031434,10.424184107128537,413,98.22788870178815,47.06920054526501,0.5016438136476625
18127,"Porter County, Indiana",167391,82696,84695,31879,113686,19582,8377,1823,1458,165816,6845,5845,12690,17954,7610,10344,77915,502,6.73,82.6,6.964532143305195,10.725785735194844,11658,99.059089198344,46.54670800700157,0.4940289501825068
18129,"Posey County, Indiana",25599,12776,12823,30763,17829,2388,955,232,114,25357,648,656,1304,2398,1085,1313,12266,74,8.57,88.8,5.08222977460057,9.36755342005547,1301,99.05465057228798,47.91593421618032,0.49908199539044495
18131,"Pulaski County, Indiana",12761,6458,6303,24445,8884,727,250,56,12,12636,723,559,1282,1663,678,985,5587,73,7.05,83.2,2.491967714128987,13.031894052190268,318,99.02045294255936,43.781835279366824,0.506073191756132
18133,"Putnam County, Indiana",37543,19747,17796,23842,24756,2210,1055,190,366,34443,1741,1436,3177,3696,1480,2216,16018,90,6.74,84.3,4.291079562102123,9.844711397597422,1611,91.74280158751299,42.66574328103774,0.5259835388754228
18135,"Randolph County, Indiana",25203,12278,12925,23427,17404,1368,839,81,92,24840,1713,1336,3049,4209,1780,2429,11201,92,7.68,83.2,4.015394992659604,16.700392810379718,1012,98.5596952743721,44.44312185057334,0.48716422648097446
18137,"Ripley County, Indiana",28372,14065,14307,25385,19184,2350,908,168,75,27900,1180,949,2129,2916,1317,1599,13518,162,7.82,83.9,4.056816579726491,10.277738615536444,1151,98.33638798815734,47.645566051036234,0.49573523191879315
18139,"Rush County, Indiana",16765,8223,8542,23749,11539,1122,494,66,28,16580,1152,988,2140,3027,1274,1753,7291,13,8.98,83.4,3.5073068893528183,18.05547271100507,588,98.89651058753356,43.48941246644796,0.4904861318222487
18141,"St. Joseph County, Indiana",268613,130472,138141,25893,174455,30387,13068,3033,3136,266134,14283,12456,26739,44003,19251,24752,123373,494,6.62,82.3,7.1616042410456675,16.38156008830548,19237,99.07711093655185,45.92964599628462,0.4857248159992257
18143,"Scott County, Indiana",23722,11628,12094,24186,16245,1279,642,92,87,23334,1135,1044,2179,3198,1356,1842,10252,132,8.1,86.4,3.460922350560661,13.481156732147374,821,98.36438748840739,43.21726667228733,0.4901778939381165
18145,"Shelby County, Indiana",44339,21933,22406,27317,30587,3670,1441,260,122,43651,2351,2009,4360,4623,1854,2769,21747,203,7.2,84.3,4.111504544531902,10.426486840027966,1823,98.44831863596383,49.04711427862604,0.49466609531112565
18147,"Spencer County, Indiana",20610,10431,10179,29114,14377,1479,607,101,94,20394,738,578,1316,1964,726,1238,9636,94,5.92,87.8,3.891314895681708,9.52935468219311,802,98.95196506550218,46.754002911208154,0.506113537117904
18149,"Starke County, Indiana",22966,11295,11671,22153,15788,1193,446,65,88,22955,980,876,1856,3818,1626,2192,9576,72,7.08,83,2.608203431159105,16.62457545937473,599,99.95210310894366,41.69642079595924,0.49181398589218844
18151,"Steuben County, Indiana",34459,17441,17018,26902,23551,3003,1405,192,182,34207,1614,1609,3223,3325,1376,1949,16849,134,7.42,82.3,5.162657070721727,9.649148263153313,1779,99.2686961316347,48.895789198757946,0.5061377288952088
18153,"Sullivan County, Indiana",20900,11235,9665,22239,14952,1271,525,54,16,18838,1207,1090,2297,2934,1080,1854,8009,10,6.28,87.3,2.84688995215311,14.038277511961722,595,90.13397129186603,38.32057416267943,0.5375598086124402
18155,"Switzerland County, Indiana",10617,5497,5120,21511,7159,451,141,8,23,10514,771,623,1394,2065,1012,1053,4310,47,8.59,85.9,1.6200433267401337,19.44993877743242,172,99.02985777526608,40.59527173401149,0.5177545445982857
18157,"Tippecanoe County, Indiana",186081,94992,91089,25481,102561,21124,10701,1671,4329,184375,10083,8341,18424,35575,18217,17358,88516,607,8.3,83.4,8.975123736437357,19.11801849732106,16701,99.08319495273564,47.56853198338358,0.510487368404082
18159,"Tipton County, Indiana",15290,7632,7658,28507,10848,1515,760,21,12,15107,594,648,1242,1414,562,852,7342,74,8.59,83.3,5.1863963374754745,9.247874427730542,793,98.80313930673643,48.01831262262917,0.49914977109221714
18161,"Union County, Indiana",7225,3658,3567,22527,4973,582,215,36,41,7168,527,440,967,583,249,334,3378,33,8.4,83.8,4.041522491349481,8.069204152249135,292,99.21107266435986,46.75432525951557,0.5062975778546713
18163,"Vanderburgh County, Indiana",181831,87869,93962,26917,123257,20697,8747,1773,1054,179469,9024,7832,16856,31506,13572,17934,85329,740,7.66,89,6.36525124978689,17.327078440969913,11574,98.7009915800936,46.92764160126711,0.4832454311971006
18165,"Vermillion County, Indiana",15644,7716,7928,23891,10949,985,371,38,28,15437,747,659,1406,2066,910,1156,6342,20,6.11,85.6,2.7934032216824343,13.20634108923549,437,98.67680900025569,40.53950396318077,0.49322423932498083
18167,"Vigo County, Indiana",107723,54651,53072,22932,69061,10051,4470,790,946,103558,5638,4680,10318,19632,8871,10761,46529,307,6.4,86.5,5.761072380085961,18.224520297429518,6206,96.13360192345182,43.19318994086685,0.5073289826685109
18169,"Wabash County, Indiana",31848,15568,16280,24700,21810,2388,1361,171,162,30840,1564,1298,2862,3993,1651,2342,14707,44,8.17,83,5.31901532278322,12.537678975131877,1694,96.83496608892239,46.17872393870887,0.48882190404421
18171,"Warren County, Indiana",8269,4124,4145,29312,5870,767,253,63,54,8182,231,218,449,762,291,471,3882,16,7,84.2,4.4745434756318785,9.215140887652678,370,98.94787761518926,46.946426411899864,0.49873019712178013
18173,"Warrick County, Indiana",61581,30490,31091,33528,41987,7662,3208,937,465,60870,2120,1695,3815,4656,1787,2869,30485,253,6.54,88.6,7.486075250483103,7.560773615238467,4610,98.84542310128124,49.50390542537471,0.4951202481284812
18175,"Washington County, Indiana",27807,13783,14024,23223,19059,1425,743,89,46,27533,1851,1397,3248,3644,1623,2021,11731,96,6.29,86.2,3.1574783327939007,13.104613946128673,878,99.01463660229439,42.18721904556406,0.49566655878016325
18177,"Wayne County, Indiana",66972,32387,34585,23895,45907,4901,2575,463,398,65748,4437,4106,8543,11727,4942,6785,28621,424,8.59,83.2,5.130502299468435,17.510302813115928,3436,98.17237054291346,42.73577017260945,0.48359015708057096
18179,"Wells County, Indiana",27832,13689,14143,25850,18701,2368,879,147,81,27221,1084,1178,2262,3011,1253,1758,13608,44,8.08,82,3.9774360448404713,10.818482322506467,1107,97.80468525438344,48.89336016096579,0.4918439206668583
18181,"White County, Indiana",24279,12185,12094,26275,16729,1781,885,100,18,23989,1196,1013,2209,2342,950,1392,11225,144,6.31,83.2,4.131142139297335,9.646196301330368,1003,98.80555212323407,46.23337040240537,0.5018740475307879
18183,"Whitley County, Indiana",33481,16716,16765,28073,23080,2880,1301,213,98,33097,1406,1103,2509,3117,1306,1811,16230,92,7.84,81.9,4.814671007437054,9.309757773065321,1612,98.8530808518264,48.47525462202443,0.49926824168931633
19001,"Adair County, Iowa",7192,3552,3640,28861,5167,598,130,60,21,7051,281,168,449,661,244,417,3619,9,6.52,87.2,2.9338153503893216,9.190767519466073,211,98.03948832035596,50.31979977753059,0.4938820912124583
19003,"Adams County, Iowa",3785,1870,1915,27022,2739,357,94,15,9,3716,104,112,216,418,174,244,1776,2,6.92,87,3.117569352708058,11.043593130779392,118,98.1770145310436,46.9220607661823,0.4940554821664465
19005,"Allamakee County, Iowa",13940,7098,6842,27377,9760,1208,359,104,41,13625,615,556,1171,1550,635,915,6773,121,6.03,82.1,3.6154949784791968,11.119081779053085,504,97.7403156384505,48.58680057388809,0.5091822094691535
19007,"Appanoose County, Iowa",12547,6206,6341,25543,8948,1156,316,128,28,12431,580,462,1042,2108,1059,1049,5413,20,5.05,88.6,3.7618554236072366,16.80082888339842,472,99.07547620945246,43.14178688132621,0.4946202279429346
19009,"Audubon County, Iowa",5711,2814,2897,31523,4147,414,116,19,19,5566,235,134,369,614,193,421,2853,11,8.5,86.1,2.6965505165470147,10.751181929609526,154,97.46104009805639,49.956224829276834,0.4927333216599545
19011,"Benton County, Iowa",25646,12786,12860,32356,17550,2764,902,161,35,25398,455,431,886,2182,961,1221,13007,96,4.87,84.2,4.28136941433362,8.508149419012712,1098,99.03298760040552,50.717460812602354,0.49855727988770177
19013,"Black Hawk County, Iowa",132960,65251,67709,27669,83456,15068,5517,1163,1221,131715,4563,3453,8016,20292,9163,11129,67617,454,5.81,83.4,5.942388688327316,15.26173285198556,7901,99.06362815884476,50.85514440433213,0.4907566185318893
19015,"Boone County, Iowa",26381,13280,13101,30190,18304,3124,868,228,218,25813,637,451,1088,2426,1012,1414,13495,33,6.04,86.9,4.980857435275388,9.19601228156628,1314,97.84693529434062,51.154239793790985,0.503392593154164
19017,"Bremer County, Iowa",24741,12195,12546,32105,16263,3321,1029,164,208,24407,513,325,838,1781,768,1013,12780,26,6.57,82.8,5.662665211592094,7.19857726041793,1401,98.65001414655835,51.65514732630047,0.4929065114587123
19019,"Buchanan County, Iowa",21101,10497,10604,30974,13993,2019,469,136,32,20844,871,675,1546,1621,685,936,10251,206,5.75,82.6,3.018814274205014,7.682100374389839,637,98.78204824415904,48.58063598881569,0.497464575138619
19021,"Buena Vista County, Iowa",20369,10254,10115,26345,12786,1838,451,144,138,20099,1269,859,2128,2654,1203,1451,10390,38,5.43,86.3,3.598605724385095,13.029603809710835,733,98.67445628160439,51.00888605233443,0.5034120477195738
19023,"Butler County, Iowa",14822,7402,7420,28584,10437,1286,355,85,38,14554,302,356,658,1369,623,746,7281,17,5.77,83.2,3.2249359060855487,9.236270408851707,478,98.19187693968425,49.12292538119012,0.4993927944946701
19025,"Calhoun County, Iowa",9814,5080,4734,27370,6990,885,297,102,45,9051,151,177,328,1381,590,791,4257,46,5.11,86.3,4.5241491746484614,14.071734257183616,444,92.22539229671898,43.37680864071734,0.51762787854086
19027,"Carroll County, Iowa",20428,10052,10376,29191,13863,2361,455,144,158,20072,276,226,502,2053,854,1199,10501,35,6.14,86.8,3.705698061484237,10.049931466614451,757,98.25729391031916,51.40493440375955,0.49206970824358726
19029,"Cass County, Iowa",13327,6586,6741,26427,9405,1343,321,134,49,13069,363,228,591,1970,911,1059,6358,14,6.73,87,3.781796353267802,14.782021460193592,504,98.06408043820815,47.70766113904104,0.4941847377504315
19031,"Cedar County, Iowa",18368,9148,9220,30362,12942,2220,514,81,81,18134,318,232,550,984,337,647,9671,99,5.98,84.9,3.6803135888501743,5.357142857142857,676,98.72604529616724,52.65135017421603,0.4980400696864111
19033,"Cerro Gordo County, Iowa",43134,21011,22123,31292,30737,4887,1384,384,156,42521,1374,1204,2578,4773,1860,2913,21635,201,5.6,83,4.460518384569017,11.065516761719293,1924,98.57884731302453,50.15764825891408,0.4871099364770251
19035,"Cherokee County, Iowa",11577,5804,5773,30973,8317,1199,301,83,36,11215,442,299,741,1307,559,748,5855,24,5.8,87.1,3.6278828712101583,11.28962598255161,420,96.87311047767125,50.574414787941606,0.5013388615358038
19037,"Chickasaw County, Iowa",12140,6053,6087,27973,8351,964,257,57,20,12004,318,287,605,1070,475,595,6189,9,7.54,82,2.7512355848434926,8.813838550247118,334,98.87973640856673,50.98023064250412,0.4985996705107084
19039,"Clarke County, Iowa",9267,4600,4667,25879,6364,822,231,40,0,9126,241,304,545,1394,679,715,4576,48,6.07,89.3,2.924355239020179,15.04262436603,271,98.47847199741017,49.37951872234812,0.4963850221215064
19041,"Clay County, Iowa",16387,8091,8296,28514,11457,1921,394,133,35,16136,430,273,703,1879,703,1176,8121,86,7.73,86,3.42954781229023,11.466406297674986,562,98.46829804113017,49.55757612741807,0.493745041801428
19043,"Clayton County, Iowa",17711,8916,8795,27719,12608,1471,354,116,41,17483,654,621,1275,1806,782,1024,8877,85,8.86,82,2.885212579752696,10.197052679125967,511,98.71266444582463,50.12139348427531,0.5034159561854215
19045,"Clinton County, Iowa",47587,23289,24298,28091,32898,4346,1539,236,190,47116,1217,964,2181,6094,2611,3483,22263,198,7.38,83.9,4.12927900477021,12.806018450417131,1965,99.01023388740623,46.783785487633175,0.48939836509971213
19047,"Crawford County, Iowa",17131,8878,8253,27270,11143,1117,217,93,24,16939,982,709,1691,3136,1548,1588,7993,275,8.27,87.3,1.9496818632887747,18.30599497986107,334,98.87922479715137,46.658105189422685,0.5182417839005312
19049,"Dallas County, Iowa",80864,39934,40930,42417,52638,18159,5442,1585,643,80343,1636,1108,2744,4345,1827,2518,43887,165,5.59,87.9,9.485061337554413,5.373219232291254,7670,99.35570834982192,54.272605856747134,0.49384151167392165
19051,"Davis County, Iowa",8834,4360,4474,25747,5580,666,263,41,22,8723,1049,1140,2189,1196,483,713,3896,190,5.08,88.4,3.690287525469776,13.53860086031243,326,98.74349105727869,44.10233189947928,0.49354765678062035
19053,"Decatur County, Iowa",8105,4074,4031,21110,4908,638,339,24,55,7996,404,567,971,1403,667,736,3672,35,6.47,88.8,5.157310302282542,17.31030228254164,418,98.65515114127082,45.305367057371996,0.502652683528686
19055,"Delaware County, Iowa",17326,8659,8667,30768,11803,1354,495,66,85,17160,407,278,685,1570,818,752,9160,29,6.66,82,3.7285005194505367,9.061526030243565,646,99.04190234329909,52.86852129747201,0.4997691330947709
19057,"Des Moines County, Iowa",39876,19534,20342,27168,27689,3884,1224,204,173,39381,1653,1080,2733,5985,2410,3575,18947,345,5.61,87.1,4.014946333634266,15.009027986758953,1601,98.75865182064399,47.51479586718828,0.48986859263717525
19059,"Dickinson County, Iowa",17000,8547,8453,36588,12620,2572,740,313,94,16817,456,327,783,1356,506,850,9094,123,8.97,84.5,6.747058823529412,7.976470588235294,1147,98.9235294117647,53.49411764705882,0.5027647058823529
19061,"Dubuque County, Iowa",96571,47757,48814,30117,64135,12576,4835,1098,746,95282,2247,1869,4116,11051,4760,6291,50104,244,8.56,82,6.916154953350385,11.443393979559081,6679,98.66523076285841,51.8830704869992,0.4945273425769641
19063,"Emmet County, Iowa",9661,4792,4869,29396,6512,967,314,25,34,9396,454,351,805,1212,425,787,4796,34,6.9,84.6,3.860883966463099,12.54528516716696,373,97.25701273160128,49.64289411034054,0.49601490528930753
19065,"Fayette County, Iowa",20139,10162,9977,27020,13887,1897,607,147,103,19797,645,510,1155,2472,1130,1342,9846,120,8.61,82.1,4.255424797656289,12.274690898257113,857,98.30180247281395,48.89021301951438,0.5045930781071553
19067,"Floyd County, Iowa",15904,7830,8074,28323,11046,1787,366,76,84,15687,544,586,1130,2438,924,1514,7953,48,5.97,82.7,3.307344064386318,15.329476861167002,526,98.6355633802817,50.006287726358146,0.49232897384305835
19069,"Franklin County, Iowa",10326,5235,5091,25248,7203,825,225,84,27,10178,329,243,572,1586,742,844,4739,27,5.79,83.5,3.2539221382916907,15.359287236103041,336,98.56672477241914,45.89386015882239,0.5069726902963393
19071,"Fremont County, Iowa",6985,3453,3532,29813,4971,682,283,33,38,6865,256,161,417,748,340,408,3306,50,6.56,87.7,5.068002863278454,10.708661417322835,354,98.28203292770222,47.329992841803865,0.4943450250536865
19073,"Greene County, Iowa",9046,4409,4637,27968,6363,926,298,85,0,8932,220,255,475,892,299,593,4428,24,5.67,87.3,4.2339155427813395,9.860711916869334,383,98.73977448596065,48.94981207163387,0.48739774485960646
19075,"Grundy County, Iowa",12354,6117,6237,35662,8600,1712,446,88,15,12198,205,158,363,697,277,420,6186,18,6.36,84,4.4439048081593,5.641897361178565,549,98.73725109276347,50.072850898494416,0.4951432734337057
19077,"Guthrie County, Iowa",10664,5321,5343,30646,7521,1125,311,98,52,10542,316,210,526,1063,483,580,5262,47,7.58,87,4.322955738934733,9.968117029257314,461,98.85596399099775,49.34358589647412,0.49896849212303074
19079,"Hamilton County, Iowa",15201,7433,7768,27963,10642,1784,523,126,63,15004,435,457,892,1402,494,908,7627,9,5.57,85,4.68390237484376,9.223077429116506,712,98.70403262943228,50.17433063614236,0.48898098809288865
19081,"Hancock County, Iowa",10971,5519,5452,29147,7778,1183,342,71,11,10814,323,224,547,976,413,563,5617,26,4.67,83.4,3.864734299516908,8.896180840397411,424,98.56895451645246,51.19861452921338,0.5030535046941937
19083,"Hardin County, Iowa",17239,8634,8605,28445,12067,1774,510,136,80,16685,379,345,724,1314,532,782,8443,94,5.63,84.4,4.211381170601543,7.622251870758165,726,96.78635651719938,48.976158709901966,0.5008411160740183
19085,"Harrison County, Iowa",14196,7016,7180,29332,9912,1311,322,90,41,13948,471,336,807,1452,617,835,7219,120,6.41,87.7,3.191039729501268,10.228233305156381,453,98.2530290222598,50.8523527754297,0.49422372499295575
19087,"Henry County, Iowa",19865,10099,9766,26340,13600,1998,561,93,55,18717,503,313,816,2255,1125,1130,9193,177,5.07,87.6,3.5690913667253965,11.351623458343822,709,94.22099169393405,46.277372262773724,0.5083815756355399
19089,"Howard County, Iowa",9321,4677,4644,27906,6363,627,231,64,8,9136,230,264,494,1051,385,666,4637,52,6.8,81.8,3.2507241712262633,11.275614204484498,303,98.01523441690806,49.74788112863427,0.5017701963308658
19091,"Humboldt County, Iowa",9586,4665,4921,29587,6692,1032,250,45,22,9475,211,165,376,1226,506,720,4648,58,5.39,84.9,3.306905904443981,12.789484665136658,317,98.84206133945337,48.487377425412056,0.48664719382432714
19093,"Ida County, Iowa",6965,3478,3487,30192,4872,794,129,32,6,6838,138,177,315,701,309,392,3462,31,7.87,86.8,2.39770279971285,10.064608758076094,167,98.17659727207466,49.7056712132089,0.49935391241923904
19095,"Iowa County, Iowa",16231,8009,8222,29881,11229,1544,545,123,53,15965,533,367,900,1555,738,817,8549,40,4.59,86.7,4.442116936726018,9.58043250569897,721,98.3611607417904,52.67081510689422,0.4934384819173187
19097,"Jackson County, Iowa",19409,9639,9770,27672,13640,1678,647,105,102,19216,599,487,1086,2293,929,1364,9546,78,7.29,83.2,4.400020608995827,11.814106857643361,854,99.00561595136277,49.18336854036787,0.49662527693338143
19099,"Jasper County, Iowa",36789,18797,17992,27214,25859,3561,840,199,88,35189,950,810,1760,3171,1482,1689,17113,61,5.06,86.7,3.0634156949088043,8.619424284432847,1127,95.6508739025252,46.51662181630379,0.51094077033896
19101,"Jefferson County, Iowa",17945,9511,8434,26630,12591,2434,1328,207,238,17790,682,436,1118,2510,1465,1045,8203,35,5.13,87.6,9.880189467818333,13.987183059348007,1773,99.13624965171357,45.71189746447478,0.5300083588743383
19103,"Johnson County, Iowa",144425,71463,72962,33039,84554,23817,11444,4471,4794,142813,4720,3789,8509,24026,11660,12366,80222,648,5.74,86.4,14.338930240609313,16.635624026311234,20709,98.88384974900467,55.545785009520515,0.49481045525359185
19105,"Jones County, Iowa",20468,10528,9940,29653,14549,1708,654,77,70,19294,482,425,907,1745,743,1002,9502,33,6.5,83.4,3.913425835450459,8.525503224545632,801,94.2642173148329,46.42368575337112,0.5143638850889193
19107,"Keokuk County, Iowa",10223,5196,5027,26638,7173,955,270,66,10,10102,305,144,449,1130,518,612,4863,59,4.8,87.8,3.3845250904822457,11.053506798395775,346,98.81639440477355,47.56920669079526,0.5082656754377385
19109,"Kossuth County, Iowa",15166,7598,7568,29949,10689,1705,284,106,12,14920,387,268,655,1488,641,847,7496,81,5.35,84.7,2.6506659633390477,9.811420282210207,402,98.37795067915073,49.42634841091916,0.5009890544639325
19111,"Lee County, Iowa",34785,17553,17232,24408,24467,2740,806,236,52,33849,1244,885,2129,5504,2451,3053,15899,265,5.26,88,3.1450337789276985,15.822912174787984,1094,97.3091849935317,45.7064826793158,0.5046140577835274
19113,"Linn County, Iowa",220008,108534,111474,32786,146925,33089,10508,2174,1659,218065,5396,4243,9639,20280,9044,11236,115832,588,5.06,84.5,6.518399330933421,9.217846623759137,14341,99.11685029635287,52.6489945820152,0.4933184247845533
19115,"Louisa County, Iowa",11238,5743,5495,27234,7694,834,239,49,26,11103,271,248,519,1222,535,687,5466,91,5.44,86.7,2.794091475351486,10.873820964584446,314,98.79871863320875,48.638547784303256,0.51103399181349
19117,"Lucas County, Iowa",8600,4343,4257,27234,5959,778,138,67,24,8464,228,172,400,828,413,415,4041,19,6.44,89.1,2.6627906976744184,9.627906976744185,229,98.4186046511628,46.98837209302326,0.505
19119,"Lyon County, Iowa",11745,6011,5734,28356,7609,1217,294,63,76,11575,284,226,510,566,224,342,5905,16,5.13,85.9,3.6866751809280545,4.819071945508727,433,98.55257556406981,50.276713495104296,0.5117922520221371
19121,"Madison County, Iowa",15720,7870,7850,31449,10634,1894,525,61,16,15538,398,265,663,1132,492,640,7923,25,5.38,88.6,3.8295165394402035,7.201017811704834,602,98.84223918575064,50.400763358778626,0.5006361323155216
19123,"Mahaska County, Iowa",22301,11293,11008,26575,14982,2546,810,129,85,22072,556,349,905,3116,1422,1694,10786,113,4.54,88.6,4.591722344289494,13.97246760234967,1024,98.97314021792745,48.36554414600242,0.5063898479888794
19125,"Marion County, Iowa",33127,16341,16786,27815,21619,3920,1221,195,298,32880,551,458,1009,2932,1152,1780,16806,43,5.31,88.4,5.174027228544691,8.850786367615541,1714,99.25438464092734,50.73203127358348,0.49328342439701756
19127,"Marshall County, Iowa",40476,20400,20076,25693,26767,3721,1070,221,221,39585,1614,1332,2946,4422,2099,2323,18900,117,5.64,85.6,3.7355469908093686,10.924992588200414,1512,97.79869552327305,46.69433738511711,0.5040023717758672
19129,"Mills County, Iowa",14933,7487,7446,31309,10287,1629,601,59,54,14731,420,266,686,1344,610,734,7274,44,5.87,87.7,4.78135672671265,9.00020089734146,714,98.64729123417933,48.7109087256412,0.5013727984999665
19131,"Mitchell County, Iowa",10663,5288,5375,27407,7264,934,264,31,15,10448,536,423,959,870,423,447,5061,57,6.25,82.8,2.907249366969896,8.159054675044546,310,97.9836818906499,47.46319047172466,0.49592047266247774
19133,"Monona County, Iowa",8865,4388,4477,26829,6487,705,246,45,54,8635,258,233,491,1284,575,709,4230,18,7.4,88,3.8917089678510997,14.483925549915398,345,97.40552735476594,47.71573604060914,0.49498025944726454
19135,"Monroe County, Iowa",7912,4029,3883,25929,5376,677,96,21,57,7779,400,190,590,846,362,484,3746,17,5.23,88.7,2.1991911021233568,10.692618806875632,174,98.31900910010111,47.345803842264914,0.5092264914054601
19137,"Montgomery County, Iowa",10239,4931,5308,25005,7143,867,227,43,11,10042,317,185,502,1653,714,939,4793,54,6.88,86.9,2.7444086336556306,16.144154702607675,281,98.07598398281083,46.81121203242504,0.4815899990233421
19139,"Muscatine County, Iowa",42923,21256,21667,28028,28378,4129,1396,327,137,42422,1050,974,2024,4442,2036,2406,21266,116,7.1,85.5,4.333341099177597,10.348764065885423,1860,98.832793607157,49.54453323393053,0.4952123570113925
19141,"O'Brien County, Iowa",13944,6979,6965,32051,9678,1435,262,172,51,13733,343,333,676,1328,495,833,7243,40,5.88,86.2,3.4781985083189904,9.523809523809524,485,98.48680436029834,51.94348823866896,0.5005020080321285
19143,"Osceola County, Iowa",6149,3099,3050,26776,4283,595,123,33,7,6054,204,199,403,689,271,418,3143,33,6.83,85.2,2.6508375345584647,11.20507399577167,163,98.45503333875426,51.114002276792974,0.503984387705318
19145,"Page County, Iowa",15393,7996,7397,25739,11118,1662,491,93,46,14386,579,310,889,1963,988,975,7110,106,7.39,87.1,4.092769440654843,12.752549860326122,630,93.45806535438186,46.18982654453323,0.5194568959916845
19147,"Palo Alto County, Iowa",9110,4540,4570,27902,6275,1232,290,53,29,8906,252,214,466,618,257,361,4733,53,6.3,86,4.083424807903403,6.783754116355653,372,97.76070252469813,51.95389681668496,0.4983534577387486
19149,"Plymouth County, Iowa",25027,12259,12768,30686,16716,2696,570,155,44,24731,681,560,1241,2251,1005,1246,12960,192,5.9,87.6,3.0726815039757063,8.99428617093539,769,98.81727734047229,51.784073200942984,0.48983098253885804
19151,"Pocahontas County, Iowa",6972,3440,3532,27553,4978,648,82,32,22,6815,232,151,383,898,332,566,3320,61,5.36,86.1,1.9506597819850833,12.880091795754446,136,97.7481353987378,47.61904761904762,0.4934021801491681
19153,"Polk County, Iowa",467235,229864,237371,33524,308247,75457,23045,7235,3117,462472,14824,11630,26454,53570,23305,30265,245995,1152,5.28,87.8,7.147795006795295,11.465322589275203,33397,98.98059862809934,52.64909520904898,0.4919665692852633
19155,"Pottawattamie County, Iowa",93287,45896,47391,29085,62841,9163,3121,674,339,92190,3713,2720,6433,10191,4352,5839,46099,293,6.32,87.6,4.431485630366503,10.924351731752548,4134,98.82405908647507,49.41631738613097,0.4919870935928908
19157,"Poweshiek County, Iowa",18428,8821,9607,27679,11984,1648,635,201,235,18132,577,580,1157,1777,667,1110,9461,77,4.65,86.1,5.8118081180811805,9.642934664640764,1071,98.39374864336878,51.3403516388105,0.4786737573258086
19159,"Ringgold County, Iowa",4986,2421,2565,27621,3499,521,116,45,20,4785,169,170,339,518,206,312,2096,11,6.58,87.8,3.6301644604893704,10.389089450461292,181,95.96871239470518,42.03770557561171,0.4855595667870036
19161,"Sac County, Iowa",9936,4848,5088,29502,7035,1026,268,62,34,9750,313,244,557,913,403,510,4905,26,5.73,86.1,3.6634460547504024,9.188808373590982,364,98.1280193236715,49.36594202898551,0.48792270531400966
19163,"Scott County, Iowa",171493,84184,87309,30798,115570,23088,10223,2166,1400,169756,5647,3993,9640,20615,9347,11268,82521,326,6.87,84.4,8.040561422332107,12.020898812196416,13789,98.9871306700565,48.1191652137405,0.49088884094394525
19165,"Shelby County, Iowa",11772,5784,5988,30799,8304,1321,364,58,19,11554,383,309,692,1005,450,555,5913,29,7.2,86.8,3.746177370030581,8.537206931702345,441,98.14814814814815,50.22935779816514,0.49133537206931704
19167,"Sioux County, Iowa",34692,17407,17285,27339,20534,4023,1196,208,210,34293,1008,918,1926,2544,1080,1464,18270,64,5.6,86.8,4.65236942234521,7.333102732618471,1614,98.8498789346247,52.663438256658594,0.5017583304508244
19169,"Story County, Iowa",95888,49985,45903,27392,49223,13567,7015,947,3354,95168,2416,1600,4016,18822,10269,8553,49825,181,5.64,86.2,11.801268146170532,19.62915067578842,11316,99.2491239779743,51.961663607542135,0.5212852494577006
19171,"Tama County, Iowa",17236,8530,8706,27074,11727,1415,383,93,43,16862,566,502,1068,1968,892,1076,8324,106,5.91,84.8,3.011139475516361,11.417962404270133,519,97.83012299837549,48.294267811557205,0.49489440705500115
19173,"Taylor County, Iowa",6214,3152,3062,27344,4357,446,148,26,3,6115,298,185,483,668,269,399,2944,31,7.6,86.8,2.848406823302221,10.749919536530415,177,98.40682330222079,47.37689089153524,0.5072417122626328
19175,"Union County, Iowa",12497,6061,6436,25098,8516,956,295,111,6,12359,381,556,937,1682,668,1014,6044,14,5.8,87.8,3.2967912298951747,13.45923021525166,412,98.89573497639434,48.36360726574378,0.48499639913579257
19177,"Van Buren County, Iowa",7308,3728,3580,24952,5074,508,173,7,14,7249,547,451,998,1014,505,509,3195,99,5.37,88.3,2.654625068418172,13.875205254515599,194,99.19266557197592,43.7192118226601,0.5101258894362343
19179,"Wapello County, Iowa",35321,17441,17880,23413,24091,2858,1131,326,115,34971,1368,966,2334,5862,2647,3215,15772,294,4.86,88.5,4.450610118626313,16.596359106480563,1572,99.00908807791399,44.65332238611591,0.49378556666006057
19181,"Warren County, Iowa",48630,23679,24951,33013,31753,6961,1834,529,323,48032,812,852,1664,2903,1102,1801,25345,54,4.75,89.2,5.523339502364795,5.969566111453835,2686,98.77030639522928,52.118034135307425,0.48692165330043186
19183,"Washington County, Iowa",22095,11066,11029,28397,14961,2179,656,189,133,21773,960,864,1824,1983,839,1144,10875,187,5.56,86.9,4.426340801086218,8.974881194840462,978,98.54265670966282,49.219280380176514,0.5008372935053179
19185,"Wayne County, Iowa",6405,3136,3269,23367,4383,416,139,43,6,6303,349,441,790,1001,454,547,2729,50,5.83,88.4,2.9352068696330993,15.628415300546449,188,98.40749414519907,42.60733801717408,0.4896174863387978
19187,"Webster County, Iowa",36945,18984,17961,24629,24701,3608,994,222,224,35229,1118,941,2059,5539,2211,3328,16201,85,5.25,85.2,3.89768574908648,14.99255650290973,1440,95.35525781567195,43.85167140343754,0.5138449045879009
19189,"Winnebago County, Iowa",10545,5142,5403,26558,7305,1168,288,51,16,10321,220,202,422,998,434,564,5011,32,4.92,82.6,3.366524419155998,9.464201043148412,355,97.87577050734946,47.520151730678045,0.487624466571835
19191,"Winneshiek County, Iowa",20575,10306,10269,29052,13462,2366,1017,178,319,20313,346,289,635,1455,595,860,11753,89,6.74,82.1,7.358444714459295,7.071688942891859,1514,98.726609963548,57.12272174969623,0.5008991494532199
19193,"Woodbury County, Iowa",102397,50496,51901,25699,65199,10188,3042,963,418,101406,4481,3560,8041,13969,6283,7686,50918,488,8.05,87.9,4.319462484252468,13.6420012305048,4423,99.0321982089319,49.72606619334551,0.49313944744474936
19195,"Worth County, Iowa",7502,3734,3768,26781,5244,586,173,23,17,7398,251,163,414,741,309,432,3732,28,5.88,82.6,2.8392428685683817,9.877366035723806,213,98.61370301253,49.74673420421221,0.4977339376166356
19197,"Wright County, Iowa",12864,6431,6433,28200,8954,1182,294,53,42,12684,428,361,789,1585,733,852,5786,42,4.97,84,3.023942786069652,12.32120646766169,389,98.60074626865672,44.978233830845774,0.49992226368159204
20001,"Allen County, Kansas",12752,6318,6434,23011,8625,1086,504,58,11,12546,456,371,827,1733,758,975,5912,30,9.82,90.6,4.493412797992471,13.590025094102886,573,98.38456712672522,46.361355081555836,0.4954516938519448
20003,"Anderson County, Kansas",7840,3849,3991,21887,5361,574,274,122,28,7734,423,367,790,1049,447,602,3427,49,6.73,89.4,5.408163265306122,13.380102040816327,424,98.64795918367346,43.71173469387755,0.4909438775510204
20005,"Atchison County, Kansas",16466,7957,8509,25494,10127,1324,526,52,199,16289,668,820,1488,2808,1208,1600,7580,48,6.18,90,4.718814526903923,17.053321996841976,777,98.92505769464351,46.03425239888254,0.4832381877808818
20007,"Barber County, Kansas",4905,2525,2380,28840,3411,393,215,44,28,4864,280,275,555,772,410,362,2373,35,4.98,94.7,5.851172273190622,15.739041794087665,287,99.16411824668705,48.379204892966364,0.5147808358817533
20009,"Barton County, Kansas",27067,13445,13622,26264,18253,2161,591,194,140,26652,1875,1694,3569,4154,1795,2359,13420,62,5.07,93.5,3.4174455979606164,15.347101636679351,925,98.4667676506447,49.580670188790776,0.49673033583330256
20011,"Bourbon County, Kansas",14757,7315,7442,20707,9565,1191,467,143,30,14482,842,730,1572,2505,1276,1229,6383,59,9.65,90.5,4.336924849224097,16.97499491766619,640,98.13647760384902,43.25404892593345,0.4956969573761605
20013,"Brown County, Kansas",9736,4680,5056,24319,6564,878,382,66,64,9664,375,435,810,1275,521,754,4514,14,5.7,89.7,5.258833196384552,13.095727198027937,512,99.26047658175843,46.364009860312244,0.4806902218570255
20015,"Butler County, Kansas",66260,33449,32811,28478,43322,8573,3323,432,348,63864,2505,2860,5365,6845,2827,4018,30994,252,5.95,92.2,6.192272864473287,10.330516148505886,4103,96.38394204648355,46.77633564744944,0.50481436764262
20017,"Chase County, Kansas",2665,1345,1320,24469,1855,335,77,9,44,2569,102,92,194,323,177,146,1152,34,5.18,92,4.878048780487805,12.120075046904315,130,96.39774859287054,43.22701688555347,0.5046904315196998
20019,"Chautauqua County, Kansas",3425,1778,1647,23621,2490,309,71,24,10,3368,258,148,406,481,234,247,1443,16,8.05,92.4,3.065693430656934,14.043795620437956,105,98.33576642335767,42.13138686131387,0.5191240875912408
20021,"Cherokee County, Kansas",20501,10087,10414,21006,14012,1713,755,136,54,20287,1292,1105,2397,2759,1317,1442,8581,19,11.93,91.1,4.609531242378421,13.45788010340959,945,98.95614848056192,41.856494805131454,0.4920247792790596
20023,"Cheyenne County, Kansas",2677,1324,1353,27934,1893,386,74,25,3,2642,109,67,176,297,133,164,1203,18,4.31,92.2,3.8102353380649983,11.094508778483377,102,98.69256630556593,44.938363840119536,0.4945834889802017
20025,"Clark County, Kansas",2089,1073,1016,27087,1433,382,86,7,0,2031,79,100,179,180,71,109,1001,11,4.96,95,4.451890856869316,8.61656294877932,93,97.22355193872666,47.917663954045,0.5136428913355673
20027,"Clay County, Kansas",8203,4051,4152,28115,5730,927,409,18,14,7944,243,167,410,757,357,400,4088,33,5.69,93.8,5.376081921248324,9.228331098378641,441,96.8426185541875,49.83542606363525,0.49384371571376323
20029,"Cloud County, Kansas",9191,4553,4638,25579,6194,772,426,65,50,8951,492,413,905,1041,554,487,4577,57,7.1,93.2,5.886193014905886,11.326297464911326,541,97.38874986399739,49.7987161353498,0.49537591121749536
20031,"Coffey County, Kansas",8328,4197,4131,31679,5869,910,254,54,8,8224,391,367,758,925,431,494,4006,8,6.51,90.9,3.7944284341978864,11.107108549471661,316,98.75120076849184,48.10278578290106,0.5039625360230547
20033,"Comanche County, Kansas",1741,841,900,28388,1228,167,57,3,0,1663,92,117,209,134,45,89,927,6,4.65,94.2,3.4462952326249283,7.696726019529006,60,95.51981619758759,53.24526134405514,0.4830557151062608
20035,"Cowley County, Kansas",35732,17973,17759,23130,23253,3215,1191,264,53,34525,1898,1714,3612,5382,2349,3033,15258,156,7.35,92.5,4.22030672786298,15.062129183924773,1508,96.62207545057652,42.70122019478339,0.5029945147206986
20037,"Crawford County, Kansas",39099,19571,19528,21207,23369,4221,1976,338,221,38465,2391,2142,4533,7849,4107,3742,18199,113,12.6,90.4,6.4835417785621114,20.074682216936495,2535,98.3784751528172,46.545947466687124,0.5005498861863474
20039,"Decatur County, Kansas",2891,1444,1447,30890,2165,318,125,22,9,2808,185,143,328,490,152,338,1335,10,5.93,92.7,5.396056727775856,16.949152542372882,156,97.12902109996541,46.17779315115877,0.49948114839156
20041,"Dickinson County, Kansas",19162,9572,9590,24434,13182,1937,611,94,104,18773,796,516,1312,2183,836,1347,8767,135,4.76,94,4.221897505479595,11.392339004279302,809,97.96994050725394,45.75200918484501,0.49953032042584283
20043,"Doniphan County, Kansas",7790,3952,3838,24520,5113,645,178,26,20,7666,529,390,919,975,464,511,3749,35,5.36,89,2.8754813863928113,12.51604621309371,224,98.40821566110398,48.125802310654684,0.5073170731707317
20045,"Douglas County, Kansas",117806,58348,59458,29438,67159,17727,10178,2190,3457,117121,5519,4677,10196,20437,10414,10023,63147,451,7.75,89.3,13.433101879360983,17.348012834660373,15825,99.41853555846052,53.602532977946794,0.49528886474373124
20047,"Edwards County, Kansas",2946,1520,1426,27966,2062,286,76,21,4,2849,139,160,299,289,117,172,1426,52,7.41,93.6,3.428377460964019,9.80991174473863,101,96.70739986422268,48.40461642905635,0.5159538357094365
20049,"Elk County, Kansas",2581,1271,1310,21156,1933,164,122,14,5,2541,160,124,284,343,144,199,996,30,6.9,91.3,5.462998837659822,13.289422704378149,141,98.45021309569934,38.5896939170864,0.4924447888415343
20051,"Ellis County, Kansas",28877,14469,14408,29339,17221,4297,1365,255,210,28655,941,974,1915,4631,2364,2267,15666,11,5.7,94.4,6.33722339578211,16.036984451293417,1830,99.23122207985594,54.25078782421997,0.5010562038992971
20053,"Ellsworth County, Kansas",6331,3576,2755,24102,4612,661,187,57,32,5440,120,123,243,618,243,375,2683,55,6.33,95.5,4.359500868741115,9.761491075659453,276,85.92639393460749,42.37877112620439,0.5648396777760227
20055,"Finney County, Kansas",37097,18913,18184,23074,21627,2518,902,196,125,36868,2534,2379,4913,5914,2661,3253,18429,112,3.87,93.7,3.2967625414454,15.941989918322236,1223,99.38269940965577,49.67787152599941,0.5098255923659595
20057,"Ford County, Kansas",34658,17933,16725,22053,20419,2480,931,240,88,34157,2743,2647,5390,5501,2550,2951,16474,312,7.04,93.5,3.63263892896301,15.872237290091753,1259,98.55444630388367,47.5330371054302,0.5174274337815223
20059,"Franklin County, Kansas",25599,12505,13094,25701,16982,2302,890,137,123,25420,958,1061,2019,3098,1320,1778,12688,190,7.32,89.2,4.492362982929021,12.102035235751396,1150,99.30075393570061,49.56443611078558,0.4884956443611079
20061,"Geary County, Kansas",35796,19025,16771,21583,19185,2879,979,135,105,29856,1224,1304,2528,5192,2214,2978,16790,304,4.92,92.5,3.405408425522405,14.504413900994525,1219,83.40596714716727,46.90468208738407,0.531483964688792
20063,"Gove County, Kansas",2632,1330,1302,29352,1934,365,59,21,2,2584,158,131,289,232,121,111,1277,8,5.44,93.3,3.115501519756839,8.814589665653495,82,98.17629179331307,48.51823708206687,0.5053191489361702
20065,"Graham County, Kansas",2561,1270,1291,27165,1934,418,75,17,20,2532,98,78,176,308,116,192,1181,36,5.07,93.7,4.373291682936353,12.02655212807497,112,98.86762983209684,46.11479890667708,0.49590003904724717
20067,"Grant County, Kansas",7716,4066,3650,26138,4613,538,110,41,58,7645,877,602,1479,765,289,476,3614,7,4.97,93.4,2.7086573354069468,9.914463452566096,209,99.07983411093831,46.83773976153447,0.5269569725246241
20069,"Gray County, Kansas",6004,3004,3000,27031,3743,594,147,15,29,5919,382,348,730,502,196,306,3047,7,5.75,93.5,3.1812125249833443,8.361092604930047,191,98.58427714856762,50.74950033311126,0.5003331112591606
20071,"Greeley County, Kansas",1210,584,626,25775,831,200,42,8,2,1180,55,34,89,136,33,103,549,0,5.06,91.2,4.297520661157025,11.239669421487603,52,97.52066115702479,45.37190082644628,0.4826446280991736
20073,"Greenwood County, Kansas",6227,3121,3106,24837,4521,584,234,25,12,6128,332,321,653,760,302,458,2712,21,7.02,91.8,4.35201541673358,12.20491408382849,271,98.41014934960656,43.55227236229324,0.5012044323109042
20075,"Hamilton County, Kansas",2621,1381,1240,21694,1615,225,42,10,11,2621,370,247,617,245,110,135,1272,10,5.91,93,2.4036627241510873,9.347577260587562,63,100,48.531095001907666,0.5268981304845479
20077,"Harper County, Kansas",5746,2928,2818,25698,3989,466,201,21,11,5595,430,305,735,936,458,478,2562,14,5.12,95,4.054994778976679,16.289592760180994,233,97.37208492864602,44.587539157674904,0.5095718760877131
20079,"Harvey County, Kansas",34683,17016,17667,26587,22810,4122,2111,331,269,34049,1673,1515,3188,3746,1550,2196,16833,100,5.45,93.9,7.8165095291641435,10.800680448634777,2711,98.1720151082663,48.53386385260791,0.4906149987025344
20081,"Haskell County, Kansas",4081,2015,2066,24141,2503,295,122,17,6,4024,331,446,777,537,227,310,1927,26,4.74,93.3,3.553050722862044,13.158539573633913,145,98.60328350894389,47.21881891693212,0.49375153148738055
20083,"Hodgeman County, Kansas",1875,935,940,28857,1338,235,75,13,4,1840,101,74,175,154,70,84,982,5,6.29,93.6,4.906666666666666,8.213333333333333,92,98.13333333333334,52.373333333333335,0.49866666666666665
20085,"Jackson County, Kansas",13322,6641,6681,25920,8932,1183,522,46,24,13185,396,381,777,1295,497,798,6227,23,5.46,91.2,4.443777210629035,9.720762648251013,592,98.9716258819997,46.74223089626182,0.498498723915328
20087,"Jefferson County, Kansas",18856,9556,9300,27783,13175,1887,682,111,113,18597,857,530,1387,1536,670,866,9166,42,7.18,89.6,4.804836656767077,8.145948239287229,906,98.62643190496394,48.61052184980908,0.5067882901994061
20089,"Jewell County, Kansas",2963,1488,1475,24361,2216,255,61,5,32,2932,127,99,226,412,177,235,1264,13,6.11,91.8,3.3074586567667903,13.90482618967263,98,98.95376307796153,42.659466756665545,0.5021937225784677
20091,"Johnson County, Kansas",578797,283504,295293,43061,388234,132207,58124,15116,6636,574871,19309,17226,36535,32267,14239,18028,306935,1500,10.03,88.5,13.80034796310278,5.5748388467804775,79876,99.32169655336845,53.02981874474125,0.4898159458324767
20093,"Kearny County, Kansas",3931,1918,2013,24232,2449,210,93,25,0,3868,192,260,452,498,179,319,1755,1,3.93,93.4,3.001780717374714,12.668532180106842,118,98.39735436275757,44.645128466039175,0.48791656067158484
20095,"Kingman County, Kansas",7576,3835,3741,30927,5340,908,285,20,29,7445,325,228,553,568,251,317,3598,59,5.45,94.5,4.408658922914467,7.497360084477297,334,98.27085533262935,47.49208025343189,0.5062038014783526
20097,"Kiowa County, Kansas",2524,1230,1294,24961,1642,309,108,20,17,2454,100,92,192,204,112,92,1254,5,6.12,93.5,5.744849445324881,8.082408874801901,145,97.22662440570522,49.68304278922346,0.4873217115689382
20099,"Labette County, Kansas",20553,10142,10411,22841,14004,1614,603,135,117,20228,986,1095,2081,3581,1567,2014,9348,119,9.58,90.4,4.159976645745147,17.42324721451856,855,98.41872232764074,45.482411326813605,0.4934559431713132
20101,"Lane County, Kansas",1702,864,838,29768,1163,206,69,0,3,1694,115,52,167,181,84,97,844,8,3.48,93.5,4.230317273795535,10.63454759106933,72,99.52996474735605,49.588719153936545,0.5076380728554641
20103,"Leavenworth County, Kansas",79359,42581,36778,30170,53657,9459,6146,645,369,72021,2077,1796,3873,6635,2900,3735,35799,367,8.25,89.1,9.022291107498834,8.360740432717146,7160,90.7534117113371,45.11019544097078,0.536561700626268
20105,"Lincoln County, Kansas",3121,1555,1566,25667,2206,287,116,18,19,3055,120,185,305,250,111,139,1440,7,7.56,95.5,4.902274911887216,8.010253123998718,153,97.88529317526434,46.139057994232616,0.4982377443127203
20107,"Linn County, Kansas",9602,4793,4809,25796,6786,708,205,30,16,9541,476,530,1006,1654,674,980,4086,29,8.74,89.5,2.614038741928765,17.225578004582378,251,99.36471568423245,42.55363465944595,0.49916684024161634
20109,"Logan County, Kansas",2790,1396,1394,28549,1919,262,81,23,0,2749,95,66,161,246,113,133,1344,1,5.93,92.4,3.727598566308244,8.817204301075268,104,98.5304659498208,48.17204301075269,0.5003584229390681
20111,"Lyon County, Kansas",33302,16165,17137,24307,19909,3498,1407,247,239,32903,1914,1654,3568,5921,2556,3365,16980,79,5.87,91,5.684343282685725,17.779712930154346,1893,98.80187376133566,50.98792865293376,0.4854062819049907
20113,"McPherson County, Kansas",28792,14238,14554,29508,19413,3881,1317,216,144,28121,842,938,1780,2083,845,1238,14985,96,5.28,94.8,5.824534592942484,7.234648513475966,1677,97.66949152542372,52.045707140872466,0.49451236454570713
20115,"Marion County, Kansas",12087,5997,6090,25620,8329,1356,505,101,28,11720,386,475,861,1211,617,594,5597,11,5.04,92.6,5.245304873004054,10.019028708529826,634,96.96367998676264,46.30594853975345,0.4961528915363614
20117,"Marshall County, Kansas",9859,4937,4922,27908,6921,844,324,90,28,9699,451,315,766,860,378,482,4841,65,5.24,90.9,4.483213307637691,8.722994218480576,442,98.37711735470128,49.10234303681915,0.5007607262399838
20119,"Meade County, Kansas",4295,2163,2132,25173,2755,394,156,13,7,4171,311,256,567,507,203,304,2042,23,6.07,94.5,4.0977881257275905,11.804423748544819,176,97.11292200232829,47.543655413271246,0.5036088474970897
20121,"Miami County, Kansas",32976,16160,16816,31611,22327,3876,1456,249,195,32390,1148,1040,2188,2492,987,1505,15979,117,8.98,88.8,5.761766132945172,7.557011159631247,1900,98.22295002426007,48.4564531780689,0.490053372149442
20123,"Mitchell County, Kansas",6230,3199,3031,26108,4226,698,248,63,10,6079,243,132,375,882,397,485,2787,20,7.04,93.9,5.152487961476726,14.157303370786517,321,97.57624398073837,44.73515248796148,0.5134831460674157
20125,"Montgomery County, Kansas",33463,16580,16883,22823,22524,2891,1030,208,76,32940,2141,1794,3935,5686,2786,2900,14340,256,9.01,91.4,3.9267250395959716,16.991901503152736,1314,98.43707975973463,42.853300660430925,0.4954726115411051
20127,"Morris County, Kansas",5605,2752,2853,26569,4097,485,213,45,0,5525,244,248,492,538,234,304,2715,11,6.66,91.1,4.6030330062444245,9.5985727029438,258,98.57270294380018,48.43889384478145,0.49099018733273864
20129,"Morton County, Kansas",2931,1534,1397,23038,1852,158,78,7,0,2847,238,144,382,227,90,137,1254,21,4.1,93.4,2.9000341180484477,7.744796997611736,85,97.13408393039919,42.78403275332651,0.5233708631866257
20131,"Nemaha County, Kansas",10095,5083,5012,27438,6658,1122,357,54,47,9824,256,305,561,1053,431,622,5036,14,4.79,90,4.5368994551758295,10.430906389301635,458,97.31550272412085,49.88608221892026,0.5035165923724616
20133,"Neosho County, Kansas",16209,7935,8274,23589,10777,1173,678,171,67,16001,887,989,1876,3356,1508,1848,7343,39,11.16,90.5,5.6511814424085385,20.70454685668456,916,98.71676229255353,45.30199272009377,0.4895428465667222
20135,"Ness County, Kansas",3001,1527,1474,30761,2184,323,86,7,0,2950,116,116,232,260,139,121,1421,2,5.05,93.4,3.0989670109963345,8.66377874041986,93,98.30056647784072,47.35088303898701,0.5088303898700434
20137,"Norton County, Kansas",5527,3127,2400,22935,3972,528,74,29,7,4720,111,90,201,544,254,290,2492,22,6.13,93,1.990229781074724,9.842590917314999,110,85.39895060611543,45.087751040347385,0.5657680477655147
20139,"Osage County, Kansas",15894,7915,7979,27209,10988,1548,598,28,99,15683,738,784,1522,2005,894,1111,7169,35,6.56,90,4.561469737007676,12.614823203724676,725,98.67245501447087,45.10507109601107,0.4979866616333207
20141,"Osborne County, Kansas",3684,1836,1848,26559,2642,429,104,35,20,3583,190,141,331,553,276,277,1734,36,6.73,94.1,4.315960912052117,15.01085776330076,159,97.25841476655809,47.068403908794785,0.498371335504886
20143,"Ottawa County, Kansas",5957,3118,2839,28839,4109,682,182,18,32,5869,277,242,519,567,275,292,2914,39,6.1,95.5,3.894577807621286,9.518213866039954,232,98.52274634883331,48.917240221588045,0.5234178277656538
20145,"Pawnee County, Kansas",6776,3842,2934,24404,5038,579,282,33,25,5699,216,260,476,443,134,309,2747,12,6.17,93.2,5.017709563164108,6.537780401416765,340,84.10566706021251,40.540141676505314,0.5670011806375442
20147,"Phillips County, Kansas",5446,2658,2788,24795,3769,570,198,21,22,5345,177,117,294,432,123,309,2733,15,6.33,92.7,4.425266250459052,7.932427469702534,241,98.14542783694455,50.183621006243115,0.4880646345941976
20149,"Pottawatomie County, Kansas",23188,11646,11542,27978,14674,3310,1113,168,331,22632,681,687,1368,2207,996,1211,11066,96,5.27,91.1,6.951871657754011,9.517854062446093,1612,97.60220803864068,47.72296015180266,0.5022425392444367
20151,"Pratt County, Kansas",9670,4860,4810,27063,6265,1119,420,84,34,9440,436,409,845,1008,383,625,4641,83,6.14,94.1,5.563598759048604,10.423991726990693,538,97.62150982419855,47.99379524301965,0.5025853154084798
20153,"Rawlins County, Kansas",2520,1300,1220,27615,1873,365,104,26,5,2481,61,72,133,213,87,126,1214,7,7.09,92.1,5.357142857142857,8.452380952380953,135,98.45238095238095,48.17460317460318,0.5158730158730159
20155,"Reno County, Kansas",63360,31944,31416,25267,43237,5873,2188,463,132,60842,2670,2746,5416,8470,3787,4683,29331,280,4.7,94.7,4.392361111111111,13.368055555555555,2783,96.02588383838383,46.29261363636363,0.5041666666666667
20157,"Republic County, Kansas",4705,2290,2415,27121,3523,490,268,29,33,4610,133,128,261,537,227,310,2372,33,7.34,91.2,7.0138150903294365,11.413390010626992,330,97.98087141339,50.4144527098831,0.4867162592986185
20159,"Rice County, Kansas",9868,4983,4885,23355,6354,961,355,35,80,9661,657,460,1117,1501,767,734,4683,26,4.81,94.6,4.762869882448318,15.210782326712607,470,97.90231049858127,47.456424807458454,0.5049655451965951
20161,"Riley County, Kansas",75696,40410,35286,26619,37648,9250,4714,1010,2162,68618,2229,1876,4105,14511,6781,7730,41515,306,4.63,92.4,10.417987740435425,19.170101458465442,7886,90.64943986472204,54.84437751004016,0.5338459099556119
20163,"Rooks County, Kansas",5148,2495,2653,25415,3608,602,257,38,29,4949,233,222,455,557,252,305,2471,16,5.96,94.2,6.293706293706293,10.81973581973582,324,96.13442113442113,47.999222999223,0.48465423465423463
20165,"Rush County, Kansas",3119,1540,1579,25983,2294,347,151,8,25,3051,94,130,224,204,84,120,1464,24,5.21,93.5,5.899326707277973,6.5405578711125365,184,97.81981404296249,46.93812119268996,0.493747996152613
20167,"Russell County, Kansas",6987,3558,3429,25686,5134,667,419,80,75,6867,197,274,471,945,513,432,3340,4,6.8,94.9,8.215256905681981,13.52511807642765,574,98.2825246887076,47.803062830971804,0.5092314297981967
20169,"Saline County, Kansas",55334,27331,28003,27951,37069,6167,2160,650,304,54446,2537,2654,5191,6799,2778,4021,27653,555,4.49,96.3,5.627643040445296,12.287201359019772,3114,98.39520005783064,49.974699100010845,0.4939277840026024
20171,"Scott County, Kansas",4981,2403,2578,31825,3302,630,181,59,10,4884,160,80,240,210,45,165,2467,9,3.79,93,5.019072475406545,4.216020879341498,250,98.05259987954226,49.528207187311786,0.4824332463360771
20173,"Sedgwick County, Kansas",510484,252399,258085,27583,328321,66165,26358,5085,3082,504644,31021,26956,57977,73900,33053,40847,243790,2376,5.92,93.8,6.763189443743585,14.47645763628243,34525,98.85598765093519,47.75663879769004,0.49443077549933007
20175,"Seward County, Kansas",22948,11752,11196,21158,13265,1185,318,80,24,22750,2454,1983,4437,4205,1783,2422,10777,90,4.99,94,1.8389402126546976,18.32403695311138,422,99.13717971065016,46.96269827435942,0.51211434547673
20177,"Shawnee County, Kansas",178392,86487,91905,28584,120131,23162,9552,2342,1427,175061,8852,6701,15553,22898,10883,12015,83219,844,6.42,90.4,7.467263105968877,12.835777389120588,13321,98.13276380106731,46.64951343109556,0.48481434145028923
20179,"Sheridan County, Kansas",2497,1282,1215,30165,1808,324,84,36,0,2471,129,116,245,119,37,82,1203,6,6.6,93.3,4.805766920304365,4.765718862635162,120,98.95875050060071,48.17781337605126,0.513416099319183
20181,"Sherman County, Kansas",5999,3009,2990,25653,4064,565,141,17,17,5902,315,172,487,969,536,433,2764,31,7.04,90.9,2.9171528588098017,16.152692115352558,175,98.383063843974,46.07434572428738,0.501583597266211
20183,"Smith County, Kansas",3693,1814,1879,28122,2738,394,91,31,34,3631,108,168,276,483,190,293,1685,7,6.86,92.7,4.224207961007311,13.078797725426483,156,98.3211481180612,45.62686163011102,0.49119956674790144
20185,"Stafford County, Kansas",4251,2142,2109,25941,2941,494,144,14,13,4131,197,233,430,591,302,289,1995,45,4.46,93.8,4.0225829216654905,13.902611150317572,171,97.17713479181369,46.93013408609739,0.5038814396612562
20187,"Stanton County, Kansas",2107,996,1111,21062,1368,260,34,0,15,2079,150,159,309,225,86,139,985,23,5.04,93.7,2.3255813953488373,10.678690080683436,49,98.67109634551495,46.74893213099193,0.47271001423825343
20189,"Stevens County, Kansas",5741,2942,2799,24691,3555,405,133,8,30,5630,418,461,879,950,373,577,2564,6,4.98,93.4,2.9785751611217557,16.547639784009753,171,98.06653893049992,44.66120884863264,0.5124542762584916
20191,"Sumner County, Kansas",23336,11658,11678,25393,15641,2444,622,129,68,22853,1202,919,2121,2691,1163,1528,10626,41,5.98,94.4,3.5095989029825163,11.53153925265684,819,97.93023654439493,45.53479602331162,0.49957147754542336
20193,"Thomas County, Kansas",7847,3856,3991,26718,5030,946,327,31,31,7734,305,264,569,827,438,389,4293,84,7.55,92,4.957308525551166,10.539059513189754,389,98.55995922008411,54.7088059130878,0.49139798649165284
20195,"Trego County, Kansas",2899,1465,1434,33233,2121,347,128,12,8,2819,82,124,206,136,64,72,1717,22,4.62,93.6,5.1052086926526385,4.69127285270783,148,97.24042773370128,59.227319765436356,0.5053466712659538
20197,"Wabaunsee County, Kansas",6918,3492,3426,25790,4741,711,276,53,37,6820,249,207,456,414,171,243,3336,36,6.38,90.4,5.2905464006938425,5.98438855160451,366,98.58340560855738,48.22202948829141,0.5047701647875108
20199,"Wallace County, Kansas",1591,802,789,29931,1087,229,48,5,5,1571,89,51,140,166,84,82,760,2,5.96,91.3,3.6455059710873665,10.433689503456945,58,98.74292897548712,47.76869893148963,0.5040854808296669
20201,"Washington County, Kansas",5572,2846,2726,26927,3911,562,162,19,3,5435,180,154,334,523,231,292,2763,38,6.78,92,3.3022254127781765,9.3862167982771,184,97.54127781765973,49.58722182340273,0.5107681263460158
20203,"Wichita County, Kansas",2157,1019,1138,27111,1461,224,67,6,0,2130,79,89,168,94,40,54,1053,0,4,91.9,3.3843300880853038,4.3579044969865555,73,98.74826147426982,48.817802503477054,0.47241539174779784
20205,"Wilson County, Kansas",8858,4362,4496,25107,6150,649,189,63,55,8727,565,432,997,1441,704,737,4111,40,7.61,91.6,3.465793632874238,16.26778053736735,307,98.52111086023933,46.410024836306164,0.492436215850079
20207,"Woodson County, Kansas",3178,1574,1604,21419,2348,241,66,14,0,3169,189,222,411,642,278,364,1484,27,8.49,91.9,2.5173064820641913,20.201384518565135,80,99.71680302076778,46.69603524229075,0.49528005034612965
20209,"Wyandotte County, Kansas",163227,80545,82682,20192,102821,11616,4052,952,572,161957,16665,15267,31932,34641,15886,18755,72319,284,10.49,89,3.416101502815098,21.22259185061295,5576,99.22194244824692,44.30578274427638,0.49345390162166797
21001,"Adair County, Kentucky",19304,9632,9672,18408,12861,997,766,197,72,19031,1049,614,1663,3860,1844,2016,7837,36,7.94,87.3,5.361583091587236,19.995855781185245,1035,98.5857853294654,40.59780356402818,0.49896394529631166
21003,"Allen County, Kentucky",20628,10227,10401,21652,14073,1274,585,127,37,20433,1269,1081,2350,4068,1848,2220,8258,134,7.7,89.5,3.630987007950359,19.720767888307154,749,99.05468295520652,40.03296490207485,0.495782431646306
21005,"Anderson County, Kentucky",22017,10639,11378,24991,15096,1974,827,161,64,21912,609,577,1186,2617,1096,1521,10257,19,6.33,87,4.7781259935504385,11.886269700685833,1052,99.52309578961712,46.586728437116776,0.4832175137393832
21007,"Ballard County, Kentucky",8152,4077,4075,25063,5710,463,265,57,18,8034,457,416,873,1436,589,847,3344,25,6.55,89.8,4.1707556427870465,17.6153091265947,340,98.55250245338567,41.020608439646715,0.5001226692836114
21009,"Barren County, Kentucky",43418,21123,22295,20493,29531,2904,1423,386,83,42693,2044,1830,3874,9704,4155,5549,17887,169,8.71,90,4.357639688608411,22.35017734580128,1892,98.33018563729328,41.1971993182551,0.4865032935648809
21011,"Bath County, Kentucky",12189,6012,6177,20059,8116,636,181,103,28,12099,587,494,1081,2888,1208,1680,4327,18,6.37,85.5,2.559684961850849,23.693494134055296,312,99.26162933792764,35.49922060874559,0.4932316022643367
21013,"Bell County, Kentucky",27469,13385,14084,14754,19355,897,674,163,67,26625,1076,1163,2239,10084,4288,5796,7448,163,8.2,83.6,3.2909825621609814,36.710473624813424,904,96.92744548400015,27.11420146346791,0.4872765663111143
21015,"Boone County, Kentucky",127682,63122,64560,33553,83393,16762,7113,1637,748,126397,3681,3751,7432,9571,3895,5676,63781,472,7.17,85.6,7.438793251985401,7.495966541877477,9498,98.99359345874907,49.95300825488322,0.4943688225435065
21017,"Bourbon County, Kentucky",20017,9706,10311,25994,13912,1712,655,135,136,19795,1061,870,1931,3268,1368,1900,9239,191,5.67,86.2,4.626067842334016,16.32612279562372,926,98.8909426987061,46.15576759754209,0.4848878453314682
21019,"Boyd County, Kentucky",48486,24180,24306,26420,34571,4012,1797,573,316,46524,2119,1867,3986,8941,4041,4900,17928,173,6.69,86,5.539743431093512,18.44037454110465,2686,95.95347110506125,36.97562182898156,0.49870065585942336
21021,"Boyle County, Kentucky",29773,14883,14890,23822,19764,2329,1639,348,229,28415,1101,725,1826,4140,1957,2183,12067,72,6.66,86.4,7.4429852550969,13.905216135424714,2216,95.43882040775199,40.530010412118365,0.49988244382494207
21023,"Bracken County, Kentucky",8330,4186,4144,22433,5654,438,269,67,16,8296,306,229,535,1765,783,982,3448,16,6.31,85.8,4.225690276110444,21.18847539015606,352,99.59183673469387,41.39255702280912,0.5025210084033613
21025,"Breathitt County, Kentucky",13276,6675,6601,16875,9298,556,444,161,12,13134,531,370,901,4678,2198,2480,3824,180,6.8,86.8,4.6474841819825246,35.23651702319976,617,98.93040072310937,28.803856583308225,0.5027869840313347
21027,"Breckinridge County, Kentucky",19991,10028,9963,20735,13844,754,543,77,0,19719,1188,786,1974,3466,1636,1830,7508,84,6.88,88.1,3.1013956280326145,17.33780201090491,620,98.63938772447601,37.556900605272375,0.5016257315792106
21029,"Bullitt County, Kentucky",78622,39131,39491,26643,54121,4923,2088,364,161,78282,2535,1416,3951,7952,3709,4243,37717,294,6.75,87.1,3.3234972399582814,10.11421739462237,2613,99.56755106713133,47.97257765002162,0.49771056447304823
21031,"Butler County, Kentucky",12735,6405,6330,21787,8971,610,322,58,62,12521,715,532,1247,2731,1217,1514,5101,85,8.13,90.1,3.4707499018453083,21.444837063211622,442,98.31959167648213,40.05496662740479,0.502944640753828
21033,"Caldwell County, Kentucky",12747,5973,6774,25272,9005,623,748,60,54,12629,446,253,699,2214,842,1372,5210,271,5.89,89.6,6.762375460892759,17.36879265709579,862,99.074291990272215,40.872362124421436,0.46858084255118854
21035,"Calloway County, Kentucky",38616,18594,20022,21757,23728,3830,2056,384,561,38206,1637,1539,3176,7810,3730,4080,16941,101,5.68,89.4,7.7713900973689665,20.224777294385746,3001,98.9382639320489,43.87041640770665,0.4815102548166563
21037,"Campbell County, Kentucky",91804,45005,46799,31065,62597,12818,5309,1096,775,90204,2998,2684,5682,12541,5301,7240,45398,415,6.21,86,7.821009977778746,13.660624809376499,7180,98.25715655091281,49.45100431353754,0.49022918391355497
21039,"Carlisle County, Kentucky",4890,2378,2512,24015,3435,318,179,16,18,4821,211,183,394,834,349,485,1946,40,6.07,89.6,4.355828220858895,17.05521472392638,213,98.58895705521472,39.79550102249489,0.48629856850715747
21041,"Carroll County, Kentucky",10695,5467,5228,22296,7122,504,204,95,34,10411,536,391,927,2843,1269,1574,4473,35,9.02,86.7,3.113604488078541,26.582515194015894,333,97.34455352968676,41.82328190743338,0.5111734455352969
21043,"Carter County, Kentucky",27385,13462,13923,18477,18647,1594,818,117,75,27077,1354,1323,2677,5711,2668,3043,9379,60,5.7,85.2,3.688150447325178,20.854482380865438,1010,98.87529669527113,34.24867628263648,0.49158298338506484
21045,"Casey County, Kentucky",15805,7785,8020,18319,11001,667,540,79,73,15462,1098,870,1968,4101,1868,2233,5650,57,6.69,86.2,4.378361278076558,25.947484973109777,692,97.82980069598229,35.74818095539386,0.4925656437836128
21047,"Christian County, Kentucky",72438,38426,34012,21393,41214,3913,2392,489,129,63103,3599,3214,6813,12986,5207,7779,31132,513,6.34,88.3,4.155277616720506,17.927054860708466,3010,87.11311742455617,42.97744277865209,0.5304674342196085
21049,"Clark County, Kentucky",35757,17426,18331,26219,24963,3608,1467,176,157,35343,1421,1025,2446,5266,2284,2982,15701,289,6.07,86.4,5.033979360684621,14.727186285202897,1800,98.84218474704254,43.9102833011718,0.48734513521827894
21051,"Clay County, Kentucky",20866,11054,9812,15388,14739,755,473,128,46,19352,1151,806,1957,7606,3735,3871,5605,96,6.91,86.8,3.1007380427489695,36.45164382248634,647,92.74417713025976,26.86188057126426,0.5297613342279306
21053,"Clinton County, Kentucky",10208,5119,5089,19325,7129,397,234,78,8,10055,766,417,1183,2016,954,1062,3765,51,8.39,86.6,3.134796238244514,19.74921630094044,320,98.50117554858934,36.882836990595614,0.5014694357366771
21055,"Crittenden County, Kentucky",9154,4627,4527,22765,6428,505,209,133,6,8952,577,562,1139,1576,802,774,3595,54,5.28,89.8,3.8016167795499234,17.216517369455975,348,97.79331439807734,39.27244920253441,0.505462093074066
21057,"Cumberland County, Kentucky",6744,3372,3372,18669,4742,408,179,34,4,6656,519,388,907,1375,583,792,2377,24,7.73,87.9,3.2176749703440093,20.388493475682086,217,98.69513641755634,35.24614472123369,0.5
21059,"Daviess County, Kentucky",99258,48300,50958,26501,66803,8843,4277,765,560,97254,3050,2345,5395,15246,6653,8593,43831,256,6.02,88.8,5.643877571581132,15.359970984706523,5602,97.9810191621834,44.158657236696286,0.4866106510306474
21061,"Edmonson County, Kentucky",12063,6049,6014,21851,8612,540,316,96,7,11969,308,333,641,2387,1021,1366,4548,23,8.51,90.3,3.4734311531128244,19.787780817375445,419,99.22075768880046,37.7020641631435,0.5014507170687226
21063,"Elliott County, Kentucky",7533,4302,3231,13436,5538,240,121,39,13,6294,250,205,455,2144,1055,1089,1728,17,6.25,85.2,2.29656179476968,28.461436346741007,173,83.55236957387496,22.939068100358423,0.5710872162485066
21065,"Estill County, Kentucky",14382,7081,7301,17728,10241,640,254,79,42,14260,779,506,1285,4329,1926,2403,4852,51,6.82,86.3,2.6074259491030456,30.100125156445557,375,99.15171742455847,33.73661521346127,0.49235155054929775
21067,"Fayette County, Kentucky",315109,154530,160579,31653,203859,48624,23567,7159,5935,309986,14987,11366,26353,56039,24865,31174,159253,1596,5.61,86.3,11.634386831223482,17.784004899891784,36661,98.37421336743793,50.539019831233,0.49040173400315445
21069,"Fleming County, Kentucky",14515,7155,7360,23351,9848,756,486,50,24,14515,1106,917,2023,2821,1324,1497,5656,14,5.96,85.2,3.8580778504994835,19.43506717189115,560,100,38.96658629004478,0.4929383396486393
21071,"Floyd County, Kentucky",37447,18314,19133,18366,26169,1653,1318,257,65,36943,1950,1310,3260,11304,5353,5951,10758,52,6.73,87,4.3795230592570835,30.186663818196383,1640,98.65409779154538,28.72860309237055,0.48906454455630627
21073,"Franklin County, Kentucky",49969,24502,25467,28001,34882,6189,3004,535,186,49196,2705,1961,4666,6289,2698,3591,23302,42,6.19,87,7.454621865556645,12.585803197982749,3725,98.45304088534891,46.63291240569153,0.49034401328823873
21075,"Fulton County, Kentucky",6259,3094,3165,18111,4408,382,215,38,21,5841,239,270,509,1474,697,777,2231,57,6.39,88.6,4.377696117590669,23.550087873462214,274,93.32161687170475,35.64467167279118,0.494328167438888
21077,"Gallatin County, Kentucky",8652,4420,4232,22508,5790,493,155,22,21,8542,447,415,862,1131,607,524,3656,21,8.28,86.5,2.2884882108183078,13.072122052704577,198,98.7286176606565,42.256125751271384,0.5108645399907535
21079,"Garrard County, Kentucky",17226,8442,8784,24874,12191,1178,548,93,97,17123,865,664,1529,3105,1484,1621,7138,102,5.45,86.2,4.284221525600836,18.025078369905955,738,99.40206664344595,41.4373621270173,0.49007314524555906
21081,"Grant County, Kentucky",24800,12266,12534,20892,15908,1233,590,118,32,24372,1135,1009,2144,5201,2294,2907,9943,25,7.82,85.8,2.9838709677419355,20.971774193548388,740,98.2741935483871,40.09274193548387,0.49459677419354836
21083,"Graves County, Kentucky",37259,18276,18983,22112,25225,2444,1229,286,132,36866,1863,1604,3467,7035,3289,3746,15359,241,5.06,89.4,4.420408491907995,18.88134410478005,1647,98.94522128881613,41.22225502563139,0.4905123594299364
21085,"Grayson County, Kentucky",26129,13079,13050,19520,17689,899,496,268,82,25803,1260,1115,2375,6625,3129,3496,10366,132,7.5,89.4,3.2377817750392284,25.35496957403651,846,98.75234413869647,39.67239465727735,0.5005549389567148
21087,"Green County, Kentucky",11044,5356,5688,23448,7931,488,307,41,35,10924,410,336,746,2068,902,1166,4574,44,8.39,87.7,3.467946396233249,18.725099601593627,383,98.9134371604491,41.41615356754799,0.4849692140528794
21089,"Greenup County, Kentucky",36012,17533,18479,25378,25554,2660,1323,309,98,35605,1449,1233,2682,5846,2671,3175,13354,27,6.15,85.5,4.803954237476397,16.233477729645674,1730,98.86982117072087,37.082083749861155,0.48686548928135065
21091,"Hancock County, Kentucky",8700,4494,4206,22438,5803,365,232,34,15,8653,206,194,400,1353,647,706,3539,16,6.37,87.4,3.2298850574712645,15.551724137931034,281,99.45977011494253,40.67816091954023,0.516551724137931
21093,"Hardin County, Kentucky",107699,53731,53968,26436,70244,9288,6001,888,350,102841,3778,3261,7039,14848,5895,8953,50463,509,6.76,87,6.721510877538324,13.786571834464572,7239,95.48928030900937,46.85558825987242,0.4988997112322306
21095,"Harlan County, Kentucky",27548,13323,14225,15457,19089,1189,722,209,49,27072,1334,1310,2644,9565,4403,5162,7377,0,7.49,81.9,3.557427036445477,34.721213881225495,980,98.2721068680122,26.778713518222737,0.48362857557717437
21097,"Harrison County, Kentucky",18630,9162,9468,22497,12759,1225,481,244,10,18424,1144,783,1927,2992,1225,1767,7769,136,6.44,86,3.9452495974235107,16.060118089103597,735,98.894256575416,41.70155662909286,0.49178743961352656
21099,"Hart County, Kentucky",18531,9138,9393,19715,12494,889,578,99,4,18265,1228,1016,2244,4211,1967,2244,6890,135,8.12,88.8,3.674923101829367,22.724083967405967,681,98.56456748151746,37.18094004640872,0.4931196373644164
21101,"Henderson County, Kentucky",46252,22409,23843,23958,31892,2978,1833,358,191,45303,1837,1199,3036,8719,3822,4897,20543,100,5.58,89.6,5.150047565510681,18.851076710196317,2382,97.94819683473148,44.41537663236184,0.4844979676554527
21103,"Henry County, Kentucky",15677,7715,7962,23932,10691,701,327,86,51,15598,773,689,1462,2825,1191,1634,7042,32,7.21,86.9,2.959749952159214,18.020029342348664,464,99.4960770555591,44.91930854117497,0.49212221726095556
21105,"Hickman County, Kentucky",4625,2156,2469,19764,3297,152,110,35,9,4463,238,136,374,658,248,410,1629,98,5.76,89.1,3.32972972972973,14.227027027027027,154,96.4972972972973,35.22162162162162,0.46616216216216216
21107,"Hopkins County, Kentucky",45985,22353,23632,23288,31931,2879,1475,526,133,44962,2040,2298,4338,7688,3273,4415,18686,221,6.74,90,4.640643688159182,16.718495161465697,2134,97.775361530934,40.63498967054474,0.4860932912906383
21109,"Jackson County, Kentucky",13369,6657,6712,16827,9173,550,273,89,52,13261,739,566,1305,4366,2037,2329,4199,71,6.67,85.5,3.0967162839404594,32.657640810831026,414,99.19216096940684,31.408482309821228,0.497943002468397
21111,"Jefferson County, Kentucky",764378,369391,394987,31039,524906,99063,49792,13329,7241,756073,29070,24764,53834,112275,48854,63421,368848,4430,5.85,87.9,9.205131492533798,14.688413324297665,70362,98.91349567883952,48.25465934393716,0.48325697495218334
21113,"Jessamine County, Kentucky",51667,25213,26454,28195,33487,5790,2904,794,555,51100,2237,1543,3780,8947,3911,5036,23177,124,5.44,86.6,8.23155979638841,17.316662473145335,4253,98.90258772524048,44.85842026825633,0.48799040006193506
21115,"Johnson County, Kentucky",23064,11314,11750,19925,16083,1410,712,211,94,22595,898,702,1600,5439,2498,2941,6735,18,6.15,86.4,4.4094693028095735,23.582206035379812,1017,97.96652792230316,29.201352757544225,0.4905480402358654
21117,"Kenton County, Kentucky",163987,81047,82940,30195,110904,20853,8829,2319,885,162466,6519,4993,11512,20819,9072,11747,80798,709,6.79,85.5,7.337776774988261,12.695518547201912,12033,99.07248745327374,49.27097879709977,0.4942282010159342
21119,"Knott County, Kentucky",15690,7806,7884,17670,10785,619,525,190,52,15525,714,743,1457,4874,2264,2610,4594,112,6.99,86,4.888463989802422,31.064372211599746,767,98.94837476099427,29.279796048438495,0.49751434034416825
21121,"Knox County, Kentucky",31424,15233,16191,15869,21046,967,770,226,134,31073,1764,1462,3226,10583,4790,5793,9101,34,7.08,86.2,3.5959775967413443,33.678080448065174,1130,98.88301934826885,28.961939918533606,0.4847568737270876
21123,"Larue County, Kentucky",14102,6976,7126,21879,9860,614,506,73,11,13821,764,300,1064,2157,783,1374,5956,20,7.02,86.4,4.183803715784995,15.295702737200397,590,98.00737484044816,42.23514395121259,0.494681605446036
21125,"Laurel County, Kentucky",59901,29162,30739,20446,40974,3259,1453,404,213,59108,2847,2064,4911,14479,6651,7828,21975,116,6.99,86.4,3.455701908148445,24.17154972371079,2070,98.67614897914893,36.68553112635849,0.4868366137460143
21127,"Lawrence County, Kentucky",15844,7900,7944,18885,10958,715,423,87,45,15735,858,843,1701,3839,1705,2134,4878,169,7.03,86.4,3.5029033072456452,24.22999242615501,555,99.31204241353194,30.78767987881848,0.4986114617520828
21129,"Lee County, Kentucky",6717,3375,3342,16489,4943,195,214,33,0,6087,240,185,425,1988,790,1198,1685,70,6.87,86.6,3.6772368616942086,29.59654607711776,247,90.62081286288522,25.08560369212446,0.5024564537740063
21131,"Leslie County, Kentucky",10648,5325,5323,15112,7534,386,165,95,28,10376,451,513,964,3572,1748,1824,2675,16,6.68,85.2,2.70473328324568,33.54620586025545,288,97.44552967693464,25.122088655146506,0.5000939143501127
21133,"Letcher County, Kentucky",23011,11267,11744,18085,16385,1035,567,215,92,22833,1027,806,1833,6946,3210,3736,6935,49,7.72,84.7,3.7981834774672985,30.185563426187475,874,99.2264569119117,30.137760201642692,0.4896353917691539
21135,"Lewis County, Kentucky",13565,6748,6817,19346,9518,565,462,84,44,13421,634,601,1235,3487,1623,1864,4452,93,5.85,85.2,4.349428676741614,25.705860670844086,590,98.93844452635459,32.81975672687062,0.49745669001105786
21137,"Lincoln County, Kentucky",24413,11960,12453,19351,16843,1062,581,155,17,24178,1595,1264,2859,5699,2651,3048,9307,24,5.57,85.6,3.084422234055626,23.34411993609962,753,99.03739810756564,38.12313111866629,0.48990292057510343
21139,"Livingston County, Kentucky",9288,4587,4701,24464,6743,406,161,19,15,9229,271,241,512,1488,538,950,3891,56,5.54,89.5,2.099483204134367,16.020671834625322,195,99.36477174849269,41.89276485788114,0.49386304909560724
21141,"Logan County, Kentucky",26847,13131,13716,21465,18311,1863,665,150,30,26559,1359,1186,2545,4610,2077,2533,10612,106,9.28,89.4,3.1474652661377434,17.17137855253846,845,98.92725444183708,39.52769396953104,0.4891049279249078
21143,"Lyon County, Kentucky",8268,4581,3687,27098,6547,519,259,117,22,6895,423,173,596,967,364,603,2768,25,5.74,89.6,4.813739719400097,11.695694242864054,398,83.39380745041123,33.47847121432027,0.5540638606676342
21145,"McCracken County, Kentucky",65285,31169,34116,29881,45970,6875,3046,900,317,64106,2557,1777,4334,10861,4666,6195,28394,300,5.9,89.8,6.529830742130658,16.63628704909244,4263,98.19407214520946,43.49237956651604,0.4774297311786781
21147,"McCreary County, Kentucky",17748,9710,8038,11492,12234,559,284,81,11,16203,898,410,1308,6628,3276,3352,4402,161,8.49,85.6,2.1185485688528285,37.345052963714224,376,91.2947937795808,24.802794681090827,0.5471038990308768
21149,"McLean County, Kentucky",9361,4657,4704,22884,6476,382,229,73,14,9265,429,320,749,1777,838,939,3769,0,6.66,89.9,3.3757077235338104,18.98301463518855,316,98.97446853968593,40.26279243670548,0.4974895844461062
21151,"Madison County, Kentucky",88376,42976,45400,23733,53820,9966,4469,748,1137,87531,3337,2737,6074,15983,7354,8629,40427,636,5.86,86.3,7.189734769620712,18.085226758395944,6354,99.04385806101205,45.744319724812165,0.48628586946682356
21153,"Magoffin County, Kentucky",12783,6436,6347,17279,8805,424,250,216,3,12658,493,412,905,3603,1885,1718,3591,12,6.35,86.2,3.6689353047015567,28.18587186106548,469,99.02213877806462,28.09199718375968,0.50348118595009
21155,"Marion County, Kentucky",19335,9799,9536,21823,13137,926,614,109,54,18573,850,670,1520,3406,1417,1989,7513,45,7.29,86.6,4.018619084561676,17.61572278251875,777,96.05896043444531,38.85699508663046,0.5068011378329454
21157,"Marshall County, Kentucky",31177,15319,15858,27391,22633,2235,1333,299,99,30628,867,907,1774,3286,1627,1659,12913,196,5.32,89.7,5.552169868813548,10.539821021907175,1731,98.2390865060782,41.418353273246304,0.49135580716553867
21159,"Martin County, Kentucky",12175,6744,5431,14914,8547,373,225,83,19,10748,675,660,1335,3190,1437,1753,2799,5,7.57,87.1,2.6858316221765914,26.20123203285421,327,88.27926078028747,22.989733059548254,0.5539219712525667
21161,"Mason County, Kentucky",17167,8429,8738,25285,11689,1109,792,201,55,16858,830,711,1541,3011,1362,1649,7039,37,6.96,85.6,6.104735830372226,17.53946525310188,1048,98.20003495077765,41.00308731869284,0.4910001747538883
21163,"Meade County, Kentucky",28452,14477,13975,25119,19235,1989,1205,112,35,27457,1138,997,2135,3678,1657,2021,12271,56,6.92,87.2,4.75186278644735,12.927035006326445,1352,96.50288204695627,43.12877829326585,0.5088218754393364
21165,"Menifee County, Kentucky",6381,3382,2999,19744,4668,338,145,15,32,6306,223,156,379,1258,560,698,2462,0,7.04,85.1,3.0089327691584393,19.714778247923523,192,98.82463563704748,38.583294154521234,0.5300109700673875
21167,"Mercer County, Kentucky",21378,10652,10726,24981,14944,1406,940,86,112,21209,973,647,1620,3526,1509,2017,9427,24,6.39,86.8,5.323229488258958,16.493591542707456,1138,99.20946767705118,44.09673496117504,0.4982692487604079
21169,"Metcalfe County, Kentucky",9990,4930,5060,18449,6925,391,365,60,23,9891,550,430,980,2275,924,1351,3871,26,8.54,88.6,4.484484484484485,22.772772772772772,448,99.009009009009,38.748748748748746,0.4934934934934935
21171,"Monroe County, Kentucky",10645,5322,5323,21985,7414,592,334,84,84,10510,531,501,1032,2469,1122,1347,4184,6,6.84,88.6,4.715829027712541,23.193987787693754,502,98.73179896665101,39.30483795209018,0.49995302959135746
21173,"Montgomery County, Kentucky",27550,13645,13905,21371,18653,1836,1024,256,49,27222,1601,1119,2720,6238,2904,3334,11212,52,6.36,86,4.823956442831216,22.64246823956443,1329,98.80943738656987,40.69691470054446,0.49528130671506354
21175,"Morgan County, Kentucky",13281,7397,5884,17089,9834,644,378,136,40,11636,446,324,770,2951,1366,1585,3488,40,6.53,85.6,4.17137263760259,22.219712371056396,554,87.61388449664935,26.263082599201866,0.5569610722084181
21177,"Muhlenberg County, Kentucky",31153,15763,15390,20376,21552,1306,773,323,30,30321,1539,976,2515,6215,2828,3387,11155,107,7.32,89.7,3.614419157063525,19.949924565852406,1126,97.32931017879498,35.807145379257214,0.5059865823516194
21179,"Nelson County, Kentucky",45131,22276,22855,28156,30234,3352,1397,344,191,44838,1350,1394,2744,5105,2198,2907,20732,82,7.09,86.7,4.280871241496976,11.311515366377877,1932,99.35077884381025,45.93738228711972,0.4935853404533469
21181,"Nicholas County, Kentucky",7061,3362,3699,21519,4810,254,160,45,43,6964,407,404,811,1919,875,1044,2760,6,5.81,85.8,3.5122503894632486,27.177453618467638,248,98.62625690412123,39.08794788273616,0.47613652457159045
21183,"Ohio County, Kentucky",24062,11957,12105,21368,16486,911,517,265,116,23720,952,868,1820,5023,2195,2828,9207,38,7.2,89.5,3.732025600531959,20.87523896600449,898,98.57867176460809,38.26365223173469,0.49692461142049704
21185,"Oldham County, Kentucky",64633,33876,30757,38063,42779,10430,4961,1314,565,60638,1415,911,2326,3412,1275,2137,30044,182,6.72,87.5,10.582829204895333,5.279037024430244,6840,93.81894697755017,46.48399424442622,0.5241285411477109
21187,"Owen County, Kentucky",10686,5239,5447,22802,7401,479,211,24,0,10628,373,399,772,1754,905,849,3870,48,7.31,86.4,2.199139060452929,16.413999625678457,235,99.4572337638031,36.215609208309935,0.4902676399026764
21189,"Owsley County, Kentucky",4497,1955,2542,16582,3095,206,208,56,16,4422,136,180,316,1451,606,845,1239,47,6.54,86.9,6.226373137647321,32.265955081165224,280,98.33222148098733,27.55170113408939,0.434734267289304
21191,"Pendleton County, Kentucky",14530,7307,7223,23191,10055,721,406,101,17,14433,545,390,935,2163,894,1269,6289,0,7.29,86,3.6063317274604265,14.886441844459739,524,99.3324156916724,43.282863041982104,0.5028905712319339
21193,"Perry County, Kentucky",27329,13516,13813,19890,19143,1120,847,261,181,26713,1244,1112,2356,6918,3105,3813,8530,394,6.82,86,4.716601412419042,25.313769256101576,1289,97.74598411943357,31.212265359142304,0.4945662117164916
21195,"Pike County, Kentucky",61586,30063,31523,20576,43282,2963,1762,620,278,60871,2498,2139,4637,15957,7145,8812,19727,208,8.62,87.6,4.3191634462377815,25.910109440457248,2660,98.83902185561654,32.03163056538824,0.4881466567076933
21197,"Powell County, Kentucky",12349,6075,6274,19302,8358,575,498,28,20,12096,547,507,1054,2875,1058,1817,4407,48,7.28,86,4.421410640537696,23.281237347153617,546,97.95125111345048,35.68710017005426,0.49194266742246334
21199,"Pulaski County, Kentucky",63974,31404,32570,21036,44738,4059,1908,605,238,63214,2740,2001,4741,15873,7589,8284,24298,337,7.12,86.2,4.300184449932785,24.8116422296558,2751,98.81201738206147,37.98105480351393,0.49088692281239255
21201,"Robertson County, Kentucky",2161,1098,1063,21764,1543,205,40,21,0,2099,68,98,166,638,297,341,867,4,6.02,85.9,2.822767237390097,29.52336881073577,61,97.1309578898658,40.12031466913466,0.5080981027302175
21203,"Rockcastle County, Kentucky",16815,8168,8647,19750,11794,805,483,106,4,16524,548,414,962,3464,1519,1945,6206,57,6.75,85.3,3.5266131430270593,20.600654177817425,593,98.26940231935771,36.90752304490039,0.4857567647933393
21205,"Rowan County, Kentucky",24392,11727,12665,19032,13920,1470,1417,389,444,24171,997,990,1987,5686,2524,3162,9973,93,7.05,84.4,9.224335847818956,23.310921613643817,2250,99.09396523450312,40.886356182354874,0.48077238438832404
21207,"Russell County, Kentucky",17731,8630,9101,18857,12466,965,484,181,45,17563,1073,787,1860,4419,1986,2433,6159,14,8.79,86.8,4.0042862782696975,24.92245220235745,710,99.05250690880379,34.73577350403249,0.4867181772037674
21209,"Scott County, Kentucky",52322,25858,26464,30702,33953,5761,2648,723,420,52042,1979,2083,4062,5837,2512,3325,26444,157,6.12,86.3,7.245518137685869,11.155919116241733,3791,99.4648522609992,50.54088146477581,0.49420893696724133
21211,"Shelby County, Kentucky",45831,22151,23680,30240,31052,4447,2430,456,211,44672,2504,1965,4469,5527,2696,2831,21738,281,6.1,87,6.7574349239597655,12.059523030263358,3097,97.47114398551199,47.4307782941677,0.4833191507931313
21213,"Simpson County, Kentucky",17881,8883,8998,22663,12102,1176,482,133,42,17536,923,715,1638,3028,1259,1769,7697,153,8.2,89.4,3.674291147027571,16.9341759409429,657,98.07057770818187,43.04569095688161,0.4967842961803031
21215,"Spencer County, Kentucky",18012,9193,8819,30779,12562,1453,833,168,32,17887,558,492,1050,1556,673,883,8929,106,6.56,87.2,5.735065511880968,8.63868532089718,1033,99.30601821008217,49.57250721741062,0.5103819675771708
21217,"Taylor County, Kentucky",25406,12381,13025,19885,16512,1675,886,329,221,25008,1240,1120,2360,5593,2372,3221,10095,126,7.91,86.7,5.652208139809494,22.014484767377784,1436,98.43344091946784,39.7347083366134,0.48732582854443834
21219,"Todd County, Kentucky",12377,6194,6183,19555,8075,564,324,101,25,12137,1044,1101,2145,2438,1101,1337,4702,76,7.27,88.8,3.6357760361961704,19.697826613880586,450,98.06091944736204,37.98981982709865,0.5004443726266462
21221,"Trigg County, Kentucky",14286,7053,7233,26224,10227,1056,496,115,63,14215,837,835,1672,2213,884,1329,5663,55,6.4,88.5,4.717905641887162,15.490690186196277,674,99.5030099398012,39.640207195856085,0.49370012599748003
21223,"Trimble County, Kentucky",8697,4265,4432,26542,6044,403,251,42,19,8674,365,278,643,1302,651,651,3773,59,9.17,86.7,3.587443946188341,14.970679544670576,312,99.73554099114637,43.382775669771185,0.4903989881568357
21225,"Union County, Kentucky",14915,7760,7155,21758,9722,609,393,56,43,14748,642,442,1084,3326,1721,1605,6404,72,6.44,89.9,3.298692591350989,22.299698290311767,492,98.88032182366744,42.936640965471,0.5202815957090178
21227,"Warren County, Kentucky",123824,60616,63208,25840,74913,13718,6495,1505,1049,122496,5300,3871,9171,20945,9319,11626,57707,324,8,90.3,7.30795322393074,16.915137614678898,9049,98.92751001421372,46.60405091097041,0.48953353146401346
21229,"Washington County, Kentucky",11999,5873,6126,22611,7983,633,631,138,14,11873,609,454,1063,1985,1031,954,5483,40,6.96,86.8,6.525543795316277,16.543045253771147,783,98.94991249270772,45.69547462288524,0.489457454787899
21231,"Wayne County, Kentucky",20692,10320,10372,17627,14446,856,597,192,0,20408,1064,968,2032,4724,2342,2382,6948,39,7.95,86.2,3.8130678523100716,22.83007925768413,789,98.62748888459308,33.57819447129325,0.4987434757394162
21233,"Webster County, Kentucky",13180,6502,6678,21150,9066,542,222,45,8,12851,639,505,1144,2739,1208,1531,4952,25,5.89,90.2,2.08649468892261,20.781487101669196,275,97.50379362670714,37.57207890743551,0.4933232169954476
21235,"Whitley County, Kentucky",36027,17686,18341,18463,23150,2503,1559,348,196,35396,1648,1229,2877,8569,3694,4875,12496,48,7.43,85.6,5.837288700141561,23.784939073472675,2103,98.24853582035695,34.685097288145,0.490909595581092
21237,"Wolfe County, Kentucky",7251,3522,3729,13533,5045,194,178,9,10,7119,294,277,571,2626,1231,1395,1867,35,7.14,85.9,2.716866639084264,36.215694386981106,197,98.1795614398014,25.748172665839196,0.4857261067438974
21239,"Woodford County, Kentucky",25817,12356,13461,31208,17839,3480,1571,524,271,25675,1081,879,1960,3680,1493,2187,12863,66,5.87,86.9,9.164504008986327,14.254173606538327,2366,99.44997482279119,49.823759538288726,0.478599372506488
22001,"Acadia Parish, Louisiana",62607,30433,32174,21591,40193,3350,1143,271,140,61694,3985,4373,8358,13196,4922,8274,24338,463,12.2,90.6,2.4821505582442858,21.077515293816987,1554,98.54169661539444,38.87424728864185,0.4860958039835801
22003,"Allen Parish, Louisiana",25667,14542,11125,20103,17898,1424,624,249,55,21250,1198,1138,2336,3518,1553,1965,8395,184,14.42,90.1,3.6155374605524604,13.706315502396073,928,82.79113258269373,32.707367436786534,0.5665640705964857
22005,"Ascension Parish, Louisiana",119129,58718,60411,31520,76658,14763,4755,1068,535,118306,5723,4391,10114,13824,5105,8719,56461,435,14.36,91.2,5.337071577869368,11.604227350183415,6358,99.30915226351266,47.394840886769806,0.49289425748558285
22007,"Assumption Parish, Louisiana",22881,11085,11796,25765,15572,1070,485,40,15,22676,1527,1389,2916,3547,1454,2093,9164,168,14.81,91.2,2.3600367116821817,15.50194484506796,540,99.10406013723177,40.050697084917616,0.4844630916480923
22009,"Avoyelles Parish, Louisiana",41095,20693,20402,20199,27863,2219,633,212,79,37485,2643,2524,5167,8863,3594,5269,14388,250,10.9,91.5,2.248448716388855,21.567100620513443,924,91.2154763353206,35.011558583769315,0.5035405767124954
22011,"Beauregard Parish, Louisiana",36598,18631,17967,24551,24302,2804,810,266,85,35941,2843,2494,5337,6246,2901,3345,14134,456,20.33,91.1,3.1723044975135255,17.06650636646811,1161,98.2048199355156,38.61959669927318,0.5090715339636046
22013,"Bienville Parish, Louisiana",13806,6692,7114,22701,9614,751,329,62,48,13478,1015,973,1988,3409,1402,2007,4950,38,10.74,93.2,3.179776908590468,24.692162827756047,439,97.62422135303491,35.853976531942635,0.48471678980153554
22015,"Bossier Parish, Louisiana",125698,62214,63484,27235,82058,13583,5692,1128,675,119547,6408,5513,11921,20009,8552,11457,58920,626,8.04,93.5,5.962704259415425,15.918312144982417,7495,95.10652516348709,46.874254164744066,0.4949482091998282
22017,"Caddo Parish, Louisiana",251069,119235,131834,25565,167590,25380,9606,3403,1772,246699,15160,15271,30431,57607,24700,32907,104472,545,7.99,93.7,5.887226220680371,22.94468851192302,14781,98.2594426233426,41.610871911705544,0.47490928788500375
22019,"Calcasieu Parish, Louisiana",198753,96906,101847,26569,130718,19062,6717,1724,893,196471,12415,12077,24492,32789,13549,19240,88795,1029,25.36,91.3,4.696281313992745,16.497361046122574,9334,98.85184123006948,44.67605520419818,0.4875699989434122
22021,"Caldwell Parish, Louisiana",10000,5313,4687,20961,6804,575,181,85,0,9443,994,796,1790,2471,1304,1167,3400,78,7.28,92,2.66,24.71,266,94.43,34,0.5313
22023,"Cameron Parish, Louisiana",6806,3289,3517,29681,4718,469,77,12,9,6779,380,333,713,590,276,314,3097,88,28.72,90,1.4399059653247135,8.668821627975316,98,99.60329121363503,45.50396708786365,0.4832500734645901
22025,"Catahoula Parish, Louisiana",10044,5359,4685,20717,6852,733,175,25,19,9017,945,904,1849,1964,794,1170,3500,51,8.16,91.6,2.1804062126642774,19.553962564715253,219,89.77499004380725,34.84667463162087,0.533552369573875
22027,"Claiborne Parish, Louisiana",16296,9360,6936,16384,11928,1102,465,76,21,14313,1155,730,1885,4263,2200,2063,5188,16,8.62,91.9,3.4486990672557685,26.15979381443299,562,87.83136966126656,31.836033382425136,0.5743740795287187
22029,"Concordia Parish, Louisiana",20211,10319,9892,17551,13563,1106,351,48,35,18164,1880,2497,4377,5659,2463,3196,6690,66,8.1,91.4,2.1473455049230616,27.999604175943794,434,89.87185196180297,33.10078670031171,0.5105635545000248
22031,"De Soto Parish, Louisiana",27164,13154,14010,23471,18322,1655,612,156,57,26970,1718,1768,3486,7092,3363,3729,10206,27,13.93,93.2,3.0371079369754086,26.108084229126785,825,99.28581946694155,37.571786187601234,0.48424385215726695
22033,"East Baton Rouge Parish, Louisiana",446167,214073,232094,30162,279844,60801,23144,6757,5788,443233,26209,21235,47444,83483,37265,46218,212556,1244,11.31,90.7,7.9990227874316115,18.711155240078266,35689,99.34239869824528,47.640457496856556,0.47980464713885157
22035,"East Carroll Parish, Louisiana",7318,4409,2909,14694,4819,359,83,7,22,4991,297,416,713,2398,873,1525,1677,2,7.37,91.4,1.5304728067778082,32.76851598797486,112,68.20169445203608,22.916097294342716,0.6024870183110139
22037,"East Feliciana Parish, Louisiana",19553,10667,8886,21138,14115,1236,307,92,67,16358,861,1063,1924,2928,1433,1495,6809,0,11.1,90.5,2.3832659949879815,14.97468419168414,466,83.65979645067253,34.82330077226001,0.5455428834449957
22039,"Evangeline Parish, Louisiana",33750,17232,16518,18655,21672,2082,516,161,34,32192,2259,1677,3936,8454,3817,4637,11230,171,11.03,90.8,2.1066666666666665,25.04888888888889,711,95.3837037037037,33.27407407407407,0.5105777777777778
22041,"Franklin Parish, Louisiana",20388,9991,10397,18786,13488,1037,435,36,33,19059,1666,1550,3216,5481,2280,3201,7026,164,7.15,92.2,2.472042377869335,26.883460859329016,504,93.48145968216598,34.46144791053561,0.49004316264469294
22043,"Grant Parish, Louisiana",22305,12669,9636,18509,15688,924,317,43,42,18907,1144,888,2032,3813,1690,2123,7062,188,10.91,91.9,1.8022864828513787,17.094821788836583,402,84.76574759022641,31.661062542030933,0.5679892400806994
22045,"Iberia Parish, Louisiana",73346,35791,37555,23410,47244,4234,1105,344,312,72549,5243,4840,10083,14695,6296,8399,29927,358,15.76,90,2.4009489270035176,20.035175742371774,1761,98.913369508903,40.80249775038857,0.48797480435197554
22047,"Iberville Parish, Louisiana",33122,16772,16350,22252,22986,2470,697,131,140,29690,1915,1334,3249,5708,2329,3379,12637,230,14.26,90.7,2.922528832799952,17.23325886117988,968,89.63830686552744,38.15288931827788,0.5063703882615784
22049,"Jackson Parish, Louisiana",15952,8086,7866,20109,11212,1030,304,82,42,14713,949,824,1773,3726,1604,2122,5383,67,8.34,92.5,2.683049147442327,23.357572718154465,428,92.23294884653961,33.74498495486459,0.5068956870611836
22051,"Jefferson Parish, Louisiana",437038,212326,224712,28839,305277,51200,16523,6568,2554,433725,32987,26465,59452,70702,29868,40834,206895,2133,15.17,89.9,5.867910799518578,16.177540625757942,25645,99.24194234826263,47.340277046847184,0.48582960749408516
22053,"Jefferson Davis Parish, Louisiana",31405,15431,15974,23068,20717,2084,966,157,57,30901,1499,1886,3385,6025,2417,3608,11919,411,17.69,90.5,3.7573634771533198,19.184843177837923,1180,98.39516000636841,37.952555325585095,0.4913548797962108
22055,"Lafayette Parish, Louisiana",238230,116361,121869,30656,157351,34741,10486,3035,1742,236010,14992,14249,29241,38761,16909,21852,117426,1119,13.37,90.9,6.406833732107627,16.270410947403768,15263,99.06812743986903,49.291021281954414,0.48843974310540234
22057,"Lafourche Parish, Louisiana",98112,48235,49877,26331,65714,7468,2198,584,456,97260,6129,5775,11904,15299,6666,8633,42029,2072,16.43,89.9,3.3003098499673844,15.59340345727332,3238,99.1316046966732,42.837777234181345,0.4916320123939987
22059,"LaSalle Parish, Louisiana",14930,7691,7239,18836,10033,939,223,32,32,13529,905,788,1693,3351,1392,1959,4727,144,9.2,91.4,1.9223040857334226,22.44474212993972,287,90.61620897521769,31.661085063630274,0.5151373074346952
22061,"Lincoln Parish, Louisiana",47536,23206,24330,21934,25668,5403,2665,414,808,46893,3271,2553,5824,13771,6375,7396,20941,178,7.44,92.3,8.176960619320095,28.96962302255133,3887,98.64734096263884,44.05292830696735,0.48817738135307975
22063,"Livingston Parish, Louisiana",137096,67159,69937,27280,89530,11035,3327,708,515,136051,7949,7633,15582,17959,7736,10223,60962,297,13.21,91.2,3.3188422711092955,13.099579856450955,4550,99.2377604014705,44.46665110579448,0.48986841337456966
22065,"Madison Parish, Louisiana",11616,5786,5830,15134,7691,698,274,23,36,9978,1222,1436,2658,3591,1552,2039,3678,36,9.01,91.5,2.8667355371900825,30.914256198347108,333,85.89876033057851,31.66322314049587,0.4981060606060606
22067,"Morehouse Parish, Louisiana",26290,12505,13785,18776,17490,1896,290,180,58,25514,1750,1659,3409,7022,2944,4078,9271,93,7.96,92.2,2.00836820083682,26.709775580068467,528,97.04830734119437,35.26435907189045,0.47565614302015974
22069,"Natchitoches Parish, Louisiana",39051,18610,20441,18219,23158,2867,1309,118,200,38338,2426,2813,5239,12179,5141,7038,12766,157,14.49,93.1,4.166346572430924,31.187421576912243,1627,98.17418247932191,32.690584107961385,0.4765562981741825
22071,"Orleans Parish, Louisiana",388182,185063,203119,29275,271570,56258,25675,11727,5410,382251,25759,21660,47419,95346,41409,53937,175114,2094,11.63,90.2,11.028847293279956,24.562189900613628,42812,98.4721084439773,45.11131376519261,0.47674286803612737
22073,"Ouachita Parish, Louisiana",156433,75019,81414,22538,100338,16303,6163,1195,745,150783,9546,10041,19587,36450,14975,21475,63315,422,7.66,92.2,5.179853355749746,23.30071020820415,8103,96.38823010490114,40.47419662091758,0.4795599393989759
22075,"Plaquemines Parish, Louisiana",23394,11393,12001,26177,15233,2074,656,133,73,22467,1338,1117,2455,4437,1633,2804,10353,69,12.75,88.8,3.6847054800376164,18.966401641446524,862,96.03744549884586,44.254937163375224,0.48700521501239635
22077,"Pointe Coupee Parish, Louisiana",22271,10692,11579,27160,15416,1728,500,163,44,22144,1835,1278,3113,3843,1767,2076,9228,408,11.49,90.8,3.1745319024740692,17.25562390552737,707,99.42975169502941,41.43505006510709,0.48008621076736563
22079,"Rapides Parish, Louisiana",132080,63888,68192,23486,86803,11153,4295,1191,794,129374,8411,7252,15663,25112,11163,13949,52711,955,12.25,91.8,4.754694124772865,19.012719563900667,6280,97.951241671714115,39.90838885523925,0.4837068443367656
22081,"Red River Parish, Louisiana",8723,4192,4531,25154,5790,542,317,17,30,8586,599,535,1134,1737,700,1037,3296,135,13.44,93.7,4.172876304023845,19.912874011234667,364,98.42943941304597,37.785165654018115,0.4805686117161527
22083,"Richland Parish, Louisiana",20619,10028,10591,19975,13873,1379,554,151,47,19793,2438,1610,4048,5567,2478,3089,7977,77,7.28,92.1,3.647121586885882,26.999369513555457,752,95.99398612929822,38.68761821620835,0.4863475435278142
22085,"Sabine Parish, Louisiana",24145,11997,12148,22980,16495,1571,603,119,42,23761,1766,1551,3317,4639,1859,2780,8167,226,18.14,92.6,3.16421619382895,19.213087595775523,764,98.40960861462,33.824808448954236,0.4968730586042659
22087,"St. Bernard Parish, Louisiana",45067,22256,22811,20431,29010,2776,500,155,69,44760,3036,2495,5531,8801,3692,5109,18102,228,12.16,89.2,1.6064969933654336,19.528701710786162,724,99.31879202076908,40.16686267113409,0.4938425011649322
22089,"St. Charles Parish, Louisiana",52728,25901,26827,30378,34811,5842,1702,89,114,52057,2658,2613,5271,6337,2606,3731,24229,281,16.12,90.8,3.612881201638598,12.018282506448188,1905,98.72743134577455,45.95091791837354,0.49121908663328784
22091,"St. Helena Parish, Louisiana",10509,5093,5416,21148,7212,410,300,69,28,10367,1091,729,1820,2719,1198,1521,3558,29,11.33,91,3.7777143400894473,25.873061185650396,397,98.64877723855743,33.85669426206109,0.48463222000190315
22093,"St. James Parish, Louisiana",21485,10340,11145,25724,14532,1435,514,43,41,21275,1443,1392,2835,3316,1245,2071,9055,168,14.13,91.4,2.783337212008378,15.434023737491273,598,99.0225738887596,42.14568303467536,0.481265999534559
22095,"St. John the Baptist Parish, Louisiana",43565,21285,22280,23380,28678,3382,1017,161,136,42910,3061,2391,5452,7643,3115,4528,19001,303,14.87,91.4,3.0161827154826124,17.543899919660277,1314,98.49649948353036,43.615287501434636,0.4885802823367382
22097,"St. Landry Parish, Louisiana",83580,40144,43436,19205,53648,4940,1730,374,210,82485,5216,5212,10428,22942,9778,13164,29958,237,10.34,90.9,2.7686049294089496,27.449150514477147,2314,98.68987796123474,35.843503230437904,0.48030629337162
22099,"St. Martin Parish, Louisiana",53609,26445,27164,23654,35653,3834,985,141,101,53363,3685,3236,6921,9367,4024,5343,23282,223,14.22,90.8,2.2887947919192673,17.472812400902832,1227,99.54112182655898,43.429274935178796,0.4932940364491037
22101,"St. Mary Parish, Louisiana",52578,26153,26425,22212,35118,2649,840,209,36,51764,3732,3185,6917,10046,4660,5386,20706,407,16.35,89.9,2.063600745558979,19.10685077408802,1085,98.451823956788,39.381490357183615,0.49741336680740994
22103,"St. Tammany Parish, Louisiana",249201,121268,127933,33149,169108,35597,12299,4515,2619,246763,13592,11912,25504,26554,11195,15359,113406,1683,13.41,91,7.798122800470303,10.655655474897774,19433,99.02167326776377,45.507843066440344,0.486627260725278
22105,"Tangipahoa Parish, Louisiana",128850,62548,66302,23520,82990,11679,3447,768,605,128049,9132,7678,16810,27355,12008,15347,55078,582,12.14,91.4,3.7407838571982928,21.23011253395421,4820,99.37834691501746,42.74582848273186,0.4854326736515328
22107,"Tensas Parish, Louisiana",4771,2322,2449,16194,3267,218,79,9,11,4753,692,471,1163,1808,883,925,1467,28,8.13,91.8,2.075036679941312,37.89561936700901,99,99.62272060364704,30.748270802766715,0.4866904212953259
22109,"Terrebonne Parish, Louisiana",113067,55794,57273,24017,73719,7936,1847,691,170,111739,8607,7570,16177,22272,9820,12452,46549,1276,17.87,90.4,2.395040108961943,19.698055135450662,2708,98.8254751607454,41.169395137396414,0.4934596301308074
22111,"Union Parish, Louisiana",22537,11212,11325,20742,15586,1393,464,56,77,22046,1426,1765,3191,4801,2087,2714,8312,35,7.57,92.3,2.648977237431779,21.30274659448906,597,97.8213604295159,36.881572525180815,0.4974930114922128
22113,"Vermilion Parish, Louisiana",59841,29021,30820,23608,39293,3570,1032,113,37,59402,3764,3565,7329,10517,4402,6115,24396,321,17.2,90.5,1.9752343710833709,17.574906836449927,1182,99.26638926488528,40.76803529352785,0.4849684998579569
22115,"Vernon Parish, Louisiana",51906,27614,24292,22583,31124,3841,1282,234,146,46516,2873,2130,5003,8433,3719,4714,21957,221,17.28,91.5,3.2019419720263556,16.246676684776325,1662,89.61584402573884,42.30146803837707,0.532000154124764
22117,"Washington Parish, Louisiana",46449,22944,23505,18345,31449,2511,1089,159,79,44595,3255,3609,6864,11679,5356,6323,15914,305,14.94,90.6,2.8568968115567612,25.143706000129175,1327,96.00852547955823,34.26123274989774,0.4939611186462572
22119,"Webster Parish, Louisiana",40043,19435,20608,19256,27475,3068,983,137,59,39092,2818,2514,5332,9697,4079,5618,15275,73,9.64,92.8,2.9443348400469493,24.216467297655022,1179,97.62505306795195,38.14649252054042,0.48535324526134405
22121,"West Baton Rouge Parish, Louisiana",25518,12631,12887,28140,17048,2304,821,235,64,24763,1546,1017,2563,4417,1985,2432,11833,101,11.55,90.7,4.389058703660162,17.30935026255976,1120,97.04130417744338,46.371188964652404,0.4949839329101027
22123,"West Carroll Parish, Louisiana",11274,5696,5578,22857,7731,550,276,62,36,10683,1211,1269,2480,2344,923,1421,3746,50,7.21,91.7,3.317367394003903,20.791200993436224,374,94.7578499201703,33.2268937378038,0.5052332801135355
22125,"West Feliciana Parish, Louisiana",15376,10210,5166,23041,10499,1510,628,121,153,12074,383,417,800,1504,664,840,5384,6,11.44,90.5,5.866285119667014,9.781477627471384,902,78.52497398543184,35.0156087408949,0.6640218522372529
22127,"Winn Parish, Louisiana",14631,7712,6919,18417,10250,911,277,85,68,12833,943,940,1883,3498,1495,2003,4955,44,10.51,92.4,2.938965210853667,23.90814025015378,430,87.7110245369421,33.86644795297656,0.5270999931651972
23001,"Androscoggin County, Maine",107317,52550,54767,26276,74251,10984,3783,1012,650,106275,5097,4099,9196,14910,6731,8179,52083,173,7.49,78.8,5.073753459377358,13.893418563694475,5445,99.02904479253054,48.531919453581445,0.4896707884119012
23003,"Aroostook County, Maine",68840,34006,34834,23631,50614,6514,2046,476,329,67685,3353,2721,6074,11673,5346,6327,29630,261,6.82,76,4.141487507263219,16.956711214410227,2851,98.32219639744335,43.041836141778035,0.4939860546194073
23005,"Cumberland County, Maine",289173,140510,148663,36780,207097,58303,24268,6885,3790,285941,11284,8451,19735,29984,13770,16214,154757,1053,6.54,79,12.083769923194765,10.368879528863344,34943,98.88232995473298,53.51709876094933,0.48590290241481743
23007,"Franklin County, Maine",30177,14739,15438,24162,21506,3601,1455,305,242,30019,1466,1563,3029,3580,1576,2004,14150,103,9.4,74.1,6.634191602876363,11.86333962951917,2002,99.47642244093184,46.89001557477549,0.4884183318421314
23009,"Hancock County, Maine",54468,26394,28074,31178,41108,7879,3775,803,844,54028,3780,2994,6774,6137,2704,3433,25821,252,6.96,77.6,9.95446867885731,11.267166042446942,5422,99.19218623779099,47.405816259087906,0.4845781009032827
23011,"Kennebec County, Maine",121289,59175,62114,27336,86934,14228,6622,1116,1220,119783,5458,3934,9392,16623,7646,8977,57198,349,7.35,78.5,7.3856656415668365,13.705282424622183,8958,98.75833752442513,47.158439759582485,0.4878843093767778
23013,"Knox County, Maine",39700,19601,20099,29806,29829,5873,2359,448,420,38577,2426,1778,4204,4469,2207,2262,18966,143,6.38,75.3,8.128463476070529,11.256926952141058,3227,97.17128463476071,47.77329974811083,0.493727959697733
23015,"Lincoln County, Maine",34021,16599,17422,31522,26018,4875,2645,516,573,33533,2094,1624,3718,3933,1790,2143,16276,216,6.76,76.9,10.975573910231915,11.560506745833456,3734,98.56559184033391,47.84103935804356,0.4879045295552747
23017,"Oxford County, Maine",57230,28290,28940,22862,41940,5125,2165,371,224,56902,3146,2752,5898,8588,3618,4970,24861,110,8.06,76.4,4.822645465664861,15.006115673597764,2760,99.4268740171239,43.44050323257033,0.49432116023064826
23019,"Penobscot County, Maine",152284,75404,76880,26347,106947,17833,6928,1540,1749,150671,8376,7178,15554,23119,10994,12125,71443,634,6.81,77.9,6.709174962569935,15.181502981271834,10217,98.94079483071104,46.91431798481784,0.4951537915999054
23021,"Piscataquis County, Maine",16960,8452,8508,23464,12933,1599,566,106,35,16824,1079,991,2070,3113,1322,1791,6326,44,7.25,75.3,4.168632075471698,18.35495283018868,707,99.19811320754717,37.299528301886795,0.4983490566037736
23023,"Sagadahoc County, Maine",35149,16942,18207,32947,25875,5701,2312,553,357,35015,1409,1037,2446,3952,1741,2211,17966,75,7.02,78.3,9.16669037525961,11.243563117016132,3222,99.6187658254858,51.113829696435175,0.4820051779566986
23025,"Somerset County, Maine",50994,25180,25814,22641,37451,4418,1243,386,174,50499,3123,2568,5691,8928,4020,4908,21808,331,7.44,74.6,3.53571008353924,17.50794211083657,1803,99.02929756441934,42.76581558614739,0.49378358238224107
23027,"Waldo County, Maine",39280,19269,20011,27763,28776,5596,2385,351,376,39073,2251,2070,4321,5495,2430,3065,18037,97,6.3,77,7.922606924643585,13.989307535641547,3112,99.47301425661914,45.919042769857434,0.4905549898167006
23029,"Washington County, Maine",31822,15714,16108,24311,23436,3210,1172,285,238,31231,2141,1798,3939,5599,2344,3255,12491,132,7.48,76.8,5.326503676701653,17.594745773364338,1695,98.14279429325624,39.252718245239144,0.4938093143108541
23031,"York County, Maine",201454,98215,103239,33635,146371,30093,11402,2107,1588,199598,9589,7145,16734,16801,7084,9717,103520,734,6.28,79.1,7.494018485609618,8.339869151270266,15097,99.07869786651047,51.38642072135574,0.4875306521588055
24001,"Allegany County, Maryland",72591,37892,34699,22355,50489,4888,3389,425,496,67219,2474,1505,3979,10916,5294,5622,28108,146,7.31,85.6,5.937375156699867,15.037676846992051,4310,92.5996335633894,38.72105357413454,0.5219930845421609
24003,"Anne Arundel County, Maryland",564600,279581,285019,43258,387306,90536,47889,10043,6929,543507,16884,12284,29168,33246,14595,18651,296978,2163,7.85,88.5,11.487956075097413,5.888416578108395,64861,96.26408076514346,52.599716613531704,0.4951842012043925
24005,"Baltimore County, Maryland",828637,392930,435707,37270,573263,125363,64306,16637,10487,820479,30774,24267,55041,73560,31293,42267,412831,4218,6.77,86.8,11.033781981736272,8.877228508985237,91430,99.015491705053,49.82048834411208,0.4741883357851508
24009,"Calvert County, Maryland",90824,45184,45640,41469,61269,10564,6245,949,672,89636,2627,2085,4712,5114,2204,2910,45262,309,7.52,87.8,8.660706421210254,5.630670307407733,7866,98.69197568924514,49.83484541530873,0.49748965031269266
24011,"Caroline County, Maryland",32785,15971,16814,25355,22216,2182,1208,160,128,32405,1617,1080,2697,5337,2154,3183,15387,162,7.73,89.1,4.563062376086625,16.278786030196738,1496,98.84093335366784,46.933048650297394,0.48714351075186824
24013,"Carroll County, Maryland",167319,82784,84535,39690,115213,25023,11620,2021,1197,165274,3500,2573,6073,8993,3972,5021,86849,307,7.9,85.7,8.868090294586986,5.374763176925514,14838,98.77778375438534,51.906238980629816,0.4947674800829553
24015,"Cecil County, Maryland",102416,50878,51538,32542,69969,9632,4889,798,775,101361,3202,2353,5555,9533,4449,5084,49958,571,7.13,85.3,6.309561006092798,9.308115919387596,6462,98.96988751757537,48.77948758006561,0.49677784721137325
24017,"Charles County, Maryland",156021,75368,80653,38890,103318,17540,9740,1267,897,152781,3606,2612,6218,10666,4243,6423,79070,397,7.21,89.1,7.629742150095179,6.836259221515053,11904,97.92335647124426,50.679075252690346,0.48306317739278687
24019,"Dorchester County, Maryland",32386,15476,16910,28911,23131,2926,1271,307,150,31971,980,812,1792,4929,2144,2785,14847,34,8.23,89.2,5.3356388562959305,15.21953930710801,1728,98.718582103378,45.84388315938986,0.4778608040511332
24021,"Frederick County, Maryland",246105,121305,124800,39566,166221,39146,20678,3382,4036,243766,7245,5776,13021,17336,7771,9565,128717,849,8.31,86.1,11.416265415168322,7.044147823083643,28096,99.04959265354219,52.3016598606286,0.49289937221917474
24023,"Garrett County, Maryland",29516,14618,14898,26303,21378,2244,1507,263,178,29037,1227,958,2185,3299,1552,1747,13738,70,8.91,78.8,6.599810272394634,11.176988751863396,1948,98.37715137552514,46.54424718796585,0.4952568098658355
24025,"Harford County, Maryland",250132,122344,127788,37972,172031,36150,19377,2449,2499,247295,5769,3930,9699,18512,7850,10662,128501,590,6.91,85.2,9.72486527113684,7.400892328850367,24325,98.86579885820287,51.37327491084707,0.4891177458302017
24027,"Howard County, Maryland",312495,152843,159652,51045,210338,63325,45105,10556,9787,309281,7725,7034,14759,16001,7056,8945,166207,1286,7.38,86.8,20.943695099121587,5.120401926430823,65448,98.9715035440567,53.1870909934559,0.489105425686811
24029,"Kent County, Maryland",19666,9426,10240,32217,13932,2644,1264,345,378,19316,748,474,1222,2359,1199,1160,8927,70,6.1,87,10.103732329909489,11.995321875317808,1987,98.22027865351367,45.393064171666836,0.4793043831994305
24031,"Montgomery County, Maryland",1039198,501571,537627,51162,713454,190725,137127,44984,43352,1030760,45797,40809,86606,72085,29877,42208,545924,3667,8.14,86.7,21.69586546548396,6.936599185140849,225463,99.18802769058448,52.53320348961411,0.48265200664358476
24033,"Prince George's County, Maryland",905161,435878,469283,34391,607229,110917,64114,9115,9330,898512,61637,45124,106761,82328,35278,47050,469632,3447,8.62,88.3,9.120918819966835,9.095398498167729,82559,99.26543454700324,51.883808515833095,0.4815474816082443
24035,"Queen Anne's County, Maryland",49071,24230,24841,40553,34452,7377,3470,828,482,48540,1250,1175,2425,3119,1454,1665,24973,204,6.84,88.1,9.74098754865399,6.356096268671925,4780,98.91789447942777,50.891565282957345,0.49377432699557783
24037,"St. Mary's County, Maryland",110979,55420,55559,37528,73031,13009,7654,829,740,108087,3646,2643,6289,8839,3413,5426,55125,248,6.99,88.5,8.31058128114328,7.964569873579686,9223,97.39410158678669,49.67155948422675,0.4993737553951649
24039,"Somerset County, Maryland",25801,13821,11980,18395,17070,1617,662,109,74,21825,959,950,1909,4434,1773,2661,8335,103,8,88.8,3.2750668578737256,17.185380411611952,845,84.58974458354328,32.304949420565094,0.5356769117476067
24041,"Talbot County, Maryland",37461,17595,19866,44785,28077,5448,3105,1133,807,37054,1263,1034,2297,3692,1476,2216,17611,108,7.88,89,13.467339366274258,9.855583139798725,5045,98.91353674488134,47.01155868770188,0.46968847601505564
24043,"Washington County, Maryland",149546,75958,73588,28742,103916,13451,7234,1027,582,141198,5381,4449,9830,18045,7433,10612,66237,347,7.36,86.7,5.913230711620504,12.066521337916093,8843,94.41777112059165,44.29205729340805,0.5079239832559881
24045,"Wicomico County, Maryland",102014,48622,53392,27755,63959,10373,5308,1056,1034,100725,4826,3568,8394,15602,6702,8900,48673,307,9.5,89.2,7.251945811359225,15.293979257748937,7398,98.73644793851824,47.712078734291374,0.47662085596094655
24047,"Worcester County, Maryland",51559,25205,26354,34425,38930,7439,3184,757,319,50884,2270,1482,3752,5228,2201,3027,23449,173,9.12,87.7,8.262379022091196,10.139839795186097,4260,98.69082022537287,45.47993560775034,0.4888574254737291
24510,"Baltimore city, Maryland",619796,291377,328419,28488,425235,67779,40095,12483,9006,610390,27460,21525,48985,133793,58512,75281,272953,2491,6.74,88.9,9.936172547096142,21.58661882296756,61584,98.4824038877308,44.03916772615506,0.47011758707703827
25001,"Barnstable County, Massachusetts",213900,102152,111748,40886,165101,39428,21534,4386,3499,211589,3948,2778,6726,15810,6615,9195,101959,816,7.31,78.1,13.753623188405797,7.391304347826087,29419,98.91958859280038,47.666666666666664,0.4775689574567555
25003,"Berkshire County, Massachusetts",127751,61741,66010,33245,92897,16997,9804,2239,1788,125512,2322,1316,3638,13778,6220,7558,62599,448,6.61,77.8,10.826529733622438,10.785042778530109,13831,98.24737184053353,49.00079060046497,0.4832917159161181
25005,"Bristol County, Massachusetts",557016,269719,287297,32406,387417,66555,30140,5229,3914,550584,10831,6531,17362,65842,28333,37509,272235,1376,7.1,80.7,7.052400649173453,11.82048630559984,39283,98.84527553966134,48.87382050066785,0.484221279101498
25007,"Dukes County, Massachusetts",17275,8282,8993,42956,12727,3591,1457,581,263,17167,327,229,556,1438,634,804,8648,174,7.11,78.6,13.319826338639652,8.324167872648335,2301,99.37481910274964,50.06078147612156,0.47942112879884224
25009,"Essex County, Massachusetts",775860,373886,401974,38604,534288,124302,62203,12595,8285,768666,15669,9316,24985,82434,35370,47064,389683,5902,6.65,79.2,10.70850411156652,10.624854999613332,83083,99.0727708607223,50.22594282473642,0.4818987961745676
25011,"Franklin County, Massachusetts",70926,34663,36263,33010,52862,9936,7242,942,1310,70141,1145,706,1851,7635,3534,4101,36182,193,8.12,80.2,13.385782364718157,10.764740715675492,9494,98.89321264416434,51.013732622733556,0.4887206384118659
25013,"Hampden County, Massachusetts",469188,226391,242797,28072,314809,49416,26334,4715,2827,463854,9637,5454,15091,78315,34117,44198,211695,1977,8.33,81.1,7.220133507250825,16.69160336581498,33876,98.8631422798537,45.11944039489501,0.4825166031526808
25015,"Hampshire County, Massachusetts",161197,75492,85705,32198,99070,22348,15018,2829,4951,159836,2387,1692,4079,19052,9247,9805,81822,408,7.77,80.6,14.142943106881642,11.819078518830995,22798,99.15569148309211,50.75900916270154,0.4683213707451131
25017,"Middlesex County, Massachusetts",1582857,773112,809745,47616,1106543,297546,204834,42622,53697,1567310,26432,17273,43705,125491,55973,69518,847033,5926,6.48,81.8,19.025913269486757,7.928132484488492,301153,99.01778872001704,53.512919992140795,0.4884282029267331
25019,"Nantucket County, Massachusetts",10912,5804,5108,47924,7931,1960,1260,253,105,10857,421,177,598,1205,685,520,6229,8,9.33,75.5,14.827712609970675,11.042888563049853,1618,99.49596774193549,57.08394428152493,0.531891495601173
25021,"Norfolk County, Massachusetts",694389,333237,361152,49816,485216,138379,78298,21682,16414,685970,8306,6136,14442,44279,17659,26620,359615,2104,6.53,81.6,16.762074284010836,6.376685114539545,116394,98.7875671993652,51.78869480939358,0.4798995951836795
25023,"Plymouth County, Massachusetts",509114,247788,261326,39247,352035,79833,34495,7411,3812,502122,7616,5641,13257,39748,16072,23676,256098,2134,7.23,80.8,8.979914125323601,7.807288740832112,45718,98.62663372054196,50.30268269974898,0.486704353052558
25025,"Suffolk County, Massachusetts",780685,377572,403113,38031,536354,130501,67684,21003,14797,773850,19898,11905,31803,144661,62177,82484,414717,3741,6.64,81.4,13.255538405374766,18.530008902438244,103484,99.12448682887464,53.1221939706796,0.48364192984366294
25027,"Worcester County, Massachusetts",818249,403587,414662,34691,559286,120813,57087,10233,9484,806244,13094,9107,22201,87858,37918,49940,405532,4117,8.72,80.1,9.386384829067925,10.737318346860185,76804,98.53284269213894,49.56095271732688,0.4932325001313781
26001,"Alcona County, Michigan",10413,5247,5166,24463,8510,847,310,97,37,10317,516,345,861,1526,734,792,3278,62,5.37,77.7,4.263900893114377,14.654758474983193,444,99.07807548256986,31.479880918083165,0.5038893690579084
26003,"Alger County, Michigan",9254,5088,4166,21771,7131,868,325,22,51,8268,411,347,758,1070,544,526,3102,11,6.4,75,4.300842878755133,11.56256753836179,398,89.34514804408904,33.52063972336287,0.5498162956559326
26005,"Allegan County, Michigan",114145,56997,57148,27172,76740,11470,4401,694,527,113378,3835,3065,6900,12169,5285,6884,53272,253,10.11,82,4.925314293223532,10.661001357921942,5622,99.32804765867975,46.67046300757808,0.4993385606027421
26007,"Alpena County, Michigan",28730,14169,14561,24030,21105,2347,975,245,84,28378,1173,979,2152,4206,1865,2341,12406,49,5.77,78.5,4.53880960668291,14.639749390880613,1304,98.77479986077272,43.18134354333449,0.49317786286112075
26009,"Antrim County, Michigan",23133,11479,11654,29307,17252,2830,1405,247,163,22964,990,830,1820,2865,1214,1651,9528,66,8.37,78.9,7.845934379457917,12.384904681623654,1815,99.26944192279427,41.18791337050966,0.4962175247481952
26011,"Arenac County, Michigan",15238,7714,7524,22622,11391,846,414,40,23,15095,762,509,1271,2773,1378,1395,5716,61,5.97,79.6,3.130332064575404,18.19792623703898,477,99.06155663472897,37.51148444677779,0.5062344139650873
26013,"Baraga County, Michigan",8580,5112,3468,18975,6246,613,255,59,39,6746,212,246,458,957,369,588,2452,18,7.43,75.3,4.1142191142191145,11.153846153846153,353,78.62470862470863,28.57808857808858,0.5958041958041959
26015,"Barry County, Michigan",59607,29958,29649,27166,41495,5549,1932,408,206,59258,1790,1644,3434,5440,2337,3103,27333,90,10.18,82.1,4.271310416561813,9.126444880634825,2546,99.41449829717986,45.855352559263174,0.5025919774523127
26017,"Bay County, Michigan",105350,51875,53475,25462,74771,9685,3539,622,360,104405,3909,2794,6703,16960,8174,8786,45337,217,6.27,80.7,4.291409587090651,16.098718557190317,4521,99.1029900332226,43.03464641670622,0.492406264831514
26019,"Benzie County, Michigan",17462,8694,8768,26790,13010,2224,1124,232,146,17273,907,537,1444,1728,835,893,7495,82,7.42,77.9,8.601534761195738,9.895773679990837,1502,98.91764975375101,42.921772992784334,0.497881113274539
26021,"Berrien County, Michigan",154948,75835,79113,27505,107173,16928,8769,1841,1093,153834,7448,5963,13411,25868,11143,14725,69293,714,9.8,81.3,7.552856442161241,16.69463303818055,11703,99.28104912615845,44.72016418411338,0.4894222577897101
26023,"Branch County, Michigan",43543,22517,21026,22977,30031,2927,992,175,114,41414,2535,1960,4495,6528,3129,3399,18452,183,6.42,82.9,2.9419194818914636,14.992076797648302,1281,95.110580345865,42.376501389431134,0.5171210068208437
26025,"Calhoun County, Michigan",134327,65652,68675,24859,90848,12698,4973,790,601,132656,5201,3967,9168,22630,10109,12521,56834,232,9.18,82.4,4.737692347778183,16.846948119142095,6364,98.75602075532098,42.310183358520625,0.488747608448041
26027,"Cass County, Michigan",51397,25861,25536,28019,36347,4402,1650,313,207,51274,2651,1826,4477,6907,3169,3738,22435,175,9.17,82.1,4.222036305620951,13.43852754051793,2170,99.76068642138647,43.65040761133918,0.5031616631320894
26029,"Charlevoix County, Michigan",26160,12868,13292,31730,19123,3346,1720,496,230,25894,1024,867,1891,2990,1314,1676,11667,49,7.89,78.4,9.350152905198776,11.429663608562691,2446,98.98318042813456,44.59862385321101,0.4918960244648318
26031,"Cheboygan County, Michigan",25475,12680,12795,24956,19222,2385,1127,148,86,25152,1428,1095,2523,4217,1916,2301,10343,84,6.28,77.8,5.342492639842983,16.553483807654562,1361,98.73209028459274,40.600588812561334,0.4977428851815505
26033,"Chippewa County, Michigan",38023,20948,17075,21958,26147,3597,1303,221,292,34430,1749,1244,2993,5786,2912,2874,14807,89,6.51,75.2,4.776056597322673,15.217105436183363,1816,90.55045630276412,38.942219183126,0.5509297004444679
26035,"Clare County, Michigan",30597,15148,15449,21198,22312,1707,863,88,48,30258,1994,1717,3711,7108,3243,3865,10746,101,7.19,81.2,3.265025982939504,23.23103572245645,999,98.89204824002353,35.12109030297088,0.49508121711278885
26037,"Clinton County, Michigan",77321,38231,39090,32792,52473,10524,3998,1259,762,76718,1847,1316,3163,7736,3489,4247,36560,113,8.49,83.3,7.7844311377245505,10.005043907864616,6019,99.22013424554778,47.283402956505995,0.49444523480037766
26039,"Crawford County, Michigan",13821,6953,6868,22891,10296,1215,409,128,55,13633,477,469,946,2228,1064,1164,5058,46,7.77,79.4,4.283336951016569,16.120396498082627,592,98.6397511033934,36.59648361189494,0.5030750307503075
26041,"Delta County, Michigan",36395,18084,18311,25582,26442,3760,1218,357,147,36001,1478,1238,2716,5156,2410,2746,15472,161,7.17,77.4,4.731419150982278,14.166781151257041,1722,98.91743371342217,42.51133397444704,0.49688143975820853
26043,"Dickinson County, Michigan",25694,12819,12875,25998,18634,3280,1024,302,137,25359,1216,733,1949,3855,1690,2165,10955,170,6.7,79.4,5.693936327547287,15.00350276329104,1463,98.6961936638904,42.63641317038997,0.4989102514205651
26045,"Eaton County, Michigan",108586,53065,55521,30064,75426,12750,5297,1061,591,107901,3821,2788,6609,11655,4961,6694,51684,225,9.76,82.8,6.399535851767263,10.73342788204741,6949,99.36916361225204,47.5972961523585,0.48869099147219713
26047,"Emmet County, Michigan",32978,16359,16619,31356,23755,4826,2079,572,329,32649,1604,1224,2828,3454,1569,1885,15957,158,7.28,76,9.036327248468677,10.4736490993996,2980,99.00236521317242,48.38680332342774,0.49605797804597
26049,"Genesee County, Michigan",410881,198115,212766,25180,278229,35525,16447,3258,1581,408548,15744,11237,26981,81280,36687,44593,163296,825,4.96,82.3,5.180575397742899,19.781883319014508,21286,99.43219569656421,39.74289392792561,0.4821712369274802
26051,"Gladwin County, Michigan",25324,12719,12605,23491,18735,1512,914,94,20,25149,1613,1265,2878,5066,2192,2874,8733,164,6.86,81.4,4.0593903016900965,20.004738587900807,1028,99.30895593113252,34.48507344811246,0.5022508292528827
26053,"Gogebic County, Michigan",15577,8445,7132,22297,11823,1434,565,104,70,14144,845,653,1498,2866,1336,1530,5848,42,6.12,76.8,4.744174102843936,18.398921486807474,739,90.80053925659627,37.54253065416961,0.5421454708865635
26055,"Grand Traverse County, Michigan",91222,44860,46362,31701,65378,13632,6271,1553,925,89528,3501,3096,6597,8642,4100,4542,44984,421,7.8,79.5,9.59088816294315,9.473591896691588,8749,98.14299182214816,49.312665804301595,0.4917673368266427
26057,"Gratiot County, Michigan",41319,21937,19382,20597,28089,2478,1302,152,204,37029,1438,1182,2620,7260,3254,4006,15001,75,7.34,82.6,4.01268181708173,17.57060916285486,1658,89.61736731285849,36.305331687601345,0.5309179796219656
26059,"Hillsdale County, Michigan",45909,22902,23007,23831,31231,3320,1378,332,209,45501,2213,1823,4036,7510,3460,4050,18879,131,5.83,82.1,4.180008277244113,16.35844823455096,1919,99.11128536888192,41.12265568842711,0.498856433379076
26061,"Houghton County, Michigan",36333,19713,16620,21462,21194,4172,1708,341,745,35905,1850,1026,2876,7264,4279,2985,14830,91,6.77,76.7,7.689978807145019,19.992843971045605,2794,98.82200754135359,40.81688822833237,0.5425646106845017
26063,"Huron County, Michigan",31750,15777,15973,26352,23306,2414,910,257,43,31373,1387,1001,2388,4266,1929,2337,13730,114,6.32,78,3.811023622047244,13.436220472440946,1210,98.81259842519685,43.24409448818898,0.49691338582677164
26065,"Ingham County, Michigan",286185,139183,147002,27399,171795,35536,18806,4762,6929,284407,11267,8161,19428,56038,25691,30347,133668,444,8.22,83,10.656393591557908,19.581040236210843,30497,99.37872355294652,46.70685046386079,0.4863392560756154
26067,"Ionia County, Michigan",64147,34130,30017,22715,43193,4981,1676,192,136,60417,2426,1557,3983,7905,3717,4188,27349,136,9.55,82.9,3.124074391631721,12.3232575178886,2004,94.18523079801082,42.63488549737322,0.5320591765787955
26069,"Iosco County, Michigan",25317,12570,12747,24099,19446,1998,1020,121,94,24993,1183,1017,2200,4186,1981,2205,8738,65,5.31,78.8,4.878145119879923,16.534344511593,1235,98.72022751510842,34.51435794130426,0.49650432515700915
26071,"Iron County, Michigan",11291,5576,5715,23658,8805,1099,395,98,39,11006,488,411,899,1556,680,876,4309,17,7.18,77.8,4.711717296962182,13.780887432468338,532,97.47586573377026,38.16313878310159,0.4938446550349836
26073,"Isabella County, Michigan",70572,34338,36234,22009,37896,6436,3325,407,986,70040,3540,3080,6620,17493,8097,9396,32069,155,7.54,82.6,6.685370968656124,24.787451113756163,4718,99.24615995012186,45.441534886357196,0.48656691038938954
26075,"Jackson County, Michigan",158989,81200,77789,25952,109293,15798,5519,1064,692,151193,6072,5094,11166,22614,9597,13017,66605,467,7.27,82.5,4.575788262081025,14.223625533841965,7275,95.09651611117751,41.89283535338923,0.5107271572247136
26077,"Kalamazoo County, Michigan",259830,127247,132583,29258,161274,35464,17756,3247,3546,257882,10386,7545,17931,41981,20053,21928,126473,1285,10.57,82.3,9.44810068121464,16.157102721009892,24549,99.25027902859561,48.67528768810376,0.48973174768117617
26079,"Kalkaska County, Michigan",17358,8874,8484,22822,12481,969,450,76,66,17306,1022,867,1889,3174,1534,1640,6831,38,8.78,79.7,3.4105311671851597,18.285516764604218,592,99.7004263163959,39.35361216730038,0.5112340131351538
26081,"Kent County, Michigan",636376,313134,323242,29433,415501,94426,36709,8089,4933,632099,27172,19564,46736,83789,38503,45286,315140,2396,9.36,82.5,7.814719599733491,13.166587049165901,49731,99.32791305768916,49.52103787697839,0.49205815429871647
26083,"Keweenaw County, Michigan",2136,1099,1037,28700,1651,251,97,57,10,2129,148,83,231,307,141,166,837,0,5.81,73.1,7.677902621722846,14.372659176029963,164,99.67228464419476,39.18539325842696,0.5145131086142322
26085,"Lake County, Michigan",11669,5965,5704,18199,8943,643,282,49,44,11323,521,476,997,2822,1444,1378,3450,53,8.58,80.5,3.2136429856885766,24.1837346816351,375,97.03487873853801,29.565515468334905,0.5111834775901962
26087,"Lapeer County, Michigan",88205,44663,43542,26650,61608,7313,3221,421,390,86704,3174,2832,6006,8427,3679,4748,37813,190,4.12,81.3,4.571169434839295,9.553880165523497,4032,98.2982824102942,42.8694518451335,0.5063545150501673
26089,"Leelanau County, Michigan",21564,10681,10883,37061,16453,3923,2171,408,206,21414,743,550,1293,1650,835,815,9626,95,7.08,76.7,12.91504359117047,7.6516416249304395,2785,99.30439621591542,44.63921350398813,0.4953162678538305
26091,"Lenawee County, Michigan",98585,49929,48656,25649,67861,9067,3819,685,353,95362,3938,2972,6910,12811,5566,7245,43557,167,5.15,83.2,4.926712988791398,12.994877516863621,4857,96.73073997058376,44.182177816097784,0.5064563574580312
26093,"Livingston County, Michigan",186946,93729,93217,36845,129271,29548,12211,1950,1150,186088,4722,3836,8558,10935,4808,6127,93385,562,5.85,82.5,8.190065580434991,5.849282680560162,15311,99.54104393782161,49.95292758336632,0.5013693793929798
26095,"Luce County, Michigan",6406,3753,2653,19442,4805,495,191,34,5,5393,299,184,483,1041,496,545,2047,38,6.76,74.8,3.5903840149859505,16.250390259132065,230,84.18669996877927,31.95441773337496,0.5858570090540118
26097,"Mackinac County, Michigan",10836,5474,5362,26967,8305,992,457,88,47,10739,774,545,1319,1648,728,920,4404,106,6.55,74.9,5.46327057954965,15.208564045773349,592,99.10483573274271,40.64230343300111,0.5051679586563308
26099,"Macomb County, Michigan",864019,420439,443580,29740,603335,95834,40771,6297,3241,857360,32503,26091,58594,101096,43997,57099,405607,1817,5.31,82.2,5.822672881036181,11.70066861955582,50309,99.22929935568547,46.94422229140795,0.48660851208133155
26101,"Manistee County, Michigan",24432,12697,11735,24398,18164,2342,1059,219,107,23191,1139,781,1920,3401,1455,1946,9294,74,8.24,78.6,5.66879502292076,13.92026850032744,1385,94.92059593975115,38.04027504911591,0.5196872953503602
26103,"Marquette County, Michigan",67145,33898,33247,25550,44536,9257,3122,774,553,65202,2510,1759,4269,10262,4798,5464,29021,136,6.56,76,6.625958745997468,15.28334202099933,4449,97.10626256608832,43.22138655149304,0.5048477176260332
26105,"Mason County, Michigan",28800,14284,14516,26251,20668,2853,1314,238,183,28496,1430,840,2270,4541,2055,2486,12148,90,8.29,78.7,6.024305555555555,15.76736111111111,1735,98.94444444444444,42.18055555555556,0.4959722222222222
26107,"Mecosta County, Michigan",43181,21802,21379,21978,26634,3540,1588,282,375,42952,1713,1231,2944,9015,4583,4432,17499,178,8.19,81.6,5.199045876658715,20.877237673976982,2245,99.46967416224729,40.5247678377064,0.5048979875408166
26109,"Menominee County, Michigan",23389,11834,11555,26151,17240,1920,593,160,56,23086,772,681,1453,3092,1308,1784,10320,107,6.86,79.6,3.458890931634529,13.219889691735432,809,98.70451921843602,44.12330582752576,0.505964342212151
26111,"Midland County, Michigan",83489,40954,42535,33013,57788,11924,5316,996,1448,82891,2502,2075,4577,9300,4290,5010,37358,200,7.39,82.3,9.294637616931572,11.139191989363868,7760,99.2837379774581,44.74601444501671,0.4905316868090407
26113,"Missaukee County, Michigan",14982,7634,7348,21805,10377,931,380,60,22,14875,767,636,1403,2349,1053,1296,6065,37,7.85,80,3.0837004405286343,15.678814577492991,462,99.28580963823255,40.481911627286074,0.5095447870778267
26115,"Monroe County, Michigan",149619,73905,75714,29245,104005,12881,5272,823,327,148683,4857,3722,8579,16555,7065,9490,68037,441,4.8,84,4.292235611787273,11.064771185477781,6422,99.37441100395003,45.47350269685,0.4939546447977864
26117,"Montcalm County, Michigan",62956,32441,30515,21509,43357,3807,1356,296,86,60500,3106,2348,5454,10487,4774,5713,25233,213,8.47,82.5,2.760658237499206,16.657665671262468,1738,96.09886269775717,40.08037359425631,0.5152963974839571
26119,"Montmorency County, Michigan",9290,4711,4579,23155,7399,580,255,34,17,9189,548,295,843,1380,554,826,2921,24,5.41,79,3.293864370290635,14.854682454251884,306,98.91280947255113,31.442411194833152,0.5071044133476856
26121,"Muskegon County, Michigan",172707,85918,86789,22829,116760,14978,5436,874,419,167878,6245,4590,10835,30727,14068,16659,71806,286,8.97,81.2,3.896194132258681,17.791403938462253,6729,97.20393498815913,41.576774537222,0.49747838825293705
26123,"Newaygo County, Michigan",47899,24036,23863,22735,33101,3325,1290,184,160,47376,2082,1620,3702,8405,3827,4578,18846,298,8.64,81.4,3.411344704482348,17.54733919288503,1634,98.90811916741477,39.345289045700326,0.5018058832125931
26125,"Oakland County, Michigan",1241860,605231,636629,40941,868144,225174,125982,30983,14921,1235853,38429,32980,71409,111071,47929,63142,617557,2923,4.83,82.1,13.841012674536582,8.94392282543926,171886,99.51629008100753,49.72839128404168,0.4873584784114151
26127,"Oceana County, Michigan",26317,13323,12994,22185,18002,2099,853,169,145,26144,1547,1034,2581,4550,2280,2270,10464,75,8.6,79.7,4.434396017783182,17.28920469658396,1167,99.34263023900901,39.76137097693506,0.5062507124672265
26129,"Ogemaw County, Michigan",20979,10518,10461,22028,15616,1180,500,133,24,20680,1018,788,1806,3856,1749,2107,7606,102,7.01,80,3.131703131703132,18.380285046951713,657,98.5747652414319,36.25530292196959,0.5013585013585014
26131,"Ontonagon County, Michigan",6072,3104,2968,22958,5010,615,203,36,16,6009,391,401,792,930,446,484,2005,8,6.9,77.4,4.199604743083004,15.316205533596838,255,98.96245059288538,33.02042160737813,0.5111989459815547
26133,"Osceola County, Michigan",23221,11725,11496,21090,16105,1303,548,69,79,22961,1477,1163,2640,4749,2163,2586,8793,46,7.77,80.5,2.997286938547005,20.451315619482365,696,98.88032384479565,37.86658627966065,0.5049308815296499
26135,"Oscoda County, Michigan",8304,4266,4038,22343,6187,445,182,44,4,8259,669,533,1202,1488,721,767,2669,51,6.39,79.4,2.7697495183044314,17.91907514450867,230,99.45809248554913,32.14113680154143,0.513728323699422
26137,"Otsego County, Michigan",24247,11951,12296,26012,17049,2470,983,242,49,24057,961,818,1779,3549,1651,1898,10615,46,6.8,78.1,5.25425825875366,14.63686229224234,1274,99.21639790489544,43.7786117870252,0.49288571782076135
26139,"Ottawa County, Michigan",280243,138250,141993,29121,172590,37735,14128,2391,1853,278888,7657,5691,13348,25806,11600,14206,140181,630,9.53,81.8,6.555739126401016,9.208436963635132,18372,99.51649104527142,50.02123157402683,0.4933218670939149
26141,"Presque Isle County, Michigan",12854,6419,6435,24793,10009,975,507,102,39,12714,689,523,1212,1891,847,1044,4427,52,5.65,77.9,5.041232301229189,14.711373891395674,648,98.91084487319122,34.44064104558892,0.49937762564182353
26143,"Roscommon County, Michigan",23934,11867,12067,22333,18974,1673,805,113,100,23717,1261,881,2142,4675,2153,2522,7486,99,7.75,80.2,4.253363416060834,19.532882092420824,1018,99.09334001838388,31.277680287457173,0.49582184340269075
26145,"Saginaw County, Michigan",193803,94017,99786,25348,131855,18221,6988,1764,873,190465,6814,5801,12615,33103,14491,18612,80936,329,5.74,82.4,4.966383389318019,17.080746944061755,9625,98.27763244119028,41.76199542834734,0.4851163294685841
26147,"St. Clair County, Michigan",159761,79295,80466,27807,112002,12806,5777,1111,484,158541,6166,4398,10564,21050,8951,12099,70641,468,4.03,81.5,4.614392749169071,13.175931547749451,7372,99.23635931172188,44.21667365627406,0.49633515063125544
26149,"St. Joseph County, Michigan",60890,30264,30626,23702,40694,3921,1892,254,203,60356,2976,2528,5504,9403,4315,5088,27007,200,8.91,82.7,3.8577763179504023,15.442601412382986,2349,99.12300870422072,44.35375266874692,0.4970274265068156
26151,"Sanilac County, Michigan",41535,20592,20943,23924,29233,2514,1261,194,96,41212,2479,2157,4636,6165,2617,3548,17220,124,4.79,79.4,3.734200072228241,14.842903575297942,1551,99.2223426026243,41.45901047309498,0.49577464788732395
26153,"Schoolcraft County, Michigan",8114,3977,4137,21534,6070,628,231,26,37,8004,361,286,647,1706,825,881,2695,10,6.08,76.8,3.623367019965492,21.025388217894996,294,98.64431846191768,33.214197683017005,0.4901404979048558
26155,"Shiawassee County, Michigan",68617,33807,34810,25218,47636,5027,2208,346,154,68206,2958,2252,5210,8857,3900,4957,30145,204,6.43,82.7,3.946543859393445,12.90787997143565,2708,99.40102307008468,43.93226168442223,0.4926913155631986
26157,"Tuscola County, Michigan",53569,26889,26680,23573,37932,3532,1391,252,54,52721,2147,1772,3919,8307,3872,4435,22585,118,5.06,80.7,3.1678769437547833,15.50710298866882,1697,98.41699490376897,42.16057794620023,0.5019507551008979
26159,"Van Buren County, Michigan",75190,37397,37793,25433,51079,6929,2830,457,321,74699,4352,2999,7351,11733,5363,6370,32796,146,10.62,82,4.798510440218114,15.604468679345658,3608,99.34698763133396,43.61750232743716,0.4973666710998803
26161,"Washtenaw County, Michigan",361509,178949,182560,37455,223988,57485,41602,9838,12769,356361,9234,7373,16607,49602,23604,25998,179583,925,4.59,83.1,17.7613835340199,13.720820228542028,64209,98.57596906301087,49.67594167780055,0.4950056568439513
26163,"Wayne County, Michigan",1763822,848339,915483,24847,1173262,161102,80610,16421,9647,1751580,88211,65356,153567,413769,189105,224664,705969,5626,4.72,83.4,6.048115966350346,23.458659660668708,106678,99.30593903466449,40.02495716687965,0.48096633333749095
26165,"Wexford County, Michigan",32915,16480,16435,22028,22725,2786,940,184,89,32681,1952,1424,3376,5628,2818,2810,13672,89,8.25,79.8,3.6852498860701806,17.09858727024153,1213,99.28907792799636,41.53729302749506,0.5006835789153882
27001,"Aitkin County, Minnesota",15841,8079,7762,26883,12338,1446,433,150,30,15658,445,282,727,1895,890,1005,6180,74,6.42,79,3.8697051953790798,11.962628621930433,613,98.8447699008901,39.01268859289186,0.5100056814595039
27003,"Anoka County, Minnesota",344861,172482,172379,34321,233378,47125,15720,2550,1600,342522,9292,7115,16407,22428,9966,12462,184814,980,6.61,82.5,5.761741687230507,6.503489811837233,19870,99.32175572187055,53.59086704498334,0.5001493355293872
27005,"Becker County, Minnesota",33552,16672,16880,28525,22920,3880,1032,325,275,33166,1550,1004,2554,4191,1660,2531,15861,64,3.93,80.5,4.86409155937053,12.491058655221746,1632,98.84954697186457,47.27288984263233,0.49690033381020504
27007,"Beltrami County, Minnesota",45847,22775,23072,23748,27843,4780,1740,448,542,45331,2616,2149,4765,8203,3976,4227,20426,73,4.31,79.5,5.9545880864614915,17.892119440748576,2730,98.87451741662485,44.552533426396494,0.49676096582110063
27009,"Benton County, Minnesota",39360,19652,19708,27018,26307,4289,1092,257,188,38826,1134,863,1997,5445,2206,3239,20139,174,5.64,80.6,3.904979674796748,13.833841463414634,1537,98.64329268292683,51.166158536585364,0.49928861788617884
27011,"Big Stone County, Minnesota",5039,2489,2550,29035,3672,465,102,29,21,4914,119,142,261,574,223,351,2361,15,6.62,84.9,3.0164715221274063,11.391149037507441,152,97.51934907719786,46.854534629886885,0.49394721174836276
27013,"Blue Earth County, Minnesota",65767,33054,32713,28283,38058,8101,2801,665,694,65163,1770,1040,2810,11321,5329,5992,36054,49,5.24,83.8,6.325360743229887,17.21380023415999,4160,99.08160627670412,54.82080678759864,0.5025924855930786
27015,"Brown County, Minnesota",25243,12550,12693,29696,17285,2522,591,207,106,24904,641,473,1114,1944,847,1097,13416,45,7.73,83.9,3.5811908251792577,7.70114487184566,904,98.65705344055777,53.14740720199659,0.4971675315929168
27017,"Carlton County, Minnesota",35408,18500,16908,26900,24634,3896,1113,189,97,34371,1036,669,1705,4123,2323,1800,16544,92,6.12,77.5,3.951084500677813,11.64426118391324,1399,97.07128332580209,46.723904202440124,0.5224807953004971
27019,"Carver County, Minnesota",98799,49086,49713,44212,63685,21349,6838,1155,877,98533,1814,1602,3416,3934,1728,2206,54880,250,5.75,83.2,8.977823662182816,3.9818216783570684,8870,99.73076650573387,55.54712092227654,0.4968268909604348
27021,"Cass County, Minnesota",28810,14698,14112,28004,20878,3148,1015,224,133,28565,1314,804,2118,4339,1937,2402,11998,190,5.55,80.2,4.762235334953141,15.060742797639708,1372,99.14960083304408,41.6452620617841,0.5101700798333911
27023,"Chippewa County, Minnesota",12040,5994,6046,29354,8288,1126,314,26,10,11852,512,300,812,1307,561,746,6215,13,9.73,84.5,2.9069767441860463,10.855481727574752,350,98.43853820598007,51.619601328903656,0.4978405315614618
27025,"Chisago County, Minnesota",54297,28102,26195,32105,37394,5690,1684,345,202,52907,1347,1069,2416,2871,1299,1572,27768,161,5.5,81.8,4.108882627032801,5.287584949444721,2231,97.44000589351161,51.140947013647164,0.5175608228815588
27027,"Clay County, Minnesota",62040,30613,31427,28122,37462,8955,2665,286,544,61544,1911,1246,3157,7236,3262,3974,33031,215,4.03,83.1,5.633462282398453,11.663442940038685,3495,99.20051579626048,53.24145712443585,0.49343971631205674
27029,"Clearwater County, Minnesota",8824,4485,4339,24515,6033,679,195,29,19,8726,497,335,832,1549,734,815,3584,30,3.94,79.8,2.753853127833182,17.554397098821397,243,98.88939256572982,40.61650045330916,0.5082728921124207
27031,"Cook County, Minnesota",5270,2609,2661,31831,4194,1059,412,150,74,5230,228,206,434,679,280,399,2563,15,5.67,73,12.06831119544592,12.884250474383302,636,99.24098671726755,48.63377609108159,0.4950664136622391
27033,"Cottonwood County, Minnesota",11437,5660,5777,27206,7888,1212,283,77,41,11246,395,190,585,1744,832,912,5281,36,7.12,83,3.506164203899624,15.24875404389263,401,98.32998163854158,46.17469616158083,0.49488502229605663
27035,"Crow Wing County, Minnesota",63505,31769,31736,30013,44990,7129,2808,765,359,62776,2003,1624,3627,6043,2637,3406,29672,194,8.08,80.2,6.191638453665066,9.515786158570192,3932,98.85205889300055,46.723880009448074,0.500259822061255
27037,"Dakota County, Minnesota",414655,204016,210639,38863,278415,78605,26544,5875,3312,412826,10501,8352,18853,28284,12676,15608,227101,1392,6.31,83.4,8.617043084009598,6.821092233302384,35731,99.55891041950537,54.76866310547322,0.49201384283319866
27039,"Dodge County, Minnesota",20485,10301,10184,31417,13372,2427,660,157,46,20347,561,365,926,1160,506,654,10963,52,5.34,81.3,4.212838662435929,5.662680009763242,863,99.3263363436661,53.517207712960705,0.502855748108372
27041,"Douglas County, Minnesota",36891,18510,18381,33336,26304,4682,1310,357,271,36494,694,569,1263,3063,1530,1533,18879,102,7.31,80.3,5.253313816377978,8.302838090591202,1938,98.9238567672332,51.175083353663496,0.5017483939172156
27043,"Faribault County, Minnesota",13966,6975,6991,29116,10037,1320,261,122,36,13679,408,428,836,1556,685,871,7000,42,5.4,83.4,3.0001432049262493,11.14134326220822,419,97.94500930832021,50.12172418731204,0.49942718029500216
27045,"Fillmore County, Minnesota",20825,10448,10377,28441,14335,2100,654,147,69,20478,1033,827,1860,2309,1036,1273,10435,84,6.41,81,4.177671068427371,11.087635054021609,870,98.33373349339736,50.10804321728691,0.5017046818727491
27047,"Freeborn County, Minnesota",30619,15312,15307,27603,21872,2652,710,243,74,30158,1173,862,2035,3536,1474,2062,14840,172,5.56,82.2,3.354126522747314,11.54838498971227,1027,98.49439890264215,48.46663836180149,0.5000816486495313
27049,"Goodhue County, Minnesota",46138,23014,23124,33477,32295,5524,1827,375,252,45330,1439,1468,2907,4870,2277,2593,23539,159,6.07,82.2,5.318826130304738,10.555290649789761,2454,98.24873206467554,51.018683081191206,0.49880792405392516
27051,"Grant County, Minnesota",5923,2972,2951,30359,4217,595,145,28,17,5877,159,156,315,623,234,389,2803,5,6.11,82.2,3.2078338679723113,10.518318419719737,190,99.22336653722776,47.32399122066521,0.5017727502954584
27053,"Hennepin County, Minnesota",1224763,604629,620134,41794,845407,259301,102674,29320,16020,1215746,41891,32337,74228,138478,64654,73824,663773,4561,6.78,83,12.085113609735108,11.306513994952493,148014,99.26377593052696,54.19603629436879,0.4936702039496621
27055,"Houston County, Minnesota",18709,9371,9338,30150,13332,2196,630,122,141,18497,486,319,805,1631,721,910,9902,149,6.9,82.4,4.773103853760222,8.717729435031268,893,98.86685552407933,52.926399059276285,0.5008819284836175
27057,"Hubbard County, Minnesota",20743,10411,10332,28073,15095,2717,925,238,142,20636,811,529,1340,2216,968,1248,9462,90,4.03,80.6,6.291278985681917,10.683122017065998,1305,99.48416333220845,45.615388323771874,0.5019042568577351
27059,"Isanti County, Minnesota",38584,19491,19093,30145,26236,3168,1056,192,112,38272,1126,743,1869,2710,1307,1403,19443,161,6.03,81.3,3.5247771096827702,7.023636740617873,1360,99.19137466307278,50.39135392908978,0.5051575782707858
27061,"Itasca County, Minnesota",45237,22941,22296,27497,32507,5025,1708,438,196,44429,1695,1417,3112,5553,2559,2994,19863,187,5.41,78.6,5.177177973782523,12.275349824258903,2342,98.21385149324668,43.90874726440745,0.5071291199681677
27063,"Jackson County, Minnesota",10104,5097,5007,31010,7103,1068,289,56,22,9983,229,85,314,765,390,375,5158,19,7.88,83.7,3.6322248614410135,7.57125890736342,367,98.80245447347585,51.04908946951702,0.5044536817102138
27065,"Kanabec County, Minnesota",15948,8101,7847,26345,11293,1086,386,152,43,15801,573,362,935,1820,837,983,7434,58,6.48,80,3.6430900426385753,11.412089290193128,581,99.07825432656132,46.613995485327315,0.5079633809882117
27067,"Kandiyohi County, Minnesota",42577,21398,21179,29375,28672,4382,1403,513,183,41915,1477,884,2361,4732,2157,2575,21594,153,9.57,82.8,4.929891725579538,11.113981727223619,2099,98.44516992742561,50.71752354557625,0.5025718110717053
27069,"Kittson County, Minnesota",4384,2226,2158,30525,3127,540,115,49,22,4247,123,97,220,473,155,318,2153,2,4.38,82.2,4.242700729927007,10.789233576642335,186,96.875,49.11040145985402,0.5077554744525548
27071,"Koochiching County, Minnesota",12776,6384,6392,26804,9417,1218,385,93,62,12606,358,264,622,2136,1024,1112,5668,66,4.46,78.3,4.226675015654352,16.718847839699436,540,98.66938008766436,44.36443331246086,0.4996869129618034
27073,"Lac qui Parle County, Minnesota",6840,3411,3429,31427,5022,695,170,75,12,6720,137,88,225,628,249,379,3397,11,8.22,84.7,3.757309941520468,9.181286549707602,257,98.24561403508773,49.66374269005848,0.4986842105263158
27075,"Lake County, Minnesota",10578,5426,5152,32319,8020,1484,515,201,124,10406,241,233,474,960,502,458,4666,28,5.76,75.6,7.941009642654566,9.075439591605218,840,98.3739837398374,44.11041784836453,0.5129514085838532
27077,"Lake of the Woods County, Minnesota",3841,2016,1825,24964,2839,390,90,2,0,3788,95,53,148,280,106,174,2043,0,5.09,79.4,2.395209580838323,7.289768289507941,92,98.62015100234314,53.18927362665973,0.5248633168445718
27079,"Le Sueur County, Minnesota",27810,14086,13724,31135,18996,3103,768,135,158,27649,673,583,1256,2433,1159,1274,14412,33,5.21,82.8,3.8151743976986694,8.748651564185545,1061,99.4210715569939,51.82308522114347,0.5065084501977706
27081,"Lincoln County, Minnesota",5724,2882,2842,28382,4048,666,91,26,14,5558,184,139,323,630,265,365,2765,10,7.76,83.6,2.2886093640810623,11.0062893081761,131,97.09993011879804,48.30538085255066,0.5034940600978337
27083,"Lyon County, Minnesota",25789,12902,12887,30203,16561,3231,746,161,247,25490,910,514,1424,3374,1423,1951,13710,34,7.71,85,4.474776067315522,13.083097444646942,1154,98.84059094962969,53.16220093838458,0.5002908216681531
27085,"McLeod County, Minnesota",35816,17850,17966,30145,24719,3161,962,205,128,35548,991,706,1697,2964,1234,1730,18970,42,5.57,83.6,3.615702479338843,8.27563100290373,1295,99.25173106991289,52.96515523788251,0.49838061201697564
27087,"Mahnomen County, Minnesota",5500,2767,2733,20720,3351,285,86,21,14,5468,408,404,812,1220,589,631,2137,11,4.33,80.6,2.2,22.181818181818183,121,99.41818181818182,38.85454545454545,0.5030909090909091
27089,"Marshall County, Minnesota",9397,4761,4636,28585,6550,1004,258,30,25,9334,327,197,524,724,319,405,4757,40,5.28,81.8,3.330850271363201,7.704586570181973,313,99.32957326806428,50.62253910822603,0.5066510588485686
27091,"Martin County, Minnesota",20084,10015,10069,30806,14218,2131,535,128,51,19869,652,559,1211,2234,897,1337,10066,57,5.61,83.8,3.555068711412069,11.123282214698268,714,98.9294961163115,50.119498107946626,0.4986556462856005
27093,"Meeker County, Minnesota",23105,11697,11408,29216,15812,2180,599,166,73,22799,757,556,1313,1885,786,1099,11423,52,6.82,82.4,3.6269205799610473,8.15840727115343,838,98.6756113395369,49.439515256438,0.506254057563298
27095,"Mille Lacs County, Minnesota",25635,12847,12788,25732,17541,1887,676,73,81,25179,960,700,1660,2869,1169,1700,11917,156,6.53,80.1,3.2377608738053443,11.191730056563292,830,98.22118197776477,46.487224497756976,0.5011507704310513
27097,"Morrison County, Minnesota",32880,16616,16264,28040,22747,2681,817,129,105,32542,1013,701,1714,3711,1511,2200,16231,144,7.99,80.5,3.19647201946472,11.286496350364963,1051,98.97201946472019,49.364355231143556,0.505352798053528
27099,"Mower County, Minnesota",39386,19742,19644,28613,26563,3719,1182,303,292,38978,1781,999,2780,5050,2297,2753,18691,181,5.49,81.5,4.511755446097598,12.821814858071395,1777,98.9640989183974,47.4559488142995,0.5012440968872188
27101,"Murray County, Minnesota",8394,4178,4216,30553,6070,778,242,58,22,8284,214,185,399,678,277,401,4145,17,6.92,83.3,3.8360733857517273,8.077197998570407,322,98.68954014772457,49.38050988801525,0.49773647843697877
27103,"Nicollet County, Minnesota",33477,16748,16729,29722,21820,4683,1446,380,526,33280,616,578,1194,3514,1737,1777,18120,45,5.72,83.5,7.025719150461511,10.496758968844281,2352,99.41153627863906,54.12671386324939,0.5002837769214685
27105,"Nobles County, Minnesota",21854,11219,10635,24935,13980,1401,430,136,57,21565,1185,715,1900,3379,1415,1964,10356,76,6.16,84.1,2.8507367072389496,15.461700375217351,623,98.67758762697905,47.38720600347762,0.5133613983710076
27107,"Norman County, Minnesota",6589,3337,3252,27099,4568,637,118,28,17,6460,289,159,448,770,329,441,3049,14,5,82.3,2.473820003035362,11.686143572621035,163,98.04219153134011,46.27409318561239,0.5064501441796935
27109,"Olmsted County, Minnesota",151685,74208,77477,37956,102459,25018,10943,4696,3466,149834,4541,2522,7063,13530,6120,7410,79595,379,5.59,81.4,12.595180802320598,8.919800903187527,19105,98.77970794739097,52.473876784125,0.4892243794706134
27111,"Otter Tail County, Minnesota",57790,29049,28741,29932,41088,7105,2076,571,401,57121,1875,1241,3116,5350,2468,2882,27592,190,4.99,80.4,5.274268904654784,9.257657034088943,3048,98.8423602699429,47.74528465132376,0.5026648209032705
27113,"Pennington County, Minnesota",14197,7115,7082,28562,9743,1423,229,91,76,13991,353,140,493,1440,546,894,7456,71,5.04,80.9,2.789321687680496,10.142987955201804,396,98.5489892230753,52.51813763471156,0.5011622173698669
27115,"Pine County, Minnesota",29057,15497,13560,24044,21042,2016,724,80,97,27445,1211,904,2115,3720,1814,1906,12424,101,6.53,79.2,3.1008018721822626,12.802422824104347,901,94.45228344288812,42.75733902329903,0.5333310389923255
27117,"Pipestone County, Minnesota",9229,4481,4748,28706,6282,985,202,71,27,9073,368,238,606,1069,431,638,4210,31,6.91,83.8,3.2506230360819157,11.583053418571893,300,98.30967602123741,45.61707660634955,0.4855347274894355
27119,"Polk County, Minnesota",31564,15988,15576,28260,21131,3622,1096,290,173,30971,879,881,1760,3763,1761,2002,15623,45,4.86,81.7,4.93917120770498,11.921809656570776,1559,98.12127740463819,49.49626156380687,0.5065264225066531
27121,"Pope County, Minnesota",10932,5540,5392,32454,7915,1243,391,96,25,10753,316,165,481,847,328,519,5429,24,7.6,82,4.683497987559458,7.747896084888401,512,98.36260519575558,49.66154409074277,0.5067691181851446
27123,"Ramsey County, Minnesota",537893,261783,276110,32544,355855,88453,38646,11004,9627,533696,19769,15034,34803,78410,35873,42537,272537,1752,7.63,82.6,11.020221493865881,14.57724863495156,59277,99.21973329268089,50.66751194010705,0.4866822955494866
27125,"Red Lake County, Minnesota",4017,2033,1984,26988,2778,348,86,20,6,3995,151,67,218,377,169,208,1993,2,5.03,81,2.788150360965895,9.385113268608414,112,99.45232760766741,49.61413990540204,0.5060990789146129
27127,"Redwood County, Minnesota",15430,7819,7611,27543,10539,1511,299,96,37,15166,534,467,1001,1778,927,851,7453,43,9.83,84.5,2.7997407647440054,11.52300712896954,432,98.28904731043421,48.30200907323396,0.5067401166558652
27129,"Renville County, Minnesota",14798,7535,7263,31215,10362,1165,240,58,42,14502,454,412,866,1589,662,927,7351,55,12.47,84,2.2976077848357885,10.737937559129612,340,97.99972969320179,49.67563184214083,0.5091904311393431
27131,"Rice County, Minnesota",65251,33283,31968,28603,41228,6864,2836,644,685,62714,1794,1541,3335,6550,2638,3912,33624,217,6.35,82.8,6.383043938023938,10.038160334707515,4165,96.11193698180871,51.530244747206936,0.5100764739237713
27133,"Rock County, Minnesota",9433,4641,4792,29000,6400,1005,279,90,22,9199,304,318,622,1011,427,584,4742,30,5.9,84.9,4.145022792324817,10.71769320470688,391,97.51934697339128,50.27032757341249,0.4919961836107283
27135,"Roseau County, Minnesota",15537,8004,7533,27935,10460,1524,354,97,32,15347,392,212,604,1411,711,700,8137,65,5.48,80.8,3.10870824483491,9.081547274248567,483,98.7771126987192,52.37175773958937,0.515157366286928
27137,"St. Louis County, Minnesota",200294,100596,99698,29197,136240,25965,8558,2495,1657,197117,5545,4111,9656,29574,14054,15520,95673,618,6.28,77.8,6.345671862362328,14.765295016326,12710,98.41383166744885,47.766283563162155,0.5022417046940997
27139,"Scott County, Minnesota",141463,70509,70954,38322,90423,25366,7709,1174,962,139907,3724,2765,6489,7872,3223,4649,76321,378,5.8,83.5,6.959416950015198,5.5647059655174855,9845,98.900065741572,53.95120985699441,0.49842715056233783
27141,"Sherburne County, Minnesota",92024,46991,45033,33048,59289,11807,3351,716,391,90017,1557,1261,2818,5746,2493,3253,48782,372,5.82,81.3,4.844388420412066,6.244023298270016,4458,97.81904720507694,53.010084325828046,0.5106385290793706
27143,"Sibley County, Minnesota",14888,7530,7358,29884,10212,1271,284,104,37,14761,408,342,750,1259,570,689,7695,21,6.22,83.9,2.854648038688877,8.4564750134336375,425,99.14696399785062,51.685921547555076,0.5057764642665233
27145,"Stearns County, Minnesota",155300,78126,77174,29148,95525,17703,5355,1561,1331,154153,3893,2923,6816,19321,9249,10072,83425,428,6.79,80.9,5.310367031551835,12.441081777205408,8247,99.26142949130714,53.71860914359304,0.5030650354153252
27147,"Steele County, Minnesota",36612,18225,18387,29930,24475,4275,1315,328,102,36230,871,527,1398,3583,1457,2126,18280,75,5.65,82.4,4.766196875341418,9.786408827706763,1745,98.95662624276194,49.92898503222987,0.497787610619469
27149,"Stevens County, Minnesota",9759,4850,4909,31419,5755,1219,205,59,176,9674,130,97,227,1454,631,823,5117,21,7.52,83.3,4.508658674044471,14.899067527410596,440,99.12900911978686,52.43365098883082,0.49697714929808384
27151,"Swift County, Minnesota",9448,4733,4715,29470,6660,885,177,42,31,9321,269,181,450,1131,382,749,4677,54,7.61,84,2.6460626587637597,11.970787468247249,250,98.65580016934801,49.50254022015241,0.5009525825571549
27153,"Todd County, Minnesota",24423,12545,11878,24988,16745,1836,467,92,41,24244,1353,1160,2513,3126,1490,1636,11067,147,8.28,80.1,2.4567006510256726,12.799410391843754,600,99.26708430577735,45.31384350816853,0.5136551611186176
27155,"Traverse County, Minnesota",3357,1663,1694,30234,2422,319,69,33,5,3270,63,55,118,355,154,201,1625,11,5.06,84.2,3.187369675305332,10.574918081620494,107,97.40840035746201,48.40631516234733,0.49538278224605303
27157,"Wabasha County, Minnesota",21490,10729,10761,32307,15298,2264,748,192,108,21311,590,405,995,1293,561,732,11216,59,6.26,82.8,4.876686831084225,6.01675197766403,1048,99.16705444392741,52.191717077710564,0.49925546765937645
27159,"Wadena County, Minnesota",13626,6757,6869,24200,9250,819,251,83,40,13332,528,319,847,1977,950,1027,5949,54,5.5,80.9,2.7447526787024805,14.509026860413915,374,97.84236019374725,43.65918097754293,0.4958902098928519
27161,"Waseca County, Minnesota",18898,8978,9920,27383,12994,1875,596,76,75,17788,332,406,738,1614,748,866,9337,153,5.45,83.2,3.9527992380146046,8.540586305429146,747,94.12636257805059,49.40734469256006,0.47507672769605247
27163,"Washington County, Minnesota",250979,124207,126772,41591,168235,46409,17175,4473,3119,247714,5209,3635,8844,12251,5117,7134,131429,563,6.59,82.4,9.868156299929476,4.881284888377115,24767,98.69909434653896,52.366532658110835,0.4948900107180282
27165,"Watonwan County, Minnesota",10936,5511,5425,26884,7335,860,211,26,21,10805,866,658,1524,1321,602,719,5502,16,5.35,83.7,2.3591806876371617,12.079370885149963,258,98.80212143379663,50.310899780541334,0.5039319678127286
27167,"Wilkin County, Minnesota",6398,3214,3184,28575,4496,758,139,21,15,6252,172,189,361,614,203,411,3247,12,4.38,83.2,2.735229759299781,9.596748984057518,175,97.71803688652705,50.75023444826508,0.5023444826508284
27169,"Winona County, Minnesota",50992,25183,25809,27200,31225,6034,2324,386,486,50486,2028,1241,3269,6849,3332,3517,27997,128,6.62,82.1,6.267649827423909,13.431518669595231,3196,99.00768748038908,54.904690931910885,0.49386178224035143
27171,"Wright County, Minnesota",131130,66046,65084,32506,84112,17100,4436,936,613,130369,2849,1914,4763,6551,2886,3665,69430,680,5.85,82.3,4.564172958133151,4.995805689010905,5985,99.41965987950888,52.94745672233661,0.5036681156104629
27173,"Yellow Medicine County, Minnesota",9930,5096,4834,28182,6924,819,175,65,33,9762,423,264,687,1215,561,654,4958,40,9.5,84.9,2.7492447129909365,12.235649546827794,273,98.30815709969788,49.92950654582074,0.5131923464249748
28001,"Adams County, Mississippi",31583,15680,15903,17721,21829,2327,1088,286,97,29135,2767,1987,4754,9950,4232,5718,10040,103,10.98,90.9,4.657568945318684,31.504290282747046,1471,92.24899471234525,31.789253712440235,0.4964696197321344
28003,"Alcorn County, Mississippi",37242,18345,18897,20527,25228,2282,1112,485,141,36753,3036,2646,5682,7186,3466,3720,14473,55,5.69,90.4,4.666774072283981,19.295419150421566,1738,98.68696632833897,38.862037484560446,0.4925890124053488
28005,"Amite County, Mississippi",12574,6133,6441,19665,9304,796,362,48,25,12470,899,986,1885,2846,1151,1695,4426,63,9.9,90.4,3.4595196437092413,22.634006680451726,435,99.17289645299824,35.199618259901385,0.48775250516939717
28007,"Attala County, Mississippi",18731,8860,9871,20617,12426,1021,430,39,44,18426,1176,945,2121,4161,1623,2538,6701,260,10.32,90.6,2.7387752922961934,22.214510704180235,513,98.37168330574983,35.774918584165285,0.4730126528215258
28009,"Benton County, Mississippi",8306,4257,4049,18599,5669,355,173,39,16,8234,718,722,1440,1663,809,854,2872,66,7.24,90.7,2.7450036118468577,20.02167108114616,228,99.13315675415362,34.57741391764989,0.5125210691066698
28011,"Bolivar County, Mississippi",33121,15613,17508,16984,21136,2986,1293,292,275,32422,3294,2377,5671,11782,5011,6771,11059,77,7.49,90.4,5.615772470637964,35.57259744572929,1860,97.88955647474413,33.38969234020712,0.47139277195736845
28013,"Calhoun County, Mississippi",14617,6994,7623,17837,9908,579,431,39,64,14429,993,1030,2023,3836,1658,2178,5132,53,6.88,92,3.6532804269001846,26.24341520147773,534,98.71382636655949,35.10980365328043,0.47848395703632757
28015,"Carroll County, Mississippi",10221,5157,5064,22995,7140,789,244,100,38,10062,481,510,991,1404,526,878,3661,0,6.98,91.3,3.7374033851873594,13.736425007337834,382,98.44437921925447,35.81841307112807,0.5045494570002935
28017,"Chickasaw County, Mississippi",17305,8393,8912,19609,11326,1009,218,72,34,17021,1270,1164,2434,3898,1564,2334,6645,78,6.83,92.2,1.8722912453048253,22.525281710488297,324,98.35885582201676,38.39930655879804,0.4850043340075123
28019,"Choctaw County, Mississippi",8360,4100,4260,19816,5795,649,241,39,76,8243,478,255,733,1998,927,1071,2975,67,8.3,91,4.258373205741627,23.89952153110048,356,98.60047846889952,35.58612440191388,0.4904306220095694
28021,"Claiborne County, Mississippi",9106,4269,4837,13095,5312,527,341,68,62,9052,896,519,1415,3897,1846,2051,2319,50,8.4,90.6,5.172413793103448,42.795958708543814,471,99.40698440588623,25.46672523610806,0.4688117724577202
28023,"Clarke County, Mississippi",16089,7575,8514,20564,11108,993,357,112,12,16035,781,804,1585,2961,1141,1820,5958,166,13.69,91,2.9896202374292997,18.40387842625396,481,99.66436695879172,37.03151221331344,0.47081857169494684
28025,"Clay County, Mississippi",19990,9273,10717,19220,13424,1658,802,98,38,19729,1260,1327,2587,5236,2239,2997,7657,18,6.95,92.8,4.692346173086543,26.193096548274138,938,98.69434717358679,38.30415207603802,0.46388194097048524
28027,"Coahoma County, Mississippi",24296,11202,13094,16699,14895,1719,629,147,29,24009,1843,1518,3361,8587,3773,4814,8113,53,7.36,90.2,3.3133026012512348,35.34326638129733,805,98.81873559433652,33.39232795521897,0.4610635495554824
28029,"Copiah County, Mississippi",28748,13762,14986,18756,18896,1806,574,61,71,28599,2301,1996,4297,6782,2895,3887,10100,72,8.55,89.5,2.455823013774871,23.591206344789203,706,99.48170307499652,35.132878808960626,0.4787115625434813
28031,"Covington County, Mississippi",19172,9219,9953,18749,12596,1171,635,199,24,18927,1560,1414,2974,4363,1797,2566,7219,90,14.36,90.3,4.475276444815356,22.75714583767995,858,98.7220947214688,37.65387022741498,0.480857500521594
28033,"DeSoto County, Mississippi",173267,83838,89429,28316,112357,17987,6533,1110,744,172433,9366,8256,17622,16778,7149,9629,84670,440,7.8,91.2,4.840506270668968,9.68332111711982,8387,99.51866194947682,48.86677786306683,0.4838659410043459
28035,"Forrest County, Mississippi",75835,36106,39729,20783,46579,7286,3823,661,684,75208,6592,5012,11604,18998,8406,10592,31756,2412,13.65,90.3,6.814795279224632,25.051757104239467,5168,99.17320498450583,41.87512362365662,0.4761126129096064
28037,"Franklin County, Mississippi",7772,3752,4020,24864,5417,594,211,39,33,7693,572,613,1185,1369,598,771,2797,82,11.62,89.8,3.6412763767370047,17.614513638703038,283,98.98353062274833,35.98816263510036,0.4827586206896552
28039,"George County, Mississippi",23545,11894,11651,20973,15216,1049,603,81,80,23091,1967,1603,3570,3385,1537,1848,7706,191,17.41,90.1,3.2448502866850713,14.376725419409642,764,98.07177744744106,32.7288171586324,0.5051603312805266
28041,"Greene County, Mississippi",13801,8077,5724,18002,9920,610,206,41,6,10482,790,840,1630,1572,640,932,3822,109,18.68,90.3,1.833200492717919,11.390478950800667,253,75.95101804217086,27.693645388015362,0.5852474458372582
28043,"Grenada County, Mississippi",21379,10097,11282,20150,14325,1642,786,85,79,21023,1351,1351,2702,5070,2370,2700,7758,165,6.41,91.9,4.443612891154872,23.714860377005472,950,98.33481453763038,36.287946115346834,0.47228588802095517
28045,"Hancock County, Mississippi",46277,22527,23750,24373,32556,4420,1792,318,275,46072,3973,3579,7552,7921,3705,4216,18905,144,16.48,89.5,5.153748082200662,17.116494154763707,2385,99.55701536400372,40.8518270415109,0.4867860924433304
28047,"Harrison County, Mississippi",200491,98928,101563,23127,131512,18557,7480,1773,1343,193081,17084,15475,32559,39854,17229,22625,88589,651,19.68,88.7,5.285025262979386,19.878199021402455,10596,96.30407349955858,44.186023312767155,0.49342863270670506
28049,"Hinds County, Mississippi",243249,113633,129616,22397,154349,25763,12446,3699,2222,240702,16984,15574,32558,56200,23950,32250,103768,996,8.59,90.9,7.550699077899601,23.103897652200008,18367,98.9529247807802,42.659168177464245,0.467146833080506
28051,"Holmes County, Mississippi",18267,8707,9560,12394,11161,762,340,64,29,18113,1883,1570,3453,8167,3540,4627,4819,59,7.66,91.4,2.370394700826627,44.70903815623802,433,99.15694969069908,26.3809054579296,0.4766518859144906
28053,"Humphreys County, Mississippi",8678,4108,4570,15696,5532,425,289,32,7,8591,805,729,1534,3469,1570,1899,2667,46,7.12,91.7,3.779672735653376,39.97464853652915,328,98.99746485365291,30.73288776215718,0.4733809633556119
28055,"Issaquena County, Mississippi",1296,761,535,16348,1029,25,30,8,0,1046,86,58,144,422,203,219,333,7,8.02,91.4,2.932098765432099,32.56172839506173,38,80.70987654320987,25.694444444444443,0.5871913580246914
28057,"Itawamba County, Mississippi",23439,11651,11788,20859,15658,1275,609,115,29,23212,1507,1213,2720,4107,1959,2148,9094,56,6.15,91.4,3.2125943939587867,17.522078586970434,753,99.03152864883315,38.798583557319,0.4970775203720295
28059,"Jackson County, Mississippi",141314,69696,71618,24665,95361,12245,5678,1300,513,139838,9653,10712,20365,21344,9242,12102,59821,549,18.08,89.5,5.300960980511485,15.103952899217346,7491,98.95551750003538,42.33196993928415,0.49319954144670736
28061,"Jasper County, Mississippi",16547,8008,8539,20619,11241,1013,383,138,34,16455,1121,1072,2193,3766,1874,1892,6406,175,15.35,90.7,3.354082310992929,22.75941258234121,555,99.44400797727685,38.713966277875144,0.48395479543119596
28063,"Jefferson County, Mississippi",7463,3671,3792,13758,4951,244,257,96,33,7018,390,430,820,3301,1303,1998,1756,25,8.98,90.4,5.17218276832373,44.23154227522444,386,94.03725043548171,23.529411764705884,0.49189334047969985
28065,"Jefferson Davis County, Mississippi",11639,5671,5968,17035,8118,792,351,19,53,11531,1160,920,2080,3697,1693,2004,3814,12,12.29,89.8,3.634332846464473,31.763897242031103,423,99.07208523068992,32.76913824211702,0.4872411719219864
28067,"Jones County, Mississippi",68328,33332,34996,20958,44791,4580,2970,514,187,67585,4102,4239,8341,14425,5862,8563,26524,568,16.28,90.6,5.372614447956914,21.111403816883268,3671,98.91259805643368,38.81863950357101,0.4878234398782344
28069,"Kemper County, Mississippi",10082,4970,5112,15790,6914,575,267,52,12,9557,512,574,1086,2905,1025,1880,3500,107,8.93,91.3,3.2830787542154334,28.81372743503273,331,94.79269986113866,34.71533425907558,0.49295774647887325
28071,"Lafayette County, Mississippi",52744,25611,27133,25719,30059,6814,3157,817,1792,52240,3220,2152,5372,12076,5778,6298,24058,162,6.32,91.3,10.932049143030486,22.89549522220537,5766,99.04444107386622,45.61277112088579,0.48557181859548004
28073,"Lamar County, Mississippi",60517,29006,31511,28342,39297,8917,3266,1110,828,59764,3934,3536,7470,9776,4187,5589,27756,1605,14,90.1,8.599236578151594,16.154138506535354,5204,98.75572153279244,45.8647983211329,0.4793033362526232
28075,"Lauderdale County, Mississippi",78221,38002,40219,23339,52004,6551,2853,671,389,75234,4780,5213,9993,16102,6384,9718,32279,385,10.42,91.6,5.002492936679408,20.585264826581096,3913,96.18133237877296,41.266411833139436,0.4858286137993633
28077,"Lawrence County, Mississippi",12659,6150,6509,21826,8422,785,280,48,52,12648,966,1104,2070,2498,1070,1428,4650,64,9.41,89.8,3.0018168891697607,19.73299628722648,380,99.91310530057666,36.7327593016826,0.48582036495773756
28079,"Leake County, Mississippi",22936,11534,11402,18825,14612,1191,413,132,39,22216,1879,1688,3567,5566,2264,3302,8498,68,11.34,90.5,2.5462155563306594,24.267527031740496,584,96.8608301360307,37.050924311126614,0.5028775723753052
28081,"Lee County, Mississippi",84840,40635,44205,23968,55803,8312,3241,1000,543,83914,5297,4696,9993,14466,6508,7958,37658,176,6.38,91.9,5.6388495992456384,17.05091937765205,4784,98.90853371051391,44.38708156529939,0.47896039603960394
28083,"Leflore County, Mississippi",30113,14013,16100,15403,18120,2069,889,184,106,29613,2452,2254,4706,11604,4711,6893,9007,6,7.09,91.3,3.9152525487331054,38.53485205725102,1179,98.3395875535483,29.9106698103809,0.46534719224255305
28085,"Lincoln County, Mississippi",34542,16495,18047,20627,23045,2166,813,262,208,33975,2287,2251,4538,8007,3336,4671,12812,148,11.45,89.2,3.7143188003010827,23.180475942331075,1283,98.35852006253256,37.09107752880551,0.47753459556481964
28087,"Lowndes County, Mississippi",59558,28531,31027,23141,39223,5836,2528,649,249,57746,3723,3868,7591,12243,5312,6931,24700,219,5.91,93.4,5.752375835320192,20.55643238523792,3426,96.95758756170456,41.47217838073811,0.4790456361865744
28089,"Madison County, Mississippi",102212,48966,53246,36627,67127,18123,8282,3065,1733,101092,3958,4014,7972,12043,4695,7348,50594,541,9.98,91.5,12.796931867099753,11.78237388956287,13080,98.90423824991194,49.49908034281689,0.4790631237036747
28091,"Marion County, Mississippi",25466,12421,13045,19610,17197,1512,520,108,83,24698,1939,2064,4003,6396,3068,3328,8924,394,15.06,90.2,2.79195790465719,25.11584072881489,711,96.98421424644624,35.04280216759601,0.48774837037618785
28093,"Marshall County, Mississippi",35981,17793,18188,19775,24467,2395,571,66,185,34688,2887,2943,5830,6032,2548,3484,13924,106,7.57,90.9,2.2845390622828714,16.764403435146328,822,96.40643673049665,38.698201828742945,0.4945109919123982
28095,"Monroe County, Mississippi",35967,17148,18819,21643,24708,3025,855,96,89,35523,2007,1978,3985,6829,2971,3858,14386,30,5.83,92.4,2.8915394667333945,18.986849056079183,1040,98.76553507381766,39.997775738871745,0.47677037284177165
28097,"Montgomery County, Mississippi",10309,4769,5540,22666,7130,1049,330,75,41,10186,405,499,904,2604,866,1738,4046,74,8.07,91.3,4.326316810553885,25.259482006014164,446,98.8068677854302,39.247259676011254,0.4626054903482394
28099,"Neshoba County, Mississippi",29437,14095,15342,19243,18610,1782,613,110,110,29025,2243,1669,3912,6401,2657,3744,11791,200,10.26,90.3,2.8297720555763157,21.744743010496993,833,98.60040085606549,40.05503278187315,0.4788191731494378
28101,"Newton County, Mississippi",21437,10043,11394,21177,13659,1569,520,34,105,21267,1322,1231,2553,4771,1952,2819,7919,124,12.09,91.2,3.0741241778233896,22.25591267434809,659,99.20697858842189,36.94080328404161,0.46848906096935206
28103,"Noxubee County, Mississippi",10942,5206,5736,16591,7161,589,292,19,22,10743,837,692,1529,3725,1659,2066,3783,32,6.6,92.3,3.0433193200511788,34.04313653811003,333,98.18131968561507,34.57320416742826,0.47578139279839154
28105,"Oktibbeha County, Mississippi",49392,24860,24532,21322,25070,5044,3320,660,1652,49024,3031,2362,5393,13152,6380,6772,20185,125,7.45,92.4,11.402656300615485,26.62779397473275,5632,99.2549400712666,40.8669420149012,0.5033203757693554
28107,"Panola County, Mississippi",34229,16553,17676,20191,22328,2188,784,119,117,34024,2614,2363,4977,6979,3216,3763,12399,110,6.79,91,2.9799292997166145,20.389143708551227,1020,99.40109264074323,36.22366998743755,0.48359578135499137
28109,"Pearl River County, Mississippi",55049,27106,27943,22136,37230,3954,1346,128,140,54137,4240,4040,8280,9556,4158,5398,20802,302,17.87,89.8,2.9319333684535596,17.35908009228142,1614,98.34329415611546,37.78815237334012,0.4923976820650693
28111,"Perry County, Mississippi",12047,5858,6189,19308,8225,637,181,51,0,11962,1184,887,2071,2377,850,1527,4140,263,16.04,90.2,1.9257906532746742,19.731053374284055,232,99.29443014858471,34.36540217481531,0.48626213995185524
28113,"Pike County, Mississippi",39763,18890,20873,17470,25292,2563,1169,164,138,39154,2589,2958,5547,12452,5066,7386,13766,493,9.28,90.6,3.699419057918165,31.31554460176546,1471,98.46842542061715,34.62012423609889,0.4750647586952695
28115,"Pontotoc County, Mississippi",31075,15346,15729,20421,20055,2107,688,89,96,30829,3051,2452,5503,5232,2169,3063,13360,288,6.55,91.7,2.809332260659694,16.83668543845535,873,99.20836685438455,42.99275945293645,0.49383748994368465
28117,"Prentiss County, Mississippi",25389,12360,13029,19016,16919,1224,650,170,40,25105,1561,1926,3487,5449,2394,3055,9361,99,5.97,91,3.387293709874355,21.46205049430856,860,98.88140533301824,36.87029816062074,0.4868250029540352
28119,"Quitman County, Mississippi",7537,3618,3919,15189,4999,369,197,23,0,7376,796,783,1579,2762,1188,1574,2257,12,7.16,90.6,2.918933262571315,36.645880323736236,220,97.86387156693645,29.945601698288442,0.48003184290831896
28121,"Rankin County, Mississippi",149645,72198,77447,29055,101973,19423,7622,1747,956,144422,7440,6730,14170,12278,4826,7452,71047,414,9.94,91.2,6.899662534665374,8.204751244612249,10325,96.50973971733102,47.477028968558926,0.4824618263222961
28123,"Scott County, Mississippi",28399,13781,14618,20520,18442,1600,544,91,100,28149,2364,2340,4704,7795,3739,4056,10681,101,12.32,91,2.588119299975351,27.448149582731787,735,99.11968731293355,37.61047924222684,0.4852635656185077
28125,"Sharkey County, Mississippi",4631,2177,2454,17192,3138,486,150,18,20,4531,460,367,827,1315,539,776,1423,7,7.4,91.6,4.05959835888577,28.395594903908442,188,97.84063917080545,30.727704599438567,0.47009285251565536
28127,"Simpson County, Mississippi",27215,13234,13981,19336,18162,1551,660,169,29,26635,1896,2025,3921,7226,3301,3925,10097,146,11.37,90.2,3.1526731581848244,26.55153408047033,858,97.86882234062098,37.10086349439647,0.4862759507624472
28129,"Smith County, Mississippi",16114,7838,8276,21864,10803,774,391,16,11,16028,931,1038,1969,2914,1209,1705,6271,190,15.74,90.8,2.594017624425965,18.08365396549584,418,99.46630259401762,38.91647015017997,0.48640933349882093
28131,"Stone County, Mississippi",17981,9096,8885,21615,11685,1307,313,51,78,17352,1377,818,2195,2995,1540,1455,7548,426,17.93,88.9,2.4581502697291584,16.656470719092376,442,96.50186307769312,41.97764306768256,0.5058673043768422
28133,"Sunflower County, Mississippi",26915,14114,12801,14427,17666,1710,678,78,94,23227,2134,2014,4148,7460,3205,4255,8253,106,7.33,90.7,3.1580902842281255,27.716886494519784,850,86.29760356678432,30.663198959687907,0.5243916031952442
28135,"Tallahatchie County, Mississippi",14552,8496,6056,14163,10390,734,263,11,41,10653,593,715,1308,3007,1253,1754,3917,0,6.72,91.1,2.1646509070918087,20.66382627817482,315,73.20643210555251,26.9172622319956,0.5838372732270478
28137,"Tate County, Mississippi",28333,13879,14454,21671,18395,1922,750,196,95,27857,1940,1483,3423,5099,2167,2932,11398,126,7.79,90.9,3.6741608724808525,17.996682313909574,1041,98.31998023506159,40.228708573042034,0.4898528217979035
28139,"Tippah County, Mississippi",21993,10762,11231,19780,14372,1450,513,55,63,21892,1201,1277,2478,4933,2212,2721,8916,32,5.97,90.5,2.8690947119538035,22.429864047651524,631,99.54076297003591,40.54017187286864,0.48933751648251717
28141,"Tishomingo County, Mississippi",19476,9400,10076,19379,13621,1054,381,83,50,19241,1295,1489,2784,3570,1484,2086,7762,76,5.94,90.4,2.6391456151160404,18.330252618607517,514,98.79338673238858,39.85417950297803,0.48264530704456765
28143,"Tunica County, Mississippi",10276,4818,5458,18486,6668,768,270,98,7,10156,737,843,1580,2746,998,1748,4174,62,8.24,90.8,3.6492798754379137,26.722460101206696,375,98.83223043985987,40.61891786687427,0.46885947839626313
28145,"Union County, Mississippi",28202,13727,14475,19518,18713,1606,824,247,73,27957,1850,1656,3506,5055,1815,3240,11341,40,6.3,91.4,4.056449897170413,17.924260690731153,1144,99.13126728600808,40.21346003829515,0.4867385291823275
28147,"Walthall County, Mississippi",14670,7186,7484,20155,9696,555,331,113,1,14535,1454,1501,2955,3762,1717,2045,5370,133,13.26,90.1,3.0334014996591683,25.644171779141104,445,99.079754601227,36.605316973415135,0.4898432174505794
28149,"Warren County, Mississippi",47510,22609,24901,22542,31711,4219,2283,382,366,47059,3530,3409,6939,11152,4480,6672,19153,176,9.39,91,6.379709534834771,23.472953062513156,3031,99.05072616291307,40.313618185645126,0.4758787623658177
28151,"Washington County, Mississippi",48002,22520,25482,19247,30707,3578,1532,390,330,47575,4477,4483,8960,15987,6843,9144,16942,104,9.98,91.4,4.691471188700471,33.30486229740428,2252,99.11045373109454,35.29436273488604,0.46914711887004706
28153,"Wayne County, Mississippi",20458,10011,10447,21515,13643,880,691,126,22,20336,1361,1042,2403,4889,2402,2487,7599,293,17.82,90.1,4.101085150063545,23.89774171473262,839,99.40365627138527,37.144393391338355,0.48934402189852383
28155,"Webster County, Mississippi",9868,4832,5036,20662,6711,804,379,17,18,9783,735,550,1285,2477,1146,1331,3401,71,7.91,91.6,4.195379002837455,25.10133765707337,414,99.13862991487636,34.46493717065261,0.48966355897851643
28157,"Wilkinson County, Mississippi",9084,4826,4258,12722,6308,585,315,42,0,8027,916,579,1495,3107,1396,1711,2270,10,10.34,90.5,3.92998678996037,34.202994275649495,357,88.36415675913695,24.988991633641568,0.531263760457948
28159,"Winston County, Mississippi",18482,8998,9484,23527,12800,1351,469,80,131,18074,1059,1146,2205,4568,1847,2721,7093,160,7.91,90.7,3.6792554918298888,24.715939833351367,680,97.79244670490206,38.37788118169029,0.4868520722865491
28161,"Yalobusha County, Mississippi",12426,6101,6325,20037,8539,757,329,28,80,12241,1001,558,1559,2756,1177,1579,5199,19,6.24,91.7,3.5168195718654434,22.17930146467085,437,98.51118622243682,41.83969097054563,0.4909866409142121
28163,"Yazoo County, Mississippi",27496,14846,12650,16927,18217,1597,744,89,174,23438,1935,1402,3337,8518,3776,4742,7643,44,8.29,91.8,3.662350887401804,30.979051498399766,1007,85.24148967122491,27.79677043933663,0.5399330811754437
29001,"Adair County, Missouri",25437,12013,13424,21778,13426,2046,1305,193,622,25129,1006,1015,2021,5943,2782,3161,11047,21,6.17,88.7,8.33431615363447,23.363604198608325,2120,98.78916538900027,43.428863466603765,0.47226481110193813
29003,"Andrew County, Missouri",17358,8622,8736,28003,12033,1968,843,148,67,17156,737,470,1207,1533,786,747,8368,28,5.66,88.5,6.095172254868072,8.831662633944003,1058,98.8362714598456,48.20831893075239,0.49671621154510887
29005,"Atchison County, Missouri",5335,2642,2693,28209,3939,683,176,46,11,5248,340,223,563,634,269,365,2628,7,5.77,88.2,4.36738519212746,11.883786316776007,233,98.369259606373,49.25960637300844,0.4952202436738519
29007,"Audrain County, Missouri",25763,11744,14019,21226,17588,1520,662,142,93,23867,1585,1145,2730,3953,1800,2153,10514,175,7.78,88.4,3.481737375305671,15.34370997166479,897,92.64060862477196,40.8104646198036,0.4558475332841672
29009,"Barry County, Missouri",35398,17782,17616,20840,24419,2081,764,189,81,35100,3127,2599,5726,7141,3025,4116,14036,187,14.34,89.2,2.921068986948415,20.173456127464828,1034,99.15814452793943,39.6519577377253,0.502344765240974
29011,"Barton County, Missouri",11942,5924,6018,24628,8091,962,332,107,7,11822,753,591,1344,2460,1130,1330,5287,30,12.4,90,3.7347178027131136,20.599564562049906,446,98.99514319209513,44.27231619494222,0.4960643108357059
29013,"Bates County, Missouri",16405,8010,8395,25873,11218,1086,481,56,55,16098,770,871,1641,2296,1071,1225,7092,57,9.95,89.9,3.6086558975921976,13.995733008229198,592,98.12861932337702,43.23072234074977,0.48826577263029564
29015,"Benton County, Missouri",18918,9308,9610,20163,14558,1005,502,110,73,18717,1253,1114,2367,3456,1477,1979,6033,63,9.05,89.9,3.620890157521937,18.268315889628926,685,98.93751982239138,31.890263241357438,0.4920181837403531
29017,"Bollinger County, Missouri",12347,6180,6167,20687,8687,575,190,13,39,12262,654,617,1271,2438,1074,1364,4750,50,12.3,89.9,1.9599902810399288,19.745687211468372,242,99.31157366161821,38.47088361545315,0.5005264436705272
29019,"Boone County, Missouri",174589,84812,89777,28495,103554,26835,12734,3755,4225,173247,6881,5914,12795,30979,14298,16681,90481,708,8.5,88.7,11.864435903751096,17.743958668644645,20714,99.23133759858868,51.825143623023216,0.48578089112143374
29021,"Buchanan County, Missouri",89425,44847,44578,24271,60333,7885,2867,693,570,86315,4590,4491,9081,14698,6599,8099,41396,302,5.26,89,4.61839530332681,16.43611965334079,4130,96.52222532848756,46.29130556332122,0.501504053676265
29023,"Butler County, Missouri",42826,20735,22091,20855,29343,2899,1228,373,174,42166,2904,2274,5178,9025,3636,5389,16761,223,10.87,90.4,4.144678466352216,21.073646850044366,1775,98.45888011955354,39.13743987297436,0.4841684957735955
29025,"Caldwell County, Missouri",9046,4572,4474,24200,6207,780,200,78,24,8853,466,363,829,1160,502,658,3727,27,5.78,88.6,3.3384921512270616,12.823347335839046,302,97.86646031395092,41.20053062126907,0.5054167587884147
29027,"Callaway County, Missouri",44793,22801,21992,24208,30293,4381,1659,273,228,42166,1665,2090,3755,5012,2042,2970,19814,475,8.51,89.3,4.822182037371911,11.189248320050007,2160,94.1352443462148,44.234590226151404,0.5090304288616525
29029,"Camden County, Missouri",44855,22316,22539,25492,33660,4870,1892,429,210,44391,3089,3142,6231,7753,3472,4281,16856,190,9.76,91,5.6426262401070115,17.284583658455023,2531,98.96555567941144,37.57886523241556,0.49751421246237876
29031,"Cape Girardeau County, Missouri",78013,37860,40153,25965,50086,9378,3957,824,773,76859,3236,3362,6598,13251,6031,7220,36535,317,11,90.2,7.119326266135132,16.985630600028202,5554,98.52075936061938,46.83193826669914,0.48530373142937716
29033,"Carroll County, Missouri",8909,4321,4588,24642,6175,680,323,44,10,8818,506,466,972,1615,710,905,3644,54,8.24,88.6,4.231675833426872,18.127735997306093,377,98.97856100572454,40.90245818834886,0.48501515321584915
29035,"Carter County, Missouri",6255,2981,3274,21569,4245,345,121,38,20,6221,608,584,1192,900,380,520,2463,85,12.77,90.7,2.861710631494804,14.388489208633093,179,99.4564348521183,39.37649880095923,0.47657873701039166
29037,"Cass County, Missouri",101888,50019,51869,30618,68556,11504,4777,911,464,101062,4013,3615,7628,9492,4195,5297,48903,244,11.08,88.6,6.038002512562814,9.316111809045227,6152,99.18930590452261,47.996820037688444,0.49092140389447236
29039,"Cedar County, Missouri",13862,6883,6979,20228,9623,859,330,120,18,13721,1140,871,2011,3079,1591,1488,4900,23,11.5,90.3,3.3761361996825854,22.211802048766412,468,98.98283076035204,35.348434569326216,0.4965372962054538
29041,"Chariton County, Missouri",7586,3768,3818,23463,5352,554,270,22,30,7363,257,272,529,1038,503,535,3100,36,9.86,89.2,4.244661218033219,13.683100448194041,322,97.06037437384656,40.86475085684155,0.4967044555760612
29043,"Christian County, Missouri",83028,40265,42763,26628,55146,10401,3666,768,578,82583,4525,3539,8064,8588,3678,4910,38673,451,15.79,89.6,6.036517801223684,10.343498578792696,5012,99.46403622874212,46.578262754733345,0.4849568820157055
29045,"Clark County, Missouri",6807,3467,3340,26253,4736,430,166,30,0,6714,472,509,981,1023,530,493,3119,40,5.21,88.5,2.8793888644042895,15.02864698104892,196,98.63375936535918,45.8204789187601,0.5093286322902895
29047,"Clay County, Missouri",236068,115761,120307,31953,158358,34344,12482,2514,1254,234562,10211,9246,19457,20693,9102,11591,121057,746,9.49,88.8,6.883609807343647,8.765694630360743,16250,99.36204822339326,51.280563227544604,0.4903714184048664
29049,"Clinton County, Missouri",20495,10282,10213,27655,14114,1803,631,137,38,20026,934,992,1926,2190,916,1274,9540,38,7.37,88.9,3.932666504025372,10.685533056843132,806,97.7116369846304,46.54793852159063,0.5016833373993657
29051,"Cole County, Missouri",76749,38820,37929,27559,52300,10767,4322,1036,320,72770,3394,3356,6750,9027,4393,4634,36268,279,8.64,89.8,7.398141995335444,11.761716765039283,5678,94.81556762954567,47.25533883177631,0.5058046358910214
29053,"Cooper County, Missouri",17620,9267,8353,22371,12161,1792,578,111,37,16047,743,639,1382,1787,786,1001,7715,72,8.4,89.1,4.120317820658343,10.141884222474461,726,91.07264472190693,43.785471055618615,0.5259364358683314
29055,"Crawford County, Missouri",24387,12030,12357,20799,16860,1257,485,53,90,24074,2015,1985,4000,4803,2119,2684,9224,42,11.23,91,2.5751424939516956,19.69491942428343,628,98.7165292983967,37.82343051625866,0.493295608315906
29057,"Dade County, Missouri",7581,3877,3704,20468,5431,516,208,64,33,7444,639,482,1121,1691,876,815,2987,47,12.3,90.9,4.023215934573275,22.305764411027567,305,98.19285054742119,39.40113441498483,0.5114101042078881
29059,"Dallas County, Missouri",16441,8117,8324,19647,11351,782,473,44,78,16240,1692,1625,3317,2553,1132,1421,5821,130,11.84,90,3.6190012772945686,15.52825253938325,595,98.7774466273341,35.40538896660787,0.49370476248403383
29061,"Daviess County, Missouri",8300,4164,4136,22642,5520,683,169,41,64,8097,762,706,1468,1066,472,594,3496,114,6.4,88.7,3.3012048192771086,12.843373493975903,274,97.55421686746988,42.12048192771084,0.5016867469879518
29063,"DeKalb County, Missouri",12564,8007,4557,18994,9411,1015,275,57,18,9060,401,281,682,1135,497,638,4263,47,5.73,89.1,2.7857370264247057,9.033747214262974,350,72.11079274116523,33.93027698185291,0.6372970391595033
29065,"Dent County, Missouri",15566,7774,7792,20908,10953,915,399,61,39,15389,1495,1299,2794,3178,1420,1758,5741,82,13.9,90.4,3.205704741102403,20.416291918283438,499,98.86290633431838,36.881665167673134,0.4994218167801619
29067,"Douglas County, Missouri",13391,6704,6687,18095,9636,601,261,35,10,13275,1032,1001,2033,2718,1386,1332,4858,27,15.93,89.5,2.2851168695392428,20.29721454708386,306,99.13374654618774,36.27809722948249,0.5006347546859832
29069,"Dunklin County, Missouri",30905,14856,16049,18878,20341,1658,629,277,50,30233,2314,2263,4577,8025,3616,4409,11482,78,7.15,90.1,3.0933505905193335,25.96667205953729,956,97.82559456398641,37.1525643099822,0.48069891603300435
29071,"Franklin County, Missouri",102413,51044,51369,27209,70279,9306,3987,630,388,101627,4386,3943,8329,10740,4694,6046,49317,282,9.53,91.2,4.887074883071485,10.486949898938612,5005,99.23251930907209,48.15501938230498,0.4984132873756261
29073,"Gasconade County, Missouri",14769,7371,7398,25963,10592,1194,487,56,79,14507,497,430,927,1726,835,891,6707,29,8.86,90.1,4.211524138397996,11.686640937097975,622,98.22601394813461,45.41268873992823,0.4990859232175503
29075,"Gentry County, Missouri",6688,3225,3463,20903,4514,639,214,27,23,6535,322,301,623,1180,530,650,2988,25,7.95,88.3,3.9473684210526314,17.64354066985646,264,97.71232057416267,44.677033492822964,0.48220693779904306
29077,"Greene County, Missouri",286759,139733,147026,25529,186539,35715,14748,3344,3006,282952,17786,15211,32997,50765,22424,28341,135689,988,13.44,90,7.3573976753999,17.703018911350647,21098,98.6724043534815,47.31813125307314,0.48728374697917065
29079,"Grundy County, Missouri",10111,4937,5174,22014,6814,749,349,91,31,9936,877,709,1586,2008,917,1091,4472,61,7.06,88.5,4.658292948274157,19.859558896251606,471,98.26921174957967,44.22905746216991,0.4882800909900109
29081,"Harrison County, Missouri",8615,4280,4335,20947,5915,600,208,35,16,8397,651,538,1189,1527,714,813,3759,89,7.62,88.4,3.0063842135809633,17.72489843296576,259,97.46952988972723,43.63319791062101,0.4968078932095183
29083,"Henry County, Missouri",21834,10783,11051,24371,15529,1716,604,111,39,21577,1531,1029,2560,4524,2126,2398,8804,90,7.7,90.2,3.453329669323074,20.719978015938445,754,98.82293670422277,40.322432902812125,0.4938627828157919
29085,"Hickory County, Missouri",9352,4547,4805,19711,7275,427,247,11,31,9273,768,699,1467,2143,905,1238,3147,55,10.29,90,3.0902480752780153,22.914884516680925,289,99.15526090675792,33.65055603079555,0.4862061591103507
29087,"Holt County, Missouri",4499,2239,2260,25306,3355,525,163,19,22,4384,218,193,411,527,236,291,2104,19,5.82,88.8,4.534340964658813,11.713714158701933,204,97.44387641698155,46.76594798844187,0.4976661480328962
29089,"Howard County, Missouri",10144,5069,5075,23430,6573,1085,480,34,80,10019,480,370,850,1551,829,722,4724,78,7.7,88.8,5.855678233438486,15.289826498422713,594,98.76774447949526,46.56940063091483,0.49970425867507884
29091,"Howell County, Missouri",40139,19656,20483,20274,27123,2359,1288,344,187,39727,2478,2393,4871,9026,4024,5002,16205,91,16.11,90.1,4.531752161239692,22.486858167866664,1819,98.97356685517826,40.372206582127106,0.48969829841301477
29093,"Iron County, Missouri",10286,5114,5172,19414,7387,559,230,17,59,9953,848,635,1483,2083,1108,975,3733,47,13.07,90.6,2.974917363406572,20.25082636593428,306,96.76258992805755,36.29204744312658,0.49718063387128136
29095,"Jackson County, Missouri",688554,332936,355618,28965,464577,89255,36929,9222,4773,681702,44784,40789,85573,108026,47792,60234,333107,3004,10.97,88.4,7.395788856066481,15.688820339435978,50924,99.00487107764968,48.3777597690232,0.4835292511553197
29097,"Jasper County, Missouri",118522,57694,60828,23390,77228,12331,3950,731,506,117521,7868,7484,15352,20083,8800,11283,55749,338,12.18,91.3,4.376402693170888,16.94453350432831,5187,99.15543105921263,47.03683704291186,0.48677882587199
29099,"Jefferson County, Missouri",222639,110772,111867,27443,152103,19821,8197,1089,965,220994,10197,9389,19586,24077,10777,13300,107502,436,10.09,92.3,4.604314607952785,10.814367653465924,10251,99.26113573991978,48.285340843248484,0.4975408621131069
29101,"Johnson County, Missouri",53941,27891,26050,23304,30916,5310,2513,413,539,50163,2572,2149,4721,7953,4055,3898,26753,112,8.79,89.2,6.423685137465008,14.743886839324446,3465,92.9960512411709,49.59678166886042,0.5170649413247808
29103,"Knox County, Missouri",3976,2010,1966,22171,2699,292,102,18,16,3905,370,406,776,787,366,421,1619,10,5.74,88.6,3.420523138832998,19.793762575452718,136,98.21428571428571,40.71931589537223,0.505533199195171
29105,"Laclede County, Missouri",35488,17562,17926,20534,24088,2302,645,236,115,35130,2209,2176,4385,6198,2856,3342,14749,146,11.6,89.6,2.8065825067628496,17.465058611361588,996,98.99120829576195,41.56052750225428,0.49487150586113615
29107,"Lafayette County, Missouri",32655,16121,16534,27260,22557,2755,1045,123,204,32169,1727,1257,2984,4081,1688,2393,14951,192,8.68,89,4.201500535905681,12.497320471596998,1372,98.51171336701883,45.78471903230746,0.49367631296891745
29109,"Lawrence County, Missouri",38131,19072,19059,21022,25502,2845,1046,139,29,37556,2788,2480,5268,6387,2822,3565,16353,400,13.4,89.8,3.183761244132071,16.75015079594031,1214,98.49204059688967,42.88636542445779,0.5001704649760038
29111,"Lewis County, Missouri",10078,5081,4997,22083,6546,528,240,61,112,9883,579,531,1110,1418,580,838,4751,56,5.75,88.6,4.098035324469141,14.070252034133757,413,98.06509228021433,47.14229013693193,0.5041674935503077
29113,"Lincoln County, Missouri",54800,27365,27435,24023,35866,3830,1491,105,196,54290,2311,2462,4773,7122,2983,4139,24608,262,8.69,89.8,3.27007299270073,12.996350364963504,1792,99.06934306569343,44.90510948905109,0.49936131386861315
29115,"Linn County, Missouri",12248,5907,6341,22361,8403,816,312,94,22,12156,753,734,1487,1999,824,1175,5464,86,9.31,88.7,3.4944480731548007,16.321032005225344,428,99.24885695623776,44.611365120836055,0.4822828216851731
29117,"Livingston County, Missouri",15025,6805,8220,22248,10655,1335,546,103,21,13830,881,837,1718,2469,1041,1428,6534,75,8,88.3,4.4592346089850246,16.43261231281198,670,92.04658901830283,43.48752079866888,0.4529118136439268
29119,"McDonald County, Missouri",22753,11613,11140,19577,14918,1139,418,197,148,22584,2176,2211,4387,4269,2065,2204,8897,89,14.46,90.5,3.353403946732299,18.762361007339692,763,99.25724080341054,39.102535929328,0.5103942337274205
29121,"Macon County, Missouri",15319,7601,7718,20890,10557,1081,471,38,22,15047,895,747,1642,2563,1226,1337,6299,98,8.19,88.7,3.4662836999804165,16.73085710555519,531,98.22442718193093,41.118871989033224,0.49618121287290295
29123,"Madison County, Missouri",12226,6004,6222,20081,8550,787,225,17,37,12042,670,775,1445,2241,891,1350,4887,118,13.83,89.8,2.282021920497301,18.32978897431703,279,98.49501063307704,39.97219041387208,0.491084573858989
29125,"Maries County, Missouri",8959,4496,4463,22087,6342,606,184,56,16,8850,537,665,1202,1673,838,835,3702,38,10.02,90,2.8574617702868625,18.673959147226252,256,98.78334635562004,41.32157606875767,0.5018417234066302
29127,"Marion County, Missouri",28703,13841,14862,22662,19324,2742,950,210,131,28031,1574,1661,3235,5013,2111,2902,12929,65,6.51,88.7,4.49778768769815,17.46507333728182,1291,97.65878131205797,45.044072048217956,0.4822144026756785
29129,"Mercer County, Missouri",3669,1835,1834,20374,2484,267,144,9,17,3612,393,364,757,634,271,363,1566,21,6.08,87.9,4.633415099482148,17.2799127827746,170,98.44644317252657,42.68192968111202,0.5001362769146906
29131,"Miller County, Missouri",24947,12291,12656,23346,17040,1752,820,91,64,24636,1626,1146,2772,4061,1751,2310,10783,200,9.2,90.9,3.908285565398645,16.278510442137332,975,98.75335711708823,43.22363410430112,0.4926844911211769
29133,"Mississippi County, Missouri",13916,7495,6421,17918,9809,791,271,52,0,12182,1041,998,2039,3843,1580,2263,4729,17,7.31,89.3,2.3210692727795346,27.61569416498994,323,87.53952285139408,33.98246622592699,0.5385886749065824
29135,"Moniteau County, Missouri",15904,8350,7554,21305,10772,1422,368,67,27,14549,1161,1005,2166,1730,780,950,6684,134,8.43,89.4,2.9049295774647885,10.877766599597585,462,91.48013078470825,42.027162977867206,0.5250251509054326
29137,"Monroe County, Missouri",8676,4390,4286,22255,6169,627,201,45,15,8572,513,555,1068,1109,519,590,3837,59,7.52,88.3,3.008298755186722,12.782388197325957,261,98.8012909174735,44.22544951590595,0.5059935454126325
29139,"Montgomery County, Missouri",11618,5798,5820,21757,8172,685,314,30,25,11292,619,500,1119,1804,778,1026,4953,5,8.15,89.8,3.1761060423480805,15.527629540368395,369,97.19400929592013,42.6321225684283,0.49905319332070924
29141,"Morgan County, Missouri",20097,10028,10069,20055,14376,1178,467,116,48,19735,2462,2335,4797,5011,2458,2553,7045,217,9.08,89.9,3.139772105289347,24.93406976165597,631,98.19873612977061,35.0549833308454,0.4989799472558093
29143,"New Madrid County, Missouri",18030,8681,9349,20261,12437,878,607,47,36,17674,1550,1601,3151,4240,1805,2435,6802,14,7.02,89.4,3.826955074875208,23.516361619523018,690,98.0255130338325,37.726012201885744,0.4814753189129229
29145,"Newton County, Missouri",58237,28926,29311,25837,39048,5053,1693,516,319,57590,4012,3812,7824,7389,3178,4211,26634,350,13.59,91,4.340882943832958,12.687810155056065,2528,98.88902244277693,45.733811837835056,0.49669454127101326
29147,"Nodaway County, Missouri",22744,11302,11442,21056,12572,1916,890,244,319,21906,999,1016,2015,4438,1881,2557,11343,58,7.43,87.9,6.388498065423848,19.51283855082659,1453,96.31551178332747,49.872493844530425,0.49692226521280336
29149,"Oregon County, Missouri",10779,5261,5518,18309,7611,597,280,61,35,10653,951,924,1875,2662,1210,1452,4106,76,11.95,90.9,3.4882642174598755,24.696168475739864,376,98.83106039521292,38.0925874385379,0.48807867149086187
29151,"Osage County, Missouri",13610,7105,6505,24995,9216,1270,373,80,10,13472,499,307,806,912,483,429,6803,82,8.95,90.1,3.4019103600293903,6.700955180014695,463,98.9860396767083,49.985304922850844,0.5220426157237326
29153,"Ozark County, Missouri",9328,4665,4663,17857,6962,522,301,90,33,9273,752,560,1312,2549,1241,1308,3010,20,16.06,90.1,4.545454545454546,27.326329331046313,424,99.41037735849056,32.26843910806175,0.5001072041166381
29155,"Pemiscot County, Missouri",17344,8210,9134,18883,11212,815,483,34,15,17170,1149,1340,2489,4859,1994,2865,6176,38,5.88,89.7,3.0673431734317345,28.015452029520294,532,98.99677121771218,35.608856088560884,0.47336254612546125
29157,"Perry County, Missouri",19135,9429,9706,24846,13028,1434,572,117,0,18824,526,576,1102,1530,610,920,9041,23,13.15,89.8,3.6007316435850534,7.99581917951398,689,98.37470603605958,47.24849751763784,0.49276195453357724
29159,"Pettis County, Missouri",42309,20777,21532,22304,28073,3194,1274,324,173,41611,2840,2703,5543,7125,3179,3946,18486,52,8.76,89,4.185870618544517,16.840388569807843,1771,98.35023281098584,43.6928313124867,0.4910775485121369
29161,"Phelps County, Missouri",44873,23605,21268,23691,27855,4569,2129,465,818,44040,2303,1832,4135,8542,4486,4056,18643,224,11.74,90.4,7.603681501125398,19.03594589173891,3412,98.143649856261,41.54614133220422,0.5260401577786197
29163,"Pike County, Missouri",18517,10202,8315,20947,12759,1471,442,58,12,16253,1046,836,1882,2444,977,1467,7486,110,7.94,89.1,2.7650267321920396,13.19868229194794,512,87.77339741858833,40.427715072635955,0.5509531781606092
29165,"Platte County, Missouri",96899,47719,49180,37443,65703,16804,7999,1465,999,95953,3263,3284,6547,6936,2851,4085,51724,290,9.34,89,10.797841050991238,7.1579686064871675,10463,99.02372573504371,53.37929183995707,0.4924612225100362
29167,"Polk County, Missouri",31347,15257,16090,21357,19983,2532,1240,160,124,30941,2041,1970,4011,4309,1791,2518,13643,51,11.64,90.6,4.861709254474112,13.746132006252592,1524,98.70482023798131,43.522506140938525,0.4867132420965324
29169,"Pulaski County, Missouri",53132,30361,22771,21716,29223,4860,2465,81,135,39627,2208,2084,4292,5567,2697,2870,28614,144,11.39,91.4,5.045923360686592,10.477678235338402,2681,74.58217270194986,53.854550929759846,0.5714258827072197
29171,"Putnam County, Missouri",4846,2436,2410,20729,3438,434,142,16,31,4788,385,298,683,808,333,475,2018,8,4.67,87.7,3.900123813454395,16.673545191910854,189,98.80313660751135,41.64259182831201,0.5026826248452332
29173,"Ralls County, Missouri",10208,5170,5038,24687,7247,602,263,70,23,10145,481,373,854,1342,669,673,4955,19,7.28,88.6,3.487460815047022,13.14655172413793,356,99.3828369905956,48.5403605015674,0.5064655172413793
29175,"Randolph County, Missouri",24987,13075,11912,19984,17130,1551,704,127,123,22953,1250,1143,2393,3758,1643,2115,9970,57,7.48,88.6,3.817985352383239,15.03982070676752,954,91.85976707888102,39.900748389162366,0.5232721014927763
29177,"Ray County, Missouri",22859,11351,11508,26781,15756,1627,521,98,24,22593,1145,964,2109,3527,1705,1822,10390,40,7.78,88.6,2.812896452163262,15.42937136357671,643,98.83634454700555,45.452556979745395,0.4965659040202984
29179,"Reynolds County, Missouri",6361,3245,3116,21593,4628,322,108,10,12,6216,344,451,795,1067,533,534,2469,33,14,90.8,2.043703820154064,16.774092123879893,130,97.7204842005974,38.81465178431064,0.5101399151076875
29181,"Ripley County, Missouri",13807,6906,6901,18434,9629,722,319,53,54,13750,1140,848,1988,3187,1457,1730,5165,77,8.73,90.6,3.0853914680958936,23.082494386905193,426,99.5871659303252,37.40856087491852,0.5001810675744188
29183,"St. Charles County, Missouri",385115,189365,195750,35628,258840,62970,27901,2816,2391,383181,10926,10188,21114,21362,9279,12083,203675,1037,9.67,91.2,8.596912610518936,5.546914557989172,33108,99.49781234176804,52.88680004673929,0.49171026836139853
29185,"St. Clair County, Missouri",9396,4744,4652,20827,6996,571,287,59,37,9144,819,653,1472,2017,920,1097,3263,74,9.83,90.5,4.07620263942103,21.46658152405279,383,97.31800766283524,34.72754363558961,0.5048957002979991
29186,"Ste. Genevieve County, Missouri",17882,8934,8948,26418,12563,1218,547,69,120,17676,480,642,1122,2934,1203,1731,8300,44,12.94,90.8,4.1158707079745,16.40756067553965,736,98.84800357901801,46.415389777429816,0.49960854490549156
29187,"St. Francois County, Missouri",66248,35790,30458,20944,46373,3715,1882,362,190,59613,3708,3183,6891,9139,4409,4730,26026,143,12.94,90.8,3.674073179567685,13.79513343799058,2434,89.98460330877913,39.285714285714285,0.5402427243086584
29189,"St. Louis County, Missouri",999539,474110,525429,38081,688617,171204,86895,22204,14534,987505,38556,34822,73378,95974,39955,56019,488114,3174,9.8,91.5,12.369002109972698,9.601826441989758,123633,98.79604497673428,48.8339124336319,0.47432866551480235
29195,"Saline County, Missouri",23010,11372,11638,21729,15142,1744,819,157,113,22549,980,1054,2034,3759,1660,2099,10320,147,7.64,89,4.732724902216428,16.336375488917863,1089,97.99652325076053,44.85006518904824,0.4942199043893959
29197,"Schuyler County, Missouri",4450,2204,2246,19882,2915,223,142,33,9,4398,393,259,652,803,359,444,1826,20,5.01,88.3,4.134831460674158,18.04494382022472,184,98.8314606741573,41.03370786516854,0.4952808988764045
29199,"Scotland County, Missouri",4883,2382,2501,23785,3112,289,90,0,14,4786,843,648,1491,792,331,461,2129,56,5.2,88.6,2.1298382142125742,16.219537169772682,104,98.01351628097481,43.600245750563175,0.4878148679090723
29201,"Scott County, Missouri",38858,18844,20014,22939,26329,2155,1063,242,130,38369,2255,2344,4599,7646,3391,4255,16824,84,8.74,89.8,3.692933244119615,19.676771835915385,1435,98.74157187709095,43.296103762417005,0.4849451850326831
29203,"Shannon County, Missouri",8273,4048,4225,17903,5822,556,224,35,14,8207,714,757,1471,2483,1061,1422,2820,49,15.5,90.8,3.299891212377614,30.0132962649583,273,99.20222410250211,34.08678834763689,0.48930255046536925
29205,"Shelby County, Missouri",6084,3053,3031,22349,4188,475,112,42,30,5870,476,411,887,899,417,482,2924,13,8.34,88.2,3.0243261012491782,14.77646285338593,184,96.48257725180802,48.06048652202498,0.5018080210387903
29207,"Stoddard County, Missouri",29634,14405,15229,21684,20643,1919,804,116,79,29208,1898,1952,3850,4864,1904,2960,12523,116,9.37,89.9,3.3711277586555983,16.41357899709793,999,98.56246203684957,42.25889181345752,0.48609705068502396
29209,"Stone County, Missouri",31529,15426,16103,26052,24153,3099,1007,239,102,31200,1702,2077,3779,3999,1771,2228,11966,25,14.67,90.1,4.2754289701544606,12.68356116591075,1348,98.95651622315962,37.952361318151546,0.48926385232642966
29211,"Sullivan County, Missouri",6382,3187,3195,21168,4433,276,156,21,20,6239,451,527,978,989,357,632,2648,28,5.29,87.9,3.086806643685365,15.49670949545597,197,97.75932309620808,41.49169539329364,0.49937323722970856
29213,"Taney County, Missouri",54308,26360,27948,21381,37285,4460,1517,420,224,53887,4782,5308,10090,8996,4032,4964,23821,141,14.95,90.6,3.979155925462179,16.564778669809236,2161,99.22479192752449,43.862782647123815,0.48537968623407235
29215,"Texas County, Missouri",25714,13248,12466,17918,17866,1718,594,109,42,24269,2203,1769,3972,6102,2956,3146,8701,60,14.74,89.6,2.8972544139379326,23.73026366959633,745,94.38049311659019,33.837598195535506,0.5152057245080501
29217,"Vernon County, Missouri",20665,10060,10605,22369,13820,1428,725,162,80,20180,1453,1608,3061,3018,1367,1651,9232,88,10.66,89.8,4.6794096298088554,14.604403580933946,967,97.65303653520445,44.67457052988144,0.4868134526977982
29219,"Warren County, Missouri",33554,16773,16781,26845,23096,2810,1132,229,139,33380,1673,1515,3188,4256,1886,2370,14617,99,8.98,90.6,4.470405912856887,12.684031710079275,1500,99.4814329141086,43.562615485486084,0.49988078917565715
29221,"Washington County, Missouri",24968,12855,12113,18314,17250,1003,449,63,25,23855,1784,1669,3453,4749,1966,2783,8822,103,10.98,92.2,2.1507529637936558,19.020346042934957,537,95.54229413649472,35.333226529958345,0.5148590195450177
29223,"Wayne County, Missouri",13369,6597,6772,18897,9617,832,250,22,57,13239,966,892,1858,3065,1244,1821,4398,23,13.34,90.2,2.4609170468995436,22.926172488593014,329,99.0276011668786,32.897000523599374,0.4934550078539906
29225,"Webster County, Missouri",37558,19170,18388,20468,24355,2439,1080,231,79,36636,3317,2764,6081,6694,3281,3413,14790,191,14.35,88.9,3.7009425422013953,17.823100271579957,1390,97.54513019862613,39.37909366845945,0.5104105649928111
29227,"Worth County, Missouri",2053,999,1054,22961,1490,185,72,19,8,1996,103,85,188,299,141,158,959,0,7.41,87.8,4.822211397954213,14.564052605942523,99,97.22357525572333,46.71212859230395,0.48660496833901606
29229,"Wright County, Missouri",18304,9012,9292,19805,12401,866,368,103,124,18111,1924,1527,3451,4493,2112,2381,6399,95,14.45,88.8,3.2506555944055946,24.546547202797203,595,98.94558566433567,34.95957167832168,0.4923513986013986
29510,"St. Louis city, Missouri",314867,152224,162643,26739,220141,41639,21940,6571,4958,310171,22088,18713,40801,76472,34548,41924,149811,1097,9.64,91.5,10.629567404650217,24.287079941689665,33469,98.5085766371198,47.57913658782915,0.48345491906106386
30001,"Beaverhead County, Montana",9360,4694,4666,28420,6378,1420,404,175,103,9233,433,412,845,1433,653,780,4525,34,2.75,79.5,7.286324786324786,15.30982905982906,682,98.6431623931624,48.3440170940171,0.5014957264957265
30003,"Big Horn County, Montana",13290,6566,6724,17905,7572,888,321,37,84,13160,2654,2512,5166,3504,1667,1837,4776,48,3.28,90.8,3.3258088788562827,26.36568848758465,442,99.02182091798345,35.93679458239278,0.4940556809631302
30005,"Blaine County, Montana",6646,3316,3330,17059,4025,666,138,13,15,6550,771,693,1464,2142,977,1165,2396,13,1.56,91,2.4977430033102617,32.22991272946133,166,98.55552211856757,36.051760457418,0.4989467348781222
30007,"Broadwater County, Montana",5755,2896,2859,32268,4210,866,293,18,26,5711,308,332,640,448,174,274,2492,20,2.13,86.4,5.855777584708949,7.784535186794092,337,99.23544743701129,43.30147697654214,0.5032145960034753
30009,"Carbon County, Montana",10466,5271,5195,31697,7986,1680,565,139,103,10380,534,530,1064,1031,444,587,5052,107,3.43,84.2,7.710682209057902,9.850945920122301,807,99.17829161093063,48.270590483470286,0.5036308045098414
30011,"Carter County, Montana",1320,660,660,30659,973,136,18,2,6,1298,87,106,193,152,66,86,599,25,2.93,92.7,1.9696969696969697,11.515151515151516,26,98.33333333333333,45.378787878787875,0.5
30013,"Cascade County, Montana",81816,41259,40557,28350,55331,10120,3849,886,259,78089,4313,3704,8017,10410,4603,5807,38845,189,2.89,89.4,6.103940549525765,12.723672631270167,4994,95.44465630194583,47.478488315243965,0.5042901144030507
30015,"Chouteau County, Montana",5812,2884,2928,22014,3896,763,208,12,13,5766,484,513,997,1163,530,633,2448,26,2.17,91.7,4.008947006194081,20.010323468685478,233,99.20853406744666,42.11975223675155,0.49621472814865797
30017,"Custer County, Montana",11895,5916,5979,28501,8329,1351,376,58,77,11674,494,482,976,1124,475,649,6360,41,2.25,95.6,4.295922656578394,9.449348465741908,511,98.14207650273224,53.46784363177806,0.4973518284993695
30019,"Daniels County, Montana",1788,926,862,36108,1293,244,44,6,4,1760,56,49,105,81,38,43,915,0,0.9,89.5,3.0201342281879193,4.530201342281879,54,98.43400447427292,51.1744966442953,0.5178970917225951
30021,"Dawson County, Montana",9324,4869,4455,29130,6456,941,233,101,3,9011,343,426,769,1088,594,494,4762,20,2.17,92.9,3.614328614328614,11.668811668811669,337,96.64307164307165,51.07250107250107,0.5222007722007722
30023,"Deer Lodge County, Montana",9131,4778,4353,25107,6812,768,317,66,11,8535,501,269,770,1605,803,802,3800,52,3.85,80.6,4.314970977987077,17.57748329865294,394,93.47278501807031,41.61647136129668,0.5232723688533567
30025,"Fallon County, Montana",2925,1526,1399,32371,1961,212,42,4,54,2856,155,120,275,164,65,99,1569,7,2.85,93.3,3.4188034188034186,5.6068376068376065,100,97.64102564102564,53.64102564102564,0.5217094017094017
30027,"Fergus County, Montana",11327,5701,5626,27491,8301,1832,479,69,67,11146,674,537,1211,1640,783,857,5476,71,2.73,90.4,5.429504723227686,14.478679261940496,615,98.40204820340779,48.3446631941379,0.5033106736117242
30029,"Flathead County, Montana",96147,47965,48182,28379,67650,13384,3963,1465,879,95564,5477,4959,10436,12886,6041,6845,45445,426,6.41,82.7,6.559747053990244,13.402394250470634,6307,99.39363682694209,47.26616535097299,0.4988715196521992
30031,"Gallatin County, Montana",100733,52057,48676,33181,63818,20309,7298,1557,1992,100355,5105,3731,8836,12625,6532,6093,55572,306,3.7,82.4,10.768070046558725,12.533132141403513,10847,99.62475057826134,55.16762133560998,0.5167819880277565
30033,"Garfield County, Montana",1086,560,526,29896,754,106,24,2,0,1086,77,67,144,55,22,33,573,4,1.99,93.8,2.394106813996317,5.064456721915286,26,100,52.76243093922652,0.5156537753222836
30035,"Glacier County, Montana",13677,6888,6789,16737,7946,1078,281,82,20,13551,3038,2897,5935,4437,2067,2370,4441,23,4.5,82.9,2.8003217079768956,32.44132485194122,383,99.0787453388901,32.47057103165899,0.5036192147400745
30037,"Golden Valley County, Montana",747,373,374,25110,574,97,19,0,2,747,34,75,109,136,52,84,341,6,2.73,90.7,2.8112449799196786,18.20615796519411,21,100,45.64926372155288,0.499330655957162
30039,"Granite County, Montana",3206,1622,1584,29144,2404,373,178,35,14,3178,183,152,335,312,144,168,1154,6,4.18,81.6,7.080474111041797,9.731752963194012,227,99.12663755458516,35.99500935745477,0.5059263880224579
30041,"Hill County, Montana",16468,8332,8136,21780,10249,1858,371,78,122,16337,944,911,1855,3393,1455,1938,6992,52,1.84,90.8,3.467330580519796,20.603594850619384,571,99.20451785280544,42.45810055865922,0.5059509351469517
30043,"Jefferson County, Montana",11625,5955,5670,32387,8435,1963,545,145,120,11458,538,547,1085,1139,522,617,5218,61,2.42,84.4,6.967741935483871,9.79784946236559,810,98.56344086021505,44.88602150537634,0.512258064516129
30045,"Judith Basin County, Montana",1965,1047,918,28709,1533,363,62,4,5,1965,55,128,183,273,149,124,955,11,2.67,86.2,3.61323155216285,13.893129770992367,71,100,48.600508905852415,0.5328244274809161
30047,"Lake County, Montana",29518,14595,14923,24348,20121,3318,1335,367,211,29358,2825,2616,5441,6109,3036,3073,11660,84,4.44,87.3,6.480791381529914,20.69584660207331,1913,99.45795785622332,39.501321227725455,0.49444406802628904
30049,"Lewis and Clark County, Montana",66290,32898,33392,31252,46485,11201,4662,1036,544,65677,2607,2250,4857,7409,3665,3744,33823,217,4.01,85,9.416201538693619,11.176648061547745,6242,99.07527530547594,51.02277869965304,0.4962739478050988
30051,"Liberty County, Montana",2245,1144,1101,36525,1656,208,27,15,20,2224,175,62,237,309,143,166,1114,0,2.14,88.8,2.7616926503340755,13.763919821826281,62,99.06458797327394,49.62138084632517,0.5095768374164811
30053,"Lincoln County, Montana",19249,9634,9615,22483,14579,2213,571,160,26,19068,1519,1204,2723,3120,1330,1790,6381,107,6.38,83.7,3.9326718271079018,16.208634214764402,757,99.05969141254091,33.1497740142345,0.5004935321315394
30055,"McCone County, Montana",1728,923,805,28230,1233,196,11,5,2,1707,56,40,96,127,78,49,790,0,1.51,93.9,1.0416666666666667,7.349537037037037,18,98.78472222222223,45.717592592592595,0.5341435185185185
30057,"Madison County, Montana",7902,4070,3832,31620,6225,1276,433,71,109,7842,542,460,1002,832,419,413,3713,49,3.51,81.8,7.757529739306505,10.52898000506201,613,99.24069855732726,46.98810427739813,0.5150594786130094
30059,"Meagher County, Montana",2000,972,1028,20095,1390,212,45,16,0,1975,120,125,245,313,114,199,876,19,2.7,83.7,3.05,15.65,61,98.75,43.8,0.486
30061,"Mineral County, Montana",4194,2121,2073,22894,3089,295,114,24,37,4140,305,187,492,834,403,431,1556,11,9.44,84.7,4.172627563185503,19.88555078683834,175,98.71244635193133,37.10061993323796,0.505722460658083
30063,"Missoula County, Montana",114231,57590,56641,29681,75530,19658,8028,2489,1979,113621,6020,4980,11000,17695,8661,9034,60157,490,5.58,85.1,10.939237159790249,15.490541096549974,12496,99.46599434479256,52.66258721362853,0.5041538636622283
30065,"Musselshell County, Montana",4766,2368,2398,23908,3446,303,145,61,7,4733,254,250,504,812,356,456,1812,55,2.94,92.5,4.469156525388166,17.03734788082249,213,99.30759546789761,38.0193033990768,0.49685270667226183
30067,"Park County, Montana",16001,7994,8007,29181,12028,2771,965,225,136,15909,1117,819,1936,2135,993,1142,7846,79,4.1,81.2,8.286982063621023,13.342916067745765,1326,99.42503593525404,49.03443534779076,0.4995937753890382
30069,"Petroleum County, Montana",453,235,218,31549,368,68,17,4,4,453,36,54,90,45,24,21,252,2,2.77,93.2,5.518763796909492,9.933774834437086,25,100,55.629139072847686,0.5187637969094923
30071,"Phillips County, Montana",4139,2096,2043,22369,2849,394,103,14,5,4098,434,274,708,732,334,398,1647,0,1.14,92.7,2.9475718772650397,17.68543126359024,122,99.00942256583716,39.792220343078036,0.5064025126842232
30073,"Pondera County, Montana",6081,3004,3077,22866,4113,680,149,48,31,6012,411,347,758,1136,532,604,2550,3,2.39,87.1,3.7493833251110016,18.6811379707285,228,98.86531820424273,41.93389245189936,0.4939976977470811
30075,"Powder River County, Montana",1610,776,834,31211,1226,260,31,10,13,1579,87,141,228,129,60,69,949,0,2.82,95,3.3540372670807455,8.012422360248447,54,98.07453416149069,58.94409937888199,0.48198757763975153
30077,"Powell County, Montana",6852,4243,2609,23990,5290,582,305,34,41,5244,342,250,592,761,397,364,2518,14,4.88,83.5,5.545826036193812,11.10624635143024,380,76.5323992994746,36.74839462930531,0.619235259778167
30079,"Prairie County, Montana",1325,681,644,28366,962,164,18,6,9,1307,41,43,84,130,54,76,626,8,1.89,93.9,2.490566037735849,9.81132075471698,33,98.64150943396227,47.24528301886792,0.5139622641509434
30081,"Ravalli County, Montana",41387,20574,20813,25151,30399,5102,2239,295,406,41146,2797,2443,5240,6562,2826,3736,17008,237,5.15,82.1,7.103679899485345,15.855220238239061,2940,99.417691545654435,41.095029840288014,0.49711261990480105
30083,"Richland County, Montana",11405,5795,5610,33709,7551,1085,312,59,29,11405,829,766,1595,669,267,402,5860,57,1.88,92.8,3.5072336694432265,5.865848312143797,400,100,51.38097325734327,0.5081104778605875
30085,"Roosevelt County, Montana",11218,5543,5675,18030,6443,718,235,23,20,10988,1455,1181,2636,3176,1487,1689,3734,9,1.25,92.2,2.4781600998395437,28.311642003922266,278,97.94972365840613,33.285790693528256,0.49411659832412197
30087,"Rosebud County, Montana",9292,4654,4638,23832,5846,859,203,12,23,9213,908,866,1774,1755,879,876,3997,44,2.12,94.2,2.5613430908308223,18.887214808437367,238,99.14980628497632,43.0154972018941,0.5008609556607835
30089,"Sanders County, Montana",11414,5843,5571,23020,8687,1137,254,77,38,11284,788,1064,1852,2378,1084,1294,3963,47,6.97,86.4,3.2328719116874014,20.834063430874366,369,98.86104783599089,34.72051866129315,0.5119151918696337
30091,"Sheridan County, Montana",3568,1792,1776,32833,2581,415,115,8,0,3519,176,140,316,428,194,234,1796,10,1.4,89.9,3.447309417040359,11.995515695067265,123,98.62668161434978,50.336322869955154,0.5022421524663677
30093,"Silver Bow County, Montana",34514,17354,17160,26248,23241,4123,1314,383,206,33928,1660,1539,3199,6442,3031,3411,16019,323,3.09,82.4,5.513704583647216,18.66488961001333,1903,98.30213826273396,46.41304977690213,0.5028104537289216
30095,"Stillwater County, Montana",9342,4651,4691,31583,6714,1204,377,58,38,9296,376,434,810,600,244,356,4410,147,3.75,85.9,5.063155641190323,6.422607578676943,473,99.50760008563476,47.20616570327553,0.4978591308071077
30097,"Sweet Grass County, Montana",3646,1763,1883,28065,2657,528,118,30,0,3623,156,101,257,376,147,229,1536,27,3.5,84.7,4.05924300603401,10.312671420735052,148,99.36917169500823,42.12835984640702,0.48354360943499725
30099,"Teton County, Montana",6040,2969,3071,26884,4177,689,228,56,17,5976,296,295,591,583,296,287,2716,76,2.47,86.7,4.983443708609271,9.652317880794701,301,98.94039735099338,44.966887417218544,0.4915562913907285
30101,"Toole County, Montana",5031,2865,2166,26354,3620,396,79,61,1,4389,315,244,559,721,359,362,2175,5,2.5,88.5,2.802623732856291,14.331146889286424,141,87.23911747167561,43.231961836612996,0.569469290399523
30103,"Treasure County, Montana",790,377,413,22880,576,102,25,3,3,790,17,29,46,134,69,65,383,6,2.27,93.4,3.9240506329113924,16.962025316455698,31,100,48.48101265822785,0.4772151898734177
30105,"Valley County, Montana",7561,3763,3798,29096,5325,833,227,37,24,7448,464,251,715,546,249,297,3746,12,0.97,90.9,3.8090199709033197,7.221267028170877,288,98.50548869197196,49.543711149318874,0.4976854913371247
30107,"Wheatland County, Montana",2108,1084,1024,20165,1384,198,47,2,0,2076,189,117,306,411,193,218,943,0,2.4,87.5,2.3244781783681217,19.497153700189752,49,98.4819734345351,44.73434535104364,0.5142314990512334
30109,"Wibaux County, Montana",1121,560,561,24662,811,159,20,3,2,1096,53,67,120,116,43,73,554,3,2.6,92.2,2.230151650312221,10.347903657448706,25,97.76984834968778,49.420160570918824,0.49955396966993754
30111,"Yellowstone County, Montana",156332,76868,79464,32296,106431,22324,6869,1984,980,154062,8758,7289,16047,15432,6568,8864,79002,414,2.59,92.5,6.289819102934779,9.871299542000358,9833,98.5479620295269,50.53475935828877,0.4916971573318323
31001,"Adams County, Nebraska",31564,15981,15583,28085,20397,2989,1314,286,209,31285,1402,1003,2405,3698,1549,2149,15569,101,6.68,89,5.731212774046382,11.715878849322012,1809,99.116081611963,49.32518058547713,0.5063046508680775
31003,"Antelope County, Nebraska",6406,3213,3193,28091,4480,614,186,18,17,6310,272,244,516,729,342,387,3131,27,6.15,87.5,3.449890727443022,11.379956290977209,221,98.50140493287543,48.87605369965657,0.5015610365282548
31005,"Arthur County, Nebraska",421,204,217,21799,264,60,15,3,1,421,15,27,42,46,20,26,169,0,3.97,90.2,4.513064133016627,10.926365795724466,19,100,40.142517814726844,0.4845605700712589
31007,"Banner County, Nebraska",728,356,372,30736,517,62,13,11,4,728,26,30,56,65,26,39,395,0,4.19,91.1,3.8461538461538463,8.928571428571429,28,100,54.25824175824176,0.489010989010989
31009,"Blaine County, Nebraska",502,256,246,28503,356,51,17,15,3,502,40,25,65,49,31,18,277,7,8.1,92,6.972111553784861,9.760956175298805,35,100,55.179282868525895,0.5099601593625498
31011,"Boone County, Nebraska",5357,2691,2666,28861,3709,533,158,15,29,5255,160,124,284,381,161,220,2729,11,5.1,87.6,3.7707672204592124,7.11218965839089,202,98.09594922531268,50.942691805114805,0.5023333955572149
31013,"Box Butte County, Nebraska",11200,5671,5529,28483,7514,963,319,25,0,11037,308,478,786,1195,393,802,5374,30,4.21,90.4,3.0714285714285716,10.669642857142858,344,98.54464285714286,47.982142857142854,0.5063392857142858
31015,"Boyd County, Nebraska",2049,1038,1011,26413,1516,247,46,6,7,2022,140,119,259,197,82,115,1017,4,5.92,91.3,2.8794533918984873,9.614446071254271,59,98.68228404099561,49.633967789165446,0.5065885797950219
31017,"Brown County, Nebraska",3058,1468,1590,29664,2302,287,68,26,37,3013,150,215,365,480,222,258,1545,27,6.49,93.4,4.283845650752125,15.696533682145192,131,98.52844996729888,50.52321778940484,0.48005232177894047
31019,"Buffalo County, Nebraska",48834,24367,24467,28553,29817,6777,2194,471,576,48238,2220,1765,3985,6669,2964,3705,26901,203,5.46,88.8,6.636769463898104,13.656468853667526,3241,98.77953884588607,55.08661997788426,0.49897612319285745
31021,"Burt County, Nebraska",6546,3231,3315,26421,4673,660,176,47,9,6446,233,356,589,791,319,472,2965,25,6.83,88,3.5441490986862205,12.083715245951726,232,98.47234952642836,45.29483654139933,0.49358386801099907
31023,"Butler County, Nebraska",8105,4085,4020,27216,5572,793,200,30,17,7934,262,251,513,619,272,347,4019,39,7.17,87.3,3.0475015422578657,7.6372609500308455,247,97.89019123997532,49.58667489204195,0.5040098704503393
31025,"Cass County, Nebraska",25513,12813,12700,32509,17389,3177,1177,166,137,25028,749,709,1458,1584,746,838,13265,43,6.75,87.9,5.800964214322111,6.208599537490691,1480,98.09900834868499,51.993101556069455,0.5022145572845216
31027,"Cedar County, Nebraska",8561,4349,4212,29694,5785,769,242,33,23,8412,252,212,464,810,373,437,4478,66,5.97,88.9,3.4809017638126387,9.461511505665227,298,98.25954911809369,52.30697348440603,0.5080014017054082
31029,"Chase County, Nebraska",3803,1892,1911,33708,2697,405,91,4,24,3734,209,212,421,297,98,199,1944,70,3.37,93.4,3.1291085984748883,7.8096239810675785,119,98.18564291348935,51.1175387851696,0.49750197212726793
31031,"Cherry County, Nebraska",5792,2871,2921,27891,4142,593,129,11,98,5740,201,212,413,515,179,336,3205,17,4.63,92.2,4.109116022099448,8.89157458563536,238,99.10220994475138,55.334944751381215,0.49568370165745856
31033,"Cheyenne County, Nebraska",10012,4899,5113,32995,6914,1422,249,114,31,9914,395,289,684,1078,479,599,5470,15,3.16,92,3.9352776667998404,10.767079504594486,394,99.02117459049141,54.63443867359169,0.48931282461046743
31035,"Clay County, Nebraska",6264,3210,3054,27275,4298,559,148,31,28,6165,314,353,667,682,286,396,3066,30,6.7,89.4,3.3045977011494254,10.887611749680715,207,98.41954022988506,48.946360153256705,0.5124521072796935
31037,"Colfax County, Nebraska",10616,5527,5089,23393,6504,604,227,93,15,10531,762,534,1296,849,488,361,5084,136,5.82,89.2,3.1556141672946496,7.997362471740769,335,99.19932177844763,47.889977392614924,0.5206292388847024
31039,"Cuming County, Nebraska",9039,4557,4482,28762,6111,958,233,80,26,8890,473,292,765,705,199,506,4702,20,7.1,88.2,3.750414868901427,7.799535346830401,339,98.35158756499612,52.019028653612125,0.5041486890142715
31041,"Custer County, Nebraska",10836,5357,5479,32605,7549,1100,350,76,111,10714,634,556,1190,1271,463,808,5525,56,7.23,90.5,4.955703211517165,11.729420450350682,537,98.87412329272794,50.9874492432632,0.4943706164636397
31043,"Dakota County, Nebraska",20529,10074,10455,22463,12588,1048,445,52,41,20314,1459,1700,3159,3408,1504,1904,10088,35,7.64,88.7,2.6206829363339668,16.600906035364606,538,98.95270105704125,49.140240635198985,0.49072044424959815
31045,"Dawes County, Nebraska",8972,4495,4477,24811,5404,1152,479,153,213,8896,635,488,1123,1129,507,622,4546,30,3.38,92,9.418189924208649,12.58359340169416,845,99.15292019616585,50.668747213553274,0.5010031208203299
31047,"Dawson County, Nebraska",23925,12235,11690,24912,15275,1687,515,150,63,23641,1507,1516,3023,3214,1415,1799,11974,50,4.21,89.9,3.0428422152560084,13.433646812957157,728,98.81295715778474,50.048066875653085,0.5113897596656217
31049,"Deuel County, Nebraska",1901,915,986,28225,1365,166,67,10,4,1882,173,114,287,207,85,122,986,44,3.02,92,4.260915307732772,10.889005786428196,81,99.00052603892688,51.86743819042609,0.4813256180957391
31051,"Dixon County, Nebraska",5765,2905,2860,26094,3885,503,197,12,20,5683,262,195,457,585,289,296,2901,11,6.6,88.4,3.972246313963573,10.147441457068517,229,98.57762359063314,50.32090199479618,0.5039028620988725
31053,"Dodge County, Nebraska",36576,17980,18596,27162,24593,3076,1246,207,148,36025,2084,1884,3968,4677,2035,2642,18020,71,5.93,89,4.377187226596676,12.787073490813649,1601,98.49354768153981,49.26727909011374,0.4915791776027997
31055,"Douglas County, Nebraska",549706,270917,278789,32023,356837,88266,31836,9836,5444,543154,29296,25525,54821,72562,32224,40338,281724,2390,6.81,88.4,8.571127111583282,13.200146987662496,47116,98.80809014273085,51.24994087748724,0.49283980891603874
31057,"Dundy County, Nebraska",2017,1004,1013,26949,1363,209,67,12,0,1978,204,165,369,208,87,121,912,19,3.58,93.5,3.9167079821517103,10.312345066931085,79,98.06643529995043,45.21566683192861,0.4977689638076351
31059,"Fillmore County, Nebraska",5603,2800,2803,30874,4053,571,150,19,37,5374,267,186,453,531,201,330,2819,25,5.89,89.5,3.6766018204533286,9.477065857576298,206,95.9129038015349,50.312332678922004,0.4997322862752097
31061,"Franklin County, Nebraska",3019,1514,1505,28635,2243,338,67,36,7,2956,76,92,168,391,170,221,1478,9,6.54,91.1,3.64359059291156,12.951308380258364,110,97.91321629678701,48.95660814839351,0.5014905597880093
31063,"Frontier County, Nebraska",2624,1324,1300,27900,1789,223,105,8,13,2616,119,123,242,270,83,187,1219,12,4.22,92.9,4.801829268292683,10.289634146341463,126,99.6951219512195,46.45579268292683,0.5045731707317073
31065,"Furnas County, Nebraska",4814,2356,2458,24522,3395,506,79,15,19,4731,216,164,380,636,245,391,2343,14,6.22,92.2,2.3473203157457414,13.211466555878687,113,98.27586206896552,48.670544245949316,0.4894058994599086
31067,"Gage County, Nebraska",21632,10816,10816,27424,15359,2244,575,198,106,21332,586,496,1082,1925,772,1153,10972,65,5.89,89.4,4.063424556213017,8.898853550295858,879,98.61316568047337,50.72115384615385,0.5
31069,"Garden County, Nebraska",1913,960,953,35602,1509,263,65,34,3,1861,75,70,145,218,86,132,896,7,3.18,91.2,5.331939362258233,11.395713538944067,102,97.28175640355462,46.83742812336644,0.501829587036069
31071,"Garfield County, Nebraska",1958,970,988,25856,1409,197,59,13,6,1913,58,60,118,137,72,65,974,8,5.99,89.2,3.9836567926455566,6.996935648621042,78,97.70173646578141,49.744637385086826,0.49540347293156284
31073,"Gosper County, Nebraska",2019,988,1031,31901,1484,279,62,13,3,1983,64,74,138,113,38,75,1113,14,5.53,90.3,3.863298662704309,5.596830113917781,78,98.21693907875186,55.12630014858841,0.4893511639425458
31075,"Grant County, Nebraska",682,346,336,22693,483,89,21,1,0,680,46,37,83,138,54,84,338,10,4.14,90.2,3.225806451612903,20.234604105571847,22,99.70674486803519,49.56011730205279,0.5073313782991202
31077,"Greeley County, Nebraska",2436,1203,1233,25544,1697,205,67,11,11,2409,82,85,167,236,88,148,1167,6,5.52,88.7,3.6535303776683086,9.688013136288998,89,98.89162561576354,47.9064039408867,0.4938423645320197
31079,"Hall County, Nebraska",61233,30843,30390,26419,39161,5391,1668,477,215,60427,4652,3846,8498,8133,3625,4508,31308,269,6.13,88.5,3.854130942465664,13.282053794522561,2360,98.68371629676808,51.12929302826907,0.5036989858409681
31081,"Hamilton County, Nebraska",9149,4566,4583,31989,6218,1120,397,66,13,9010,231,220,451,643,288,355,4744,33,6.26,88.4,5.202754399387911,7.028090501694174,476,98.48070827412832,51.85266149305935,0.499070936714395
31083,"Harlan County, Nebraska",3469,1811,1658,26375,2498,377,63,27,0,3418,145,171,316,441,171,270,1557,2,6.19,91.4,2.5944076102623232,12.712597290285386,90,98.52983568751802,44.883251657538196,0.5220524646872298
31085,"Hayes County, Nebraska",957,494,463,27183,698,101,17,2,0,957,70,87,157,86,43,43,499,3,4.46,92.9,1.9853709508881923,8.986415882967608,19,100,52.14211076280042,0.51619644723092994
31087,"Hitchcock County, Nebraska",2860,1423,1437,25290,2052,216,130,3,9,2823,186,193,379,398,180,218,1305,0,5.19,93.6,4.965034965034965,13.916083916083917,142,98.7062937062937,45.62937062937063,0.49755244755244754
31089,"Holt County, Nebraska",10293,5157,5136,27858,7159,1061,303,110,26,10130,432,377,809,899,410,489,5565,53,6.11,89.8,4.265034489458856,8.734091129894102,439,98.41639949480229,54.06587000874381,0.501020110754882
31091,"Hooker County, Nebraska",684,315,369,27714,540,88,50,0,0,658,13,26,39,114,51,63,299,9,4.7,90.2,7.309941520467836,16.666666666666668,50,96.19883040935673,43.71345029239766,0.4605263157894737
31093,"Howard County, Nebraska",6385,3212,3173,26734,4425,682,146,38,24,6378,232,167,399,646,283,363,3258,24,6.07,88.7,3.2576350822239624,10.117462803445575,208,99.89036805011746,51.025841816758025,0.503054032889585
31095,"Jefferson County, Nebraska",7276,3511,3765,26859,5232,571,152,28,19,7164,263,143,406,755,266,489,3627,7,6.62,90.7,2.7350192413413965,10.376580538757558,199,98.46069268829027,49.84881803188565,0.4825453545904343
31097,"Johnson County, Nebraska",5200,3087,2113,22398,3745,451,149,21,27,3995,123,169,292,405,160,245,1987,15,5.35,88.7,3.7884615384615383,7.788461538461538,197,76.82692307692308,38.21153846153846,0.5936538461538462
31099,"Kearney County, Nebraska",6547,3229,3318,31234,4485,760,189,41,12,6474,256,252,508,605,283,322,3404,4,6.24,89.3,3.6963494730410877,9.240873682602718,242,98.88498548953719,51.99327936459447,0.49320299373758975
31101,"Keith County, Nebraska",8129,4121,4008,27890,6007,950,207,70,97,8068,457,427,884,1051,535,516,4043,139,3.32,91.4,4.600811907983762,12.929019559601427,374,99.24960019682618,49.73551482347152,0.5069504244064461
31103,"Keya Paha County, Nebraska",720,368,352,28981,533,71,22,13,4,720,29,30,59,55,20,35,427,0,5.02,94.6,5.416666666666667,7.638888888888889,39,100,59.30555555555556,0.5111111111111111
31105,"Kimball County, Nebraska",3688,1840,1848,24011,2612,316,120,15,5,3627,254,250,504,412,206,206,1694,8,3.7,91,3.7960954446854664,11.171366594360087,140,98.34598698481562,45.93275488069414,0.49891540130151846
31107,"Knox County, Nebraska",8496,4147,4349,27283,5899,886,251,67,25,8277,438,453,891,1018,385,633,4197,17,6.67,89.6,4.037193973634651,11.98210922787194,343,97.42231638418079,49.39971751412429,0.4881120527306968
31109,"Lancaster County, Nebraska",306357,153788,152569,29901,189221,45943,16868,4168,4660,301968,14020,11002,25022,40887,18548,22339,164852,756,6.74,88.1,8.38760008747964,13.3461941460453,25696,98.5673576905375,53.81042378662802,0.5019895089715594
31111,"Lincoln County, Nebraska",35569,17490,18079,29687,24416,3630,1378,196,214,35153,1525,1743,3268,4373,1690,2683,17131,81,4.3,91.6,5.02684922263769,12.294413674829205,1788,98.83044223902837,48.16272596924288,0.49172031825465995
31113,"Logan County, Nebraska",919,471,448,24624,600,119,11,6,0,919,61,31,92,88,38,50,438,2,5.04,90.8,1.8498367791077257,9.57562568008705,17,100,47.66050054406964,0.5125136017410229
31115,"Loup County, Nebraska",537,260,277,29248,401,68,20,4,0,537,23,14,37,48,22,26,267,2,7.02,90.4,4.4692737430167595,8.938547486033519,24,100,49.720670391061454,0.48417132216014896
31117,"McPherson County, Nebraska",432,221,211,27241,322,63,16,0,2,432,5,14,19,69,31,38,223,11,4.04,90.2,4.166666666666667,15.972222222222221,18,100,51.620370370370374,0.5115740740740741
31119,"Madison County, Nebraska",35062,17437,17625,26093,22903,3250,969,339,111,34438,1665,1582,3247,5440,2262,3178,18020,238,5.87,87.7,4.047116536421197,15.51537276823912,1419,98.22029547658434,51.39467229479208,0.4973190348525469
31121,"Merrick County, Nebraska",7829,3898,3931,27223,5476,775,133,33,22,7715,404,256,660,759,338,421,4031,29,7.16,88.4,2.401328394430962,9.694724741346276,188,98.54387533529186,51.48805722314472,0.4978924511431856
31123,"Morrill County, Nebraska",4903,2460,2443,25120,3400,476,143,21,3,4741,329,226,555,444,171,273,2372,20,3.49,92.1,3.4060779114827655,9.055680195798491,167,96.69590046910055,48.37854374872527,0.5017336324699164
31125,"Nance County, Nebraska",3569,1764,1805,26852,2517,256,150,38,17,3472,136,144,280,405,195,210,1783,15,7.06,88.4,5.743905855982068,11.347716447184085,205,97.28215186326702,49.95797142056598,0.49425609414401794
31127,"Nemaha County, Nebraska",7041,3476,3565,28572,4572,897,313,25,43,6930,271,188,459,751,405,346,3392,0,6.36,88.6,5.411163187047294,10.666098565544667,381,98.42351938645079,48.174975145575914,0.4936798750177532
31129,"Nuckolls County, Nebraska",4318,2163,2155,24426,3167,383,144,43,36,4237,263,171,434,451,187,264,2213,3,6.22,90.1,5.1644279759147755,10.444650301065309,223,98.12413154238074,51.25057897174618,0.500926354793886
31131,"Otoe County, Nebraska",15875,7783,8092,28567,10819,1691,489,83,56,15632,640,532,1172,1555,740,815,7987,26,5.8,88.4,3.955905511811024,9.795275590551181,628,98.46929133858268,50.31181102362205,0.49026771653543305
31133,"Pawnee County, Nebraska",2704,1317,1387,27196,1983,235,57,18,6,2666,220,152,372,546,248,298,1191,2,5.68,88.9,2.9955621301775146,20.192307692307693,81,98.59467455621302,44.04585798816568,0.4870562130177515
31135,"Perkins County, Nebraska",2904,1474,1430,30923,2085,340,85,44,9,2867,94,72,166,137,45,92,1439,5,3.55,92,4.75206611570248,4.71763085399449,138,98.72589531680441,49.55234159779614,0.5075757575757576
31137,"Phelps County, Nebraska",9163,4603,4560,30166,6274,1185,307,55,85,8928,257,214,471,626,193,433,4676,14,5.37,89.4,4.8783149623485755,6.831823638546328,447,97.43533777147222,51.03132161955691,0.5023463931026956
31139,"Pierce County, Nebraska",7175,3598,3577,28766,4862,800,240,31,23,7041,184,107,291,479,189,290,3608,40,7.16,87.9,4.097560975609756,6.67595818815331,294,98.13240418118467,50.285714285714285,0.5014634146341463
31141,"Platte County, Nebraska",32875,16662,16213,28187,21469,3184,990,277,165,32585,1569,1098,2667,2777,1225,1552,17430,142,6.56,88.4,4.355893536121673,8.447148288973384,1432,99.11787072243347,53.01901140684411,0.5068288973384031
31143,"Polk County, Nebraska",5244,2578,2666,32424,3633,566,158,26,8,5150,303,233,536,389,196,193,2710,23,8.19,87.9,3.6613272311212817,7.418001525553013,192,98.20747520976354,51.67810831426392,0.4916094584286804
31145,"Red Willow County, Nebraska",10870,5552,5318,25006,7352,928,248,148,53,10616,564,396,960,1220,723,497,5448,122,4.53,93.8,4.130634774609016,11.223551057957682,449,97.66329346826127,50.11959521619135,0.5107635694572217
31147,"Richardson County, Nebraska",8045,4036,4009,28109,5858,866,218,32,22,7899,302,282,584,1289,598,691,3903,34,5.38,89.1,3.3809819763828464,16.022374145431947,272,98.18520820385332,48.51460534493474,0.5016780609073959
31149,"Rock County, Nebraska",1381,690,691,33867,1010,146,27,1,17,1343,73,95,168,128,37,91,747,4,5.82,91.4,3.2585083272990585,9.268645908761767,45,97.24837074583635,54.091238233164376,0.499637943519189
31151,"Saline County, Nebraska",14325,7320,7005,22324,8783,802,292,52,35,14043,742,665,1407,1544,645,899,6846,35,6.09,88.7,2.6457242582897034,10.778359511343805,379,98.03141361256544,47.79057591623037,0.5109947643979058
31153,"Sarpy County, Nebraska",175188,87568,87620,33103,111217,28689,12282,1878,1058,171101,5433,4579,10012,9155,3872,5283,93783,555,7.14,88.2,8.686668036623512,5.225814553508231,15218,97.66707765372057,53.53277621754915,0.4998515880083111
31155,"Saunders County, Nebraska",20953,10546,10407,31163,14199,2583,941,105,127,20683,626,392,1018,1860,806,1054,10902,73,6.93,88.1,5.598243688254665,8.877010451963919,1173,98.71140170858588,52.03073545554336,0.5033169474538253
31157,"Scotts Bluff County, Nebraska",36509,17659,18850,26532,24349,3663,1219,265,222,35917,2281,1970,4251,4698,1986,2712,17269,121,3.76,92.6,4.672820400449204,12.868059930428114,1706,98.37848201813252,47.300665589306746,0.4836889534087485
31159,"Seward County, Nebraska",17045,8582,8463,29398,10824,2031,629,194,183,16761,518,486,1004,1436,703,733,8643,19,6.24,87,5.902024053974773,8.424757993546494,1006,98.3338222352596,50.70695218539161,0.5034907597535935
31161,"Sheridan County, Nebraska",5241,2604,2637,25817,3751,694,206,55,11,5176,397,364,761,816,376,440,2594,17,3.81,90.5,5.189849265407365,15.569547796222095,272,98.75977866819309,49.49437130318641,0.4968517458500286
31163,"Sherman County, Nebraska",3048,1518,1530,27983,2213,280,102,22,0,2986,131,102,233,318,109,209,1469,22,6.92,89,4.0682414698162725,10.433070866141732,124,97.96587926509186,48.19553805774278,0.49803149606299213
31165,"Sioux County, Nebraska",1256,647,609,26852,909,204,35,3,0,1256,51,53,104,156,70,86,660,4,3.29,90.7,3.0254777070063694,12.420382165605096,38,100,52.547770700636946,0.5151273885350318
31167,"Stanton County, Nebraska",6020,3013,3007,29517,4043,552,144,4,13,5978,276,255,531,568,259,309,3138,12,6.35,88.6,2.6744186046511627,9.435215946843854,161,99.30232558139535,52.12624584717608,0.5004983388704319
31169,"Thayer County, Nebraska",5133,2547,2586,31129,3708,565,150,16,35,4985,153,119,272,545,250,295,2469,8,6.76,90.6,3.9158386908240796,10.617572569647379,201,97.11669588934346,48.10052600818235,0.4962010520163647
31171,"Thomas County, Nebraska",643,344,299,29243,459,112,15,6,0,643,27,11,38,80,45,35,358,0,6.3,91.5,3.265940902021773,12.441679626749611,21,100,55.67651632970451,0.5349922239502333
31173,"Thurston County, Nebraska",7055,3502,3553,19380,3830,413,126,52,22,7005,1009,965,1974,2124,981,1143,2521,29,8.15,87.6,2.8348688873139616,30.106307583274273,200,99.2912827781715,35.733522324592485,0.4963855421686747
31175,"Valley County, Nebraska",4252,2111,2141,27271,3059,473,109,25,15,4208,229,149,378,482,197,285,2264,0,6.15,89.2,3.5042333019755407,11.335841956726247,149,98.96519285042334,53.24553151458137,0.4964722483537159
31177,"Washington County, Nebraska",20414,10118,10296,33136,13730,3100,859,149,119,20234,556,578,1134,1959,650,1309,10660,56,6.61,88.2,5.520721073772901,9.596355442343489,1127,99.11825217987655,52.21906534731067,0.4956402468893896
31179,"Wayne County, Nebraska",9409,4772,4637,27292,5381,1249,338,86,69,9375,311,300,611,1102,632,470,4875,4,7.73,88,5.239664151344457,11.712190455946434,493,99.63864385163141,51.812094802848335,0.5071739823573175
31181,"Webster County, Nebraska",3597,1774,1823,26136,2517,355,197,15,6,3517,150,168,318,395,182,213,1679,3,6.32,90.6,6.0606060606060606,10.981373366694468,218,97.77592438142896,46.67778704475952,0.4931887684181262
31183,"Wheeler County, Nebraska",846,444,402,28257,650,87,30,7,0,846,22,23,45,22,10,12,480,6,5.69,88.6,4.373522458628842,2.600472813238771,37,100,56.737588652482266,0.524822695035461
31185,"York County, Nebraska",13832,6795,7037,28298,9379,1843,513,148,129,13172,572,447,1019,1253,473,780,6972,3,5.98,88,5.711393869288606,9.058704453441296,790,95.22845575477155,50.40485829959514,0.49125216888374784
32001,"Churchill County, Nevada",24022,12177,11845,25211,16340,2048,721,178,43,23152,1598,1622,3220,3245,1575,1670,9865,75,2.03,95.6,3.9214053784031306,13.508450586961951,942,96.37831987344934,41.066522354508365,0.5069103321954874
32003,"Clark County, Nevada",2112436,1056002,1056434,27719,1428870,222051,77575,22082,11045,2088806,163634,143800,307434,304449,141523,162926,968735,13750,2.18,101.1,5.240490126091394,14.412223612928392,110702,98.88138622897924,45.85866743418499,0.4998977483814894
32005,"Douglas County, Nevada",47632,24047,23585,35727,36100,6139,2641,760,269,47330,2799,2306,5105,4647,2219,2428,20356,76,10.61,87.2,7.704904266039637,9.756046355391334,3670,99.36597245549211,42.73597581457843,0.5048496808867988
32007,"Elko County, Nevada",52377,27185,25192,32498,33076,3848,1677,247,66,51729,2547,2905,5452,5931,2825,3106,26249,150,3.31,88.5,3.7993775893999273,11.323672604387422,1990,98.76281573973309,50.11550871565763,0.5190255264715429
32009,"Esmeralda County, Nevada",1102,485,617,23755,818,110,13,7,7,1097,94,128,222,75,22,53,445,0,2.07,94.4,2.4500907441016335,6.805807622504537,27,99.54627949183303,40.381125226860256,0.4401088929219601
32011,"Eureka County, Nevada",1728,849,879,35606,1265,135,27,0,9,1723,144,91,235,173,89,84,904,0,2.59,90.2,2.0833333333333335,10.011574074074074,36,99.71064814814815,52.31481481481482,0.4913194444444444
32013,"Humboldt County, Nevada",17088,8879,8209,29215,10965,1009,420,207,34,16871,1221,1476,2697,1535,659,876,8338,82,3.48,92.3,3.8682116104868913,8.982911985018726,661,98.73010299625469,48.79447565543071,0.5196044007490637
32015,"Lander County, Nevada",5887,3276,2611,30256,3897,275,178,64,0,5845,263,294,557,769,402,367,2667,24,2.35,91.1,4.110752505520638,13.06268048241889,242,99.28656361474435,45.30321046373365,0.5564803804994055
32017,"Lincoln County, Nevada",5203,2780,2423,27218,3643,510,271,0,11,4696,261,229,490,568,274,294,1759,0,2.38,93.9,5.419950028829521,10.916778781472228,282,90.25562175667883,33.80741879684797,0.5343071305016337
32019,"Lyon County, Nevada",52303,26400,25903,25063,37297,3580,1579,160,152,52010,3265,2769,6034,7148,3459,3689,20682,138,4.88,93.2,3.6154713878745004,13.666520084889967,1891,99.43980268818233,39.542664856700384,0.5047511615012523
32021,"Mineral County, Nevada",4471,2165,2306,22791,3290,303,145,0,13,4399,327,348,675,894,339,555,1664,7,3.25,92.4,3.5338850369044956,19.995526727801387,158,98.38962200849922,37.217624692462536,0.4842317154998882
32023,"Nye County, Nevada",43296,21789,21507,23740,33362,2766,838,161,61,42853,3143,2315,5458,7388,3470,3918,14319,140,2,93,2.4482631189948263,17.063932002956392,1060,98.97681079083519,33.07233924611973,0.5032566518847007
32027,"Pershing County, Nevada",6661,4337,2324,19201,5137,381,265,47,10,4714,397,381,778,709,269,440,2115,15,3.17,95,4.834108992643747,10.644047440324275,322,70.77015463143672,31.75198919081219,0.6511034379222339
32029,"Storey County, Nevada",3891,1894,1997,36388,3228,531,115,37,56,3860,241,99,340,300,177,123,1775,0,7.61,89.9,5.345669493703418,7.710100231303007,208,99.20328964276536,45.618093035209455,0.4867643279362632
32031,"Washoe County, Nevada",445551,224212,221339,31879,305049,57226,22486,6263,4905,442940,28742,23525,52267,58642,27916,30726,215877,1968,5.3,90.4,7.5533440616225755,13.161680705463572,33654,99.41398403325321,48.451692398849964,0.5032240978024962
32033,"White Pine County, Nevada",9858,5820,4038,25350,7022,693,289,12,30,8381,479,457,936,1092,591,501,3476,26,2.18,87.6,3.35767904240211,11.077297626293365,331,85.01724487725706,35.26070196794482,0.5903834449178332
32510,"Carson City, Nevada",54219,27794,26425,28044,38664,5006,2195,707,432,52287,3321,2753,6074,7698,3584,4114,23925,122,8.82,88.9,6.149135911765248,14.197974879654733,3334,96.4366734908427,44.12659768715764,0.51262472564968
33001,"Belknap County, New Hampshire",60383,29705,30678,33849,44469,8666,3883,1093,351,59629,2844,2578,5422,5421,2563,2858,30185,504,8.33,79.1,8.822019442558336,8.977692396866669,5327,98.75130417501614,49.9892353808191,0.49194309656691454
33003,"Carroll County, New Hampshire",47524,23734,23790,35646,36574,7979,3383,706,375,47059,3094,2001,5095,4313,1930,2383,22572,208,9.17,77.8,9.393148724854811,9.075414527396683,4464,99.02154700782762,47.49600202003198,0.4994108240047134
33005,"Cheshire County, New Hampshire",76109,37199,38910,32072,52603,10363,4960,975,841,75355,3880,2552,6432,7297,3072,4225,39383,298,8.56,79.4,8.90302066772655,9.587565202538464,6776,99.00931558685569,51.74552286851752,0.4887595422354781
33007,"Coos County, New Hampshire",32119,16923,15196,25895,24528,3033,1101,221,122,30072,1635,1275,2910,3989,1915,2074,14338,185,7.33,74.4,4.495781313241384,12.419440206731219,1444,93.62682524362526,44.640244092281826,0.526884398642548
33009,"Grafton County, New Hampshire",89280,43952,45328,35255,62303,12183,7339,2418,2557,88326,4356,3853,8209,8993,4134,4859,44369,939,8.45,76.3,13.792562724014337,10.072804659498209,12314,98.93145161290323,49.6964605734767,0.4922939068100358
33011,"Hillsborough County, New Hampshire",406371,201775,204596,37622,283506,66236,29377,4587,3371,402033,16558,12780,29338,34076,15138,18938,215197,1160,8.42,80,9.187417409214733,8.385440890221005,37335,98.93250256538975,52.95579655044282,0.49652903381392866
33013,"Merrimack County, New Hampshire",147958,72864,75094,34475,104448,22026,11016,2442,1238,144508,5629,4521,10150,10899,4681,6218,76400,605,7.82,79.4,9.932548425904649,7.366279619892132,14696,97.66825720812663,51.63627515916679,0.49246407764365563
33015,"Rockingham County, New Hampshire",302479,149778,152701,43474,217737,55341,26092,4165,2762,300188,9145,8002,17147,14402,6180,8222,167263,1054,5.78,79.8,10.916129714790118,4.761322273612383,33019,99.2425920477124,55.29739254625941,0.49516825961471705
33017,"Strafford County, New Hampshire",126552,61938,64614,32540,81763,18165,8487,1069,1453,125124,5123,4756,9879,11127,4874,6253,65642,773,5.73,79.2,8.69919084645047,8.792433150009483,11009,98.87161008913333,51.8695872052595,0.489427271003224
33019,"Sullivan County, New Hampshire",43073,21263,21810,31301,31540,5232,2253,397,300,42581,1895,1543,3438,3953,1799,2154,21150,188,6.74,77.8,6.848838019176746,9.177442945696841,2950,98.8577531168017,49.102686137487524,0.49365031458222086
34001,"Atlantic County, New Jersey",272926,132171,140755,29941,187294,33494,11366,3397,1525,270265,16417,13551,29968,40750,18226,22524,125165,2750,8.48,85.8,5.96791804371881,14.930787099799947,16288,99.02501044239098,45.86041637660025,0.4842741255871555
34003,"Bergen County, New Jersey",937920,454204,483716,46601,659670,196349,84431,23606,11534,931733,44966,40837,85803,66918,28633,38285,463417,4841,5.92,84.7,12.748528659160696,7.1347236438075745,119571,99.34034885704537,49.40901142954623,0.4842673149095872
34005,"Burlington County, New Jersey",449192,220995,228197,39528,313495,74439,30007,6793,4056,434992,12770,9803,22573,28066,12265,15801,222712,1342,7.46,86.6,9.095442483392402,6.248107713405403,40856,96.83876827726229,49.58058024185649,0.49198338349747994
34007,"Camden County, New Jersey",510996,246942,264054,32931,348322,68485,27384,8424,4007,505446,25056,19093,44149,65858,27934,37924,242617,2116,6.9,86.9,7.791646118560615,12.888163508129223,39815,98.913885822981,47.47923662807537,0.4832562290115774
34009,"Cape May County, New Jersey",94549,46158,48391,36256,69911,14444,5617,1331,495,92434,3437,2773,6210,9796,4361,5435,41958,353,8.75,85.2,7.872108642079768,10.360765317454442,7443,97.76306465430623,44.376989709039755,0.4881913082105575
34011,"Cumberland County, New Jersey",154952,79550,75402,23012,104613,10464,3456,790,303,143496,9833,7565,17398,26781,12163,14618,61398,935,8.59,86,2.9357478444937786,17.2834168000413,4549,92.60674273323352,39.62388352522071,0.513384790128556
34013,"Essex County, New Jersey",800401,384515,415886,35133,534516,109961,49138,15037,7782,788754,58282,50058,108340,130583,56435,74148,364016,2871,6.08,84.9,8.990118703000121,16.314697257999427,71957,98.54485439173614,45.479203549220955,0.4804029480223038
34015,"Gloucester County, New Jersey",291372,141589,149783,36205,198621,40959,15127,3238,2232,290110,9255,7247,16502,22815,9729,13086,143008,1022,6.31,86.9,7.068970251087956,7.830196449899098,20597,99.56687670743929,49.0809000178466,0.4859389371662342
34017,"Hudson County, New Jersey",679756,337345,342411,35910,481845,118853,53139,11134,6341,675541,60525,49134,109659,115254,51509,63745,347223,3858,6.45,85.2,10.388139273504022,16.955201572328896,70614,99.37992456116606,51.08053478012699,0.4962736629025709
34019,"Hunterdon County, New Jersey",125717,62901,62816,54200,88545,26800,13069,2791,2261,121490,2444,1795,4239,5403,2418,2985,64755,219,6.24,84,14.414120604214228,4.2977481168020235,18121,96.63768623177454,51.50854697455396,0.5003380608827764
34021,"Mercer County, New Jersey",373362,182693,190669,40064,250034,53953,33742,6521,9509,367599,19982,14738,34720,40450,17935,22515,177472,1500,5.96,86.2,13.330762102195724,10.833989532946577,49772,98.45645780770406,47.53349296393313,0.48931867731584894
34023,"Middlesex County, New Jersey",837288,412127,425161,36558,572917,142318,75205,12916,10245,828230,39916,33904,73820,69297,30225,39072,401409,6004,7.1,86,11.748167894440146,8.27636368847995,98366,98.91817391387431,47.9415684925617,0.4922165372010587
34025,"Monmouth County, New Jersey",627551,305192,322359,46736,436169,115874,55385,13595,7040,623613,25519,20913,46432,47055,20692,26363,308262,2058,7.84,85.4,12.113756491504276,7.498195365794971,76020,99.37248128040589,49.12142598768865,0.4863222271974708
34027,"Morris County, New Jersey",498847,244480,254367,53491,347344,106554,55614,13280,7231,494902,15941,13527,29468,22800,9981,12819,257135,1176,6.22,82.6,15.2601899981357,4.570539664466259,76125,99.20917636068775,51.545864764146124,0.4900901478810136
34029,"Ocean County, New Jersey",589699,283959,305740,33312,406087,76806,30529,5360,2584,584418,23151,19577,42728,63181,28695,34486,247187,2126,7.42,85.4,6.524175893125137,10.714110079888215,38473,99.10445837622244,41.917486717800095,0.4815321036664468
34031,"Passaic County, New Jersey",510563,248308,262255,29393,336045,60664,22536,5010,2557,506947,38948,31355,70303,85639,37914,47725,234222,3365,6.15,82.6,5.896040253602396,16.7734442174619,30103,99.29176223110566,45.87523968638542,0.48634154844749816
34033,"Salem County, New Jersey",63776,31105,32671,31681,44330,6440,2356,249,273,62626,2581,1985,4566,8860,3969,4891,28920,378,7.44,86.6,4.512669342699448,13.892373306573006,2878,98.19681384846965,45.34621174109383,0.48772265429001505
34035,"Somerset County, New Jersey",333316,162775,170541,51923,230407,66537,39338,8461,8051,330448,11215,9915,21130,15745,7466,8279,171277,848,6.61,85.4,16.755871305307878,4.7237456347730085,55850,99.13955525687335,51.385772060147126,0.4883503942204995
34037,"Sussex County, New Jersey",143570,71475,72095,41272,101164,23533,8735,1546,937,142397,5179,3918,9097,7573,3620,3953,73850,316,6.58,81.4,7.813610085672495,5.274778853520931,11218,99.18297694504423,51.43832276938079,0.49784077453507
34039,"Union County, New Jersey",557320,271607,285713,38163,377040,77535,36110,9438,5366,552755,38652,32962,71614,56826,23991,32835,271283,12674,6.54,85.5,9.13550563410608,10.196296562118711,50914,99.18090145697265,48.67634393167301,0.4873447929376301
34041,"Warren County, New Jersey",107088,52230,54858,37001,75330,15509,6686,1162,487,106181,4127,3429,7556,8602,3945,4657,53587,244,6.75,82.4,7.783318392350217,8.032646048109966,8335,99.15303301957269,50.0401538921261,0.4877297176154191
35001,"Bernalillo County, New Mexico",674855,330743,344112,28340,458214,84115,47618,10657,10803,667841,38845,33508,72353,119697,54584,65113,311619,2537,2.95,91.2,10.23597661719925,17.73669899459884,69078,98.96066562446748,46.175697001578115,0.4900949092768076
35003,"Catron County, New Mexico",3547,1861,1686,22487,2958,507,226,0,31,3539,244,216,460,761,227,534,885,33,2.8,85,7.245559627854525,21.454750493374682,257,99.77445728784889,24.950662531716944,0.524668734141528
35005,"Chaves County, New Mexico",65454,32536,32918,21177,41186,5149,2067,304,299,64465,4847,3852,8699,13488,6127,7361,26227,186,3.37,95.1,4.0792006600055,20.60683839031992,2670,98.48901518623767,40.06936168912519,0.49708192012711216
35006,"Cibola County, New Mexico",27049,13678,13371,17768,17996,1548,494,162,23,25336,2073,1654,3727,7201,3287,3914,9349,538,1.84,87.5,2.5102591593034864,26.62205626825391,679,93.66704868941551,34.56320011830382,0.505674886317424
35007,"Colfax County, New Mexico",12522,6317,6205,21785,9223,1194,532,34,129,12012,630,527,1157,2820,1348,1472,4634,6,4.97,82.8,5.55023159239738,22.520364159080017,695,95.92716818399617,37.00686791247404,0.504472129052867
35009,"Curry County, New Mexico",50283,26139,24144,22628,30517,3952,1800,225,96,47717,3945,2791,6736,11064,4875,6189,22260,411,7.6,92.2,4.2181254101783905,22.00346041405644,2121,94.89688363860549,44.269434997911816,0.5198377185132153
35011,"De Baca County, New Mexico",2016,926,1090,24571,1371,78,64,0,0,1989,169,12,181,452,68,384,675,24,3.74,94,3.1746031746031744,22.42063492063492,64,98.66071428571429,33.482142857142854,0.4593253968253968
35013,"Doña Ana County, New Mexico",213849,105094,108755,21050,128109,20740,10310,1942,2172,210417,14377,13618,27995,58114,27115,30999,88718,519,3.31,96.8,6.744946200356326,27.175249825811672,14424,98.3951292734593,41.486282376817286,0.49144022183877406
35015,"Eddy County, New Mexico",56793,28792,28001,28419,36678,3602,2006,152,180,56148,3284,3296,6580,8164,3651,4513,26188,116,3.86,95.8,4.116704523444791,14.375011004877361,2338,98.86429665627806,46.11131653548853,0.50696388639445
35017,"Grant County, New Mexico",28382,13940,14442,23898,20168,3044,1716,239,446,27951,784,527,1311,6101,2651,3450,10465,48,3.4,91,8.459587062222536,21.496018603340143,2401,98.4814318934536,36.87196110210697,0.49115636671129587
35019,"Guadalupe County, New Mexico",4426,2645,1781,18086,3418,262,163,22,0,3783,84,124,208,492,212,280,1354,2,3.95,91.7,4.1798463624039766,11.116131947582467,185,85.47220967013105,30.591956619972887,0.5976050610031631
35021,"Harding County, New Mexico",546,291,255,30782,437,88,11,0,6,544,26,27,53,108,39,69,198,0,5.66,92.3,3.1135531135531136,19.78021978021978,17,99.633699633699635,36.26373626373626,0.532967032967033
35023,"Hidalgo County, New Mexico",4446,2179,2267,18338,3115,294,147,4,3,4351,213,242,455,1133,461,672,1627,14,3.41,96.8,3.46378767431399,25.483580746738642,154,97.86324786324786,36.59469185784975,0.49010346378767433
35025,"Lea County, New Mexico",69505,35804,33701,24507,41617,3292,1807,202,163,67623,5426,5325,10751,10794,4681,6113,28393,214,3.83,94.5,3.1249550392058127,15.529817998705129,2172,97.2922811308539,40.8502985396734,0.5151284080281994
35027,"Lincoln County, New Mexico",19497,9399,10098,26820,14662,2907,1050,171,217,19346,1126,1111,2237,2987,1196,1791,6979,127,3.21,89.7,7.375493665692158,15.320305688054573,1438,99.22552187516028,35.79525055136688,0.4820741652561933
35028,"Los Alamos County, New Mexico",18031,9135,8896,52125,12704,3196,2532,192,2395,17947,490,286,776,920,386,534,9040,37,3.99,82.8,28.389995008596305,5.102323775719594,5119,99.53413565526039,50.13587710054905,0.5066274749043315
35029,"Luna County, New Mexico",24319,12057,12262,16622,15549,1342,738,47,71,23948,1937,1523,3460,7611,3292,4319,7739,117,2.96,97.8,3.5198815740778815,31.296517126526584,856,98.47444385048728,31.822854558164398,0.4957851885357128
35031,"McKinley County, New Mexico",72849,35209,37640,14077,43373,2572,1587,299,239,72505,9828,7593,17421,27086,13216,13870,22811,332,2.08,88,2.9169926834959985,37.18101827066947,2125,99.52779036088347,31.312715342695164,0.4833148018504029
35033,"Mora County, New Mexico",4605,2286,2319,16019,3044,210,82,0,95,4605,291,224,515,933,433,500,1245,0,5.49,83,3.8436482084690553,20.26058631921824,177,100,27.035830618892508,0.49641693811074916
35035,"Otero County, New Mexico",65130,33478,31652,21876,42409,4319,2757,421,269,59882,3747,3382,7129,13183,6183,7000,25718,105,3.43,91.5,5.292491939198526,20.24105634884078,3447,91.94226930753877,39.48717948717949,0.514018117610932
35037,"Quay County, New Mexico",8447,4057,4390,18220,5761,485,372,9,21,8404,380,141,521,1805,852,953,2985,5,6.33,94.5,4.759086066058956,21.36853320705576,402,99.49094353024742,35.337989818870604,0.4802888599502782
35039,"Rio Arriba County, New Mexico",39455,19338,20117,19602,26604,3186,1426,161,138,39215,3093,2307,5400,10338,4835,5503,13649,147,3.27,82.3,4.372069446204537,26.20200228107971,1725,99.3917120770498,34.59384108478013,0.49012799391712075
35041,"Roosevelt County, New Mexico",19313,9665,9648,18954,11004,1488,905,57,244,18717,1372,1262,2634,4974,2191,2783,7809,219,6.77,93,6.244498524310051,25.754673018174287,1206,96.91399575415524,40.43390462382851,0.500440118055196
35043,"Sandoval County, New Mexico",138815,67939,70876,27406,93967,16453,8717,1537,1542,137964,7926,6921,14847,20258,9304,10954,58457,548,3.01,88.4,8.497640744876275,14.593523754637467,11796,99.38695385945323,42.111443287829125,0.4894211720635378
35045,"San Juan County, New Mexico",128221,63529,64692,22665,81304,6752,3923,712,446,126898,12012,9424,21436,26248,12295,13953,50603,378,1.93,91.2,3.9626894190499216,20.47090570187411,5081,98.968187738358,39.465454176772916,0.49546486145015245
35047,"San Miguel County, New Mexico",28203,14114,14089,18012,19478,1979,1413,136,285,27631,1886,1431,3317,8267,3850,4417,9161,12,5.71,88.8,6.502854306279474,29.312484487465873,1834,97.97184696663476,32.48236003262064,0.5004432152607878
35049,"Santa Fe County, New Mexico",147514,71878,75636,35801,108259,22812,14433,4081,3528,145821,10414,8997,19411,20817,9403,11414,68945,433,3.27,86.4,14.942310560353594,14.11188090621907,22042,98.85231232289817,46.7379367382079,0.4872622259582141
35051,"Sierra County, New Mexico",11254,5513,5741,22749,8689,1121,462,36,50,11005,429,405,834,2322,1263,1059,3675,6,2.65,93,4.869379776079616,20.632663941709616,548,97.78745334992003,32.655055980095966,0.48987026834903147
35053,"Socorro County, New Mexico",17098,9066,8032,17017,10962,1309,592,75,164,17002,1284,836,2120,4411,2101,2310,5791,138,2.03,91.1,4.860217569306352,25.798338987016024,831,99.4385308223184,33.869458416189026,0.5302374546730612
35055,"Taos County, New Mexico",32809,16054,16755,23229,24305,3897,2035,393,411,32624,2088,1781,3869,6939,3230,3709,13344,192,3.53,77.7,8.653113474961138,21.14968453777927,2839,99.43613033009235,40.67176689323052,0.4893169557133713
35057,"Torrance County, New Mexico",15534,8126,7408,19129,10996,1299,512,75,59,14921,833,487,1320,4031,1765,2266,5267,22,2.81,87.9,4.158619801725248,25.949530063087423,646,96.05381743272821,33.90627011716235,0.5231105961117548
35059,"Union County, New Mexico",4216,2285,1931,23180,2989,296,162,13,5,3601,301,227,528,508,167,341,1525,16,4.35,88.9,4.269449715370019,12.049335863377609,180,85.41271347248576,36.17172675521822,0.5419829222011385
35061,"Valencia County, New Mexico",75845,38013,37832,20572,50564,5302,2405,243,309,74349,4524,3197,7721,16266,7331,8935,28158,506,2.76,94,3.898740853055574,21.446370887995254,2957,98.02755620014503,37.12571692267124,0.5011932230206342
36001,"Albany County, New York",308580,149287,159293,35278,204833,43162,28417,6459,5019,304767,9044,5413,14457,36325,16590,19735,156025,1104,6,79.8,12.92857605807246,11.771663750081016,39895,98.76433987944779,50.5622529003824,0.48378702443450644
36003,"Allegany County, New York",47400,24013,23387,22377,30331,3012,2283,272,436,46918,2076,1732,3808,6992,3292,3700,19699,165,5.96,78.4,6.310126582278481,14.751054852320674,2991,98.9831223628692,41.55907172995781,0.5066033755274262
36005,"Bronx County, New York",1455846,685636,770210,19721,927374,115670,47967,9418,6494,1434422,93355,65604,158959,422197,179686,242511,576863,3240,6.14,84.8,4.387758045837265,29.00011402304914,63879,98.5284157802405,39.623902528152016,0.47095365856004
36007,"Broome County, New York",196124,96409,99715,26790,129802,20371,12032,2108,1897,193241,5822,3732,9554,31795,14476,17319,85433,420,6.77,78.7,8.17696967224817,16.211682405009075,16037,98.53001162529829,43.5607064918113,0.4915716587465073
36009,"Cattaraugus County, New York",78175,38739,39436,23984,53201,5702,3701,379,286,77388,3182,2640,5822,12777,5951,6826,32991,227,5.91,78.3,5.584905660377358,16.344099776143267,4366,98.99328429804925,42.20147105852254,0.49554205308602495
36011,"Cayuga County, New York",78319,40132,38187,27957,55476,7518,3949,610,376,74877,2975,1886,4861,8599,3854,4745,36108,341,6.62,77.9,6.3011529769276935,10.9794558153194,4935,95.60515328336675,46.10375515519861,0.5124171656941483
36013,"Chautauqua County, New York",130846,64652,66194,23962,90242,10576,6929,1005,636,128249,4930,3517,8447,23101,10828,12273,54751,258,5.89,78.2,6.549684361768797,17.65510600247619,8570,98.01522400379072,41.84384696513459,0.4941075768460633
36015,"Chemung County, New York",86883,43018,43865,27209,60124,8149,5532,889,540,83346,2246,2336,4582,12934,5461,7473,37086,139,5.5,80,8.011924081811172,14.886686693599438,6961,95.92900797624391,42.684990159179584,0.495125628719082
36017,"Chenango County, New York",48763,24382,24381,25233,34561,3571,2464,220,190,48177,1472,1060,2532,6973,3116,3857,21282,118,6.48,78,5.8938129319360995,14.299776469864446,2874,98.79826917950085,43.64374628304247,0.5000102536759429
36019,"Clinton County, New York",81224,41648,39576,25833,55125,6200,4466,767,621,76759,2480,1257,3737,11518,5236,6282,35037,600,5.74,76,7.207229390327982,14.180537772087067,5854,94.50285629863095,43.1362651433074,0.5127548507830197
36021,"Columbia County, New York",61481,30856,30625,34737,45715,7112,5015,1093,555,59819,1722,1380,3102,6806,3121,3685,29141,182,6.47,80.9,10.837494510499178,11.070086693450008,6663,97.29672581773231,47.398383240350675,0.5018786291699875
36023,"Cortland County, New York",48334,23443,24891,26271,30199,4460,2603,351,443,47867,1424,850,2274,6573,2375,4198,23537,96,6.48,77,7.028178921670046,13.599122770720404,3397,99.03380643025613,48.69656970248686,0.4850208962634998
36025,"Delaware County, New York",45950,23118,22832,26016,32972,3997,2664,216,255,45478,1573,1675,3248,7187,3171,4016,19439,234,6.18,77,6.822633297062024,15.640914036996735,3135,98.9727965179543,42.30467899891186,0.5031120783460283
36027,"Dutchess County, New York",295685,146993,148692,36704,204168,38896,24491,3774,3481,287723,9369,6645,16014,25353,11548,13805,141426,594,5.32,81.8,10.736425588041328,8.574327409236181,31746,97.30726956051203,47.82995417420566,0.4971270101628422
36029,"Erie County, New York",923995,447024,476971,31083,642871,117778,69843,14347,9388,912268,23841,15383,39224,133648,58513,75135,438166,2341,6.46,79.2,10.127543980216343,14.464147533265873,93578,98.73083728808056,47.42081937672823,0.48379482572957644
36031,"Essex County, New York",38233,19936,18297,29008,28866,4186,2779,405,334,35897,1213,655,1868,3170,1485,1685,17087,361,6.45,74.3,9.201475165433003,8.291266706771637,3518,93.890094944158193,44.69175842858264,0.521434362984856
36033,"Franklin County, New York",51054,27928,23126,24294,35862,3240,2633,477,341,46282,1990,1400,3390,8793,4119,4674,19411,293,7.14,75.1,6.759509538919575,17.222940416030085,3451,90.6530340423865,38.020527284835666,0.5470286363458299
36035,"Fulton County, New York",53955,26899,27056,26298,38651,3778,2610,346,96,53200,2286,1524,3810,8461,3819,4642,23653,366,6.74,76.7,5.656565656565657,15.68158650727458,3052,98.60068575664906,43.83838383838384,0.4985450838661848
36037,"Genesee County, New York",58537,29199,29338,27499,41240,5226,2963,413,240,58079,1721,1259,2980,7362,3430,3932,28681,293,5.84,78.9,6.177289577532159,12.576660915318516,3616,99.21758887541213,48.9963612757743,0.4988127167432564
36039,"Greene County, New York",47791,24875,22916,27402,35151,4380,2653,476,234,44874,1376,1189,2565,5550,2407,3143,19650,216,6.51,77.7,7.036889790964826,11.613065221485217,3363,93.89634031512209,41.11652821660982,0.5204954907827833
36041,"Hamilton County, New York",4646,2387,2259,24891,3604,313,373,23,13,4612,336,200,536,446,208,238,1943,95,7.57,73.2,8.803271631510977,9.599655617735687,409,99.26818768833405,41.82092122255704,0.5137752905725355
36043,"Herkimer County, New York",62943,31103,31840,24932,43979,5258,3165,418,267,62282,2552,1564,4116,9201,4282,4919,27893,187,7.36,75.6,6.116645218689926,14.617987703160003,3850,98.94984350920674,44.31469742465405,0.49414549671925395
36045,"Jefferson County, New York",116567,61385,55182,24717,73008,9044,5267,916,426,104191,3875,2778,6653,16189,7322,8867,53830,639,8.88,76.7,5.669700687158458,13.88815016256745,6609,89.38292998876183,46.179450444808566,0.5266070157077046
36047,"Kings County, New York",2635121,1247773,1387348,29928,1789355,380135,186559,43830,18766,2623350,141469,108664,250133,570731,253532,317199,1189790,5804,6.44,84.5,9.455163538979804,21.65862592268059,249155,99.55330324489843,45.15124732412667,0.4735163964007725
36049,"Lewis County, New York",26845,13525,13320,25779,18363,1664,1104,107,111,26485,1196,869,2065,3765,1661,2104,11665,93,7.65,74.6,4.924566958465263,14.024958092754703,1322,98.65896815049358,43.453157012479046,0.5038182156826224
36051,"Livingston County, New York",64373,32269,32104,25882,42717,5614,3500,526,473,61781,1434,1190,2624,8497,3956,4541,28824,305,6.43,79,6.98895499666009,13.199633386668324,4499,95.97346713684308,44.77653674677271,0.5012815932145465
36053,"Madison County, New York",71760,35413,36347,28010,47707,7427,4002,714,761,71200,2076,1447,3523,7397,3453,3944,32943,253,6.35,77.7,7.632385730211817,10.307971014492754,5477,99.21962095875139,45.90719063545151,0.4934921962095875
36055,"Monroe County, New York",748680,361649,387031,31291,510165,105288,62151,11883,9696,741530,20345,13337,33682,107481,47826,59655,358734,2145,6.48,79.3,11.183683282577336,14.356066677352139,83730,99.04498584174814,47.915531335149865,0.4830488326120639
36057,"Montgomery County, New York",49500,24352,25148,25307,34126,3460,1856,375,127,48717,2344,1631,3975,9486,4124,5362,21400,245,6.08,80.1,4.763636363636364,19.163636363636364,2358,98.41818181818182,43.23232323232323,0.491959595959596
36059,"Nassau County, New York",1363069,661718,701351,46839,942504,229392,133182,42287,13242,1353154,44299,34333,78632,78657,34049,44608,669286,3884,5.32,84,13.84456692948046,5.7705809463790905,188711,99.27259735200492,49.10140279032096,0.485461851160873
36061,"New York County, New York",1653877,782142,871735,69529,1259137,397987,230186,92348,43628,1643228,65096,44518,109614,277483,121500,155983,888848,6585,6.42,84.9,22.13961497741368,16.777728936311465,366162,99.35611898587379,53.74329529946907,0.4729142493667909
36063,"Niagara County, New York",212675,103592,109083,28395,150502,20569,12156,1550,1095,210660,5953,4332,10285,28070,12711,15359,99290,817,6.47,79.8,6.9594451628071,13.19854237686611,14801,99.05254496297167,46.68625837545551,0.4870906312448572
36065,"Oneida County, New York",232324,115854,116470,27283,159917,22777,11659,2341,1433,224652,6893,4237,11130,36487,17051,19436,100528,275,7.25,78,6.642878049620358,15.705222017527246,15433,96.6977152597235,43.2706048449579,0.49867426525025393
36067,"Onondaga County, New York",467669,225685,241984,31436,316513,62078,35384,7757,5548,462658,13897,10097,23994,67057,30387,36670,219516,1346,6.75,78.4,10.41099581113993,14.338559964419279,48689,98.92851568096239,46.93832603828776,0.48257421381361604
36069,"Ontario County, New York",109491,53712,55779,33685,76354,14319,8806,1326,1263,108600,3106,2303,5409,10343,4662,5681,53501,217,6.18,78.3,10.407248084317432,9.44643852006101,11395,99.18623448502616,48.863376898557874,0.4905608680165493
36071,"Orange County, New York",378174,189437,188737,32616,240447,41214,23781,3782,2209,369083,12794,8786,21580,45108,19986,25122,174932,1196,5.51,81.9,7.872566596328674,11.927842739056624,29772,97.59608011127153,46.25701396711567,0.5009254999021614
36073,"Orleans County, New York",41584,20662,20922,23929,29704,2874,1572,175,95,38971,1325,1180,2505,6169,2579,3590,17489,268,6.12,79,4.429588303193536,14.835032704886494,1842,93.71633320507888,42.057041169680645,0.4968737976144671
36075,"Oswego County, New York",119833,60028,59805,25791,80201,8412,5246,560,485,119166,4319,2972,7291,20978,9741,11237,51735,188,6.97,78.2,5.2498059799888175,17.506029224003406,6291,99.44339205394174,43.17258184306493,0.5009304615590029
36077,"Otsego County, New York",60750,29341,31409,26688,40004,6124,3843,1009,859,60089,2179,1661,3840,8966,4004,4962,27701,231,6.4,76.9,9.40082304526749,14.758847736625514,5711,98.9119341563786,45.59835390946502,0.4829794238683128
36079,"Putnam County, New York",99464,49485,49979,44063,70373,15619,8733,1544,1230,98891,2986,2645,5631,4719,2483,2236,50307,99,5.36,81.7,11.569009893026623,4.744430145580311,11507,99.42391216922705,50.57809860854179,0.4975166894554814
36081,"Queens County, New York",2339280,1134031,1205249,28814,1665576,325374,142222,30052,15658,2324280,159740,124601,284341,317142,136877,180265,1110333,4889,6.13,84.5,8.033753975582231,13.557248384118191,187932,99.35877705960809,47.46473273827844,0.4847777948770562
36083,"Rensselaer County, New York",159800,78800,81000,33067,110822,18877,10479,1991,1699,158043,4666,2876,7542,19322,8736,10586,78570,334,6.13,79.4,8.866708385481852,12.091364205256571,14169,98.90050062578223,49.16770963704631,0.493116395494368
36085,"Richmond County, New York",475948,230325,245623,33922,328506,62620,32433,7490,2942,471955,15860,12073,27933,60735,27032,33703,209287,1377,7.03,85,9.006235975358653,12.760847823711835,42865,99.16104280299528,43.97266087891955,0.4839289166043349
36087,"Rockland County, New York",325027,159227,165800,36898,204647,44992,28264,6250,3248,322811,12868,10714,23582,45563,21888,23675,146206,700,5.59,83.7,11.618111726102754,14.01822002479794,37762,99.31821048712877,44.98272451211746,0.4898885323373135
36089,"St. Lawrence County, New York",110817,56381,54436,23554,72131,8335,6303,862,1173,107198,4876,3408,8284,19142,9370,9772,43151,247,6.43,76.4,7.524116335941237,17.273523015421823,8338,96.73425557450571,38.93897145744786,0.5087757293556043
36091,"Saratoga County, New York",226632,111991,114641,39653,160285,37413,20727,3297,3298,223481,4834,3551,8385,14681,6206,8475,116418,513,5.9,78.3,12.055667337357479,6.477902502735713,27322,98.60964029792792,51.36873874827915,0.4941535175968089
36093,"Schenectady County, New York",155239,75537,79702,29981,106739,18515,10803,1707,1856,153486,4827,3665,8492,18684,8151,10533,71694,522,5.64,79.6,9.254117844098454,12.03563537513125,14366,98.87077345254737,46.18298236912116,0.48658520088379853
36095,"Schoharie County, New York",31611,15700,15911,26953,22191,2825,1560,210,200,31535,1044,541,1585,4186,1884,2302,13745,39,5.88,77.7,6.2320078453702825,13.242225807472083,1970,99.7595773623106,43.48169940843378,0.49666255417417987
36097,"Schuyler County, New York",18112,9076,9036,25285,13177,1568,978,213,150,17876,767,462,1229,2706,1182,1524,8135,43,5.72,78.6,7.40393109540636,14.940371024734983,1341,98.6969964664311,44.914973498233216,0.5011042402826855
36099,"Seneca County, New York",34843,18308,16535,26541,24870,2962,1646,244,244,32036,1730,1370,3100,3752,1563,2189,15185,238,6.37,78.9,6.124616135235198,10.768303532990844,2134,91.94386246878857,43.58120712912206,0.5254427001119306
36101,"Steuben County, New York",97539,48550,48989,27731,68162,7885,5996,766,735,96379,4040,2927,6967,13922,6249,7673,42419,366,5.49,78.3,7.686156306708086,14.273265052953178,7497,98.81073211740944,43.489270958283356,0.49774961810147733
36103,"Suffolk County, New York",1497595,737373,760222,40277,1030141,196946,121297,26953,15000,1483523,56154,40716,96870,105522,46228,59294,731210,4448,6.79,81.7,10.900810966916957,7.046097242578935,163250,99.06036011071085,48.82561707270657,0.4923714355349744
36105,"Sullivan County, New York",75783,38941,36842,28224,53264,7141,4138,657,502,73419,3541,2125,5666,11583,5479,6104,31858,163,6.61,79.3,6.989694258606812,15.28443054510906,5297,96.88056688175449,42.03845189554386,0.5138487523587084
36107,"Tioga County, New York",49322,24340,24982,30252,34772,5443,2598,336,214,48942,1660,1122,2782,5453,2342,3111,22596,205,6,79.2,6.382547341956936,11.055918251490207,3148,99.2295527350878,45.81322736304286,0.49349174810429425
36109,"Tompkins County, New York",104415,51397,53018,29759,60092,13726,10276,2250,5363,103532,2957,2197,5154,18411,8301,10110,48990,157,6.6,78.4,17.132595891394914,17.63252406263468,17889,99.15433606282622,46.91854618589283,0.4922377053105397
36111,"Ulster County, New York",180129,89377,90752,32453,129659,22291,14083,2355,1962,175816,6791,5414,12205,22682,10369,12313,84516,555,6.39,79,10.214901542783227,12.592086782250497,18400,97.6056048720639,46.91970754292757,0.49618329086376983
36113,"Warren County, New York",64701,31717,32984,33127,47642,7426,5174,966,389,64154,2344,1411,3755,6328,2869,3459,31695,174,6.5,75.4,10.091034141667054,9.780374337336363,6529,99.15457257229409,48.98687810080215,0.4902088066645029
36115,"Washington County, New York",62183,32148,30035,26064,44765,5207,3010,383,256,59170,2533,1588,4121,7556,3569,3987,27987,128,5.95,78.6,5.868163324381261,12.15123104385443,3649,95.1546242542174,45.007477928051074,0.5169901741633566
36117,"Wayne County, New York",91442,45218,46224,27318,63889,8181,4778,549,377,90522,3115,2200,5315,10541,4901,5640,42372,389,5.66,77.7,6.2378338181579585,11.52752564467094,5704,98.99389777126484,46.33756916952822,0.49449924542332846
36119,"Westchester County, New York",975321,471874,503447,52049,668102,159656,107904,36202,15111,962824,43588,31620,75208,89829,39478,50351,468700,2972,5.52,83.7,16.324574165838733,9.210198488497634,159217,98.71867826079824,48.05597336671721,0.4838140468625201
36121,"Wyoming County, New York",40886,22032,18854,25635,29320,2832,1421,188,79,37617,1203,640,1843,4267,1970,2297,17942,132,6.07,77.1,4.1285525607787505,10.436335175854817,1688,92.00459815095631,43.88299173311158,0.5388641588807905
36123,"Yates County, New York",25083,12069,13014,26608,16613,2220,1409,180,166,24730,2396,2443,4839,3120,1377,1743,11041,139,6.67,78.5,6.996770721205597,12.438703504365506,1755,98.59267232787147,44.01786070246781,0.48116254036598494
37001,"Alamance County, North Carolina",157844,75078,82766,25157,106443,16342,5625,1251,1121,156660,9593,10544,20137,26996,11355,15641,72651,633,6.55,89.7,5.066394668153366,17.102962418590508,7997,99.24989229872533,46.02709003826563,0.4756468411849674
37003,"Alexander County, North Carolina",37159,18797,18362,22655,26561,2453,978,181,73,35923,2172,1797,3969,5285,2181,3104,16043,343,6.78,88.1,3.315482117387443,14.222664764929089,1232,96.67375333028338,43.173928254258726,0.5058532253289917
37005,"Alleghany County, North Carolina",10935,5445,5490,21153,8076,949,458,69,34,10812,870,661,1531,2266,997,1269,4297,19,11.3,81.4,5.130315500685871,20.722450845907638,561,98.87517146776406,39.295839048925465,0.49794238683127573
37007,"Anson County, North Carolina",25531,13361,12170,19105,18081,1179,328,75,87,23748,2067,1450,3517,5383,2265,3118,9948,54,7.48,91.9,1.9192354392699071,21.08417218283655,490,93.01633308526888,38.96439622419803,0.5233245857976577
37009,"Ashe County, North Carolina",26833,13213,13620,23650,20207,2669,1022,159,94,26594,2167,1524,3691,5139,2573,2566,11815,171,11.67,79.8,4.75161182126486,19.151790705474603,1275,99.10930570566094,44.031602877054375,0.4924160548578243
37011,"Avery County, North Carolina",17535,9573,7962,21704,13225,1626,787,167,97,15412,1487,1028,2515,2154,1113,1041,6647,57,10.75,77.2,5.993726832050186,12.284003421727972,1051,87.89278585685771,37.90704305674365,0.5459366980325064
37013,"Beaufort County, North Carolina",47316,22596,24720,24657,33835,4287,1600,398,354,46957,2887,2894,5781,8947,3827,5120,18901,131,7.27,89.4,4.970834390058331,18.909037112181927,2352,99.24127145151746,39.94631837010736,0.47755516104488965
37015,"Bertie County, North Carolina",19913,10057,9856,18319,14657,1155,524,59,64,18658,1528,962,2490,4102,1767,2335,7165,117,6.3,89,3.2491337317330387,20.599608296087982,647,93.69758449254256,35.98151961030483,0.5050469542509918
37017,"Bladen County, North Carolina",34130,16241,17889,20839,24279,2456,776,129,169,33803,2164,2000,4164,8271,3704,4567,12986,61,6.45,90.4,3.14679167887489,24.233811895692938,1074,99.0418986229124,38.04863756226194,0.47585701728684443
37019,"Brunswick County, North Carolina",122586,59412,63174,29707,95320,17232,7205,1245,1008,121634,8016,7142,15158,17129,6665,10464,47978,572,10.92,89.2,7.715399800956064,13.973047493188455,9458,99.22340234610805,39.13823764540812,0.4846556703049288
37021,"Buncombe County, North Carolina",252268,121002,131266,29590,183555,43720,19036,4818,3142,248611,15514,13025,28539,32591,14957,17634,121086,473,8.87,83.3,10.701317646312651,12.919197044413085,26996,98.55035121378852,47.99895349390331,0.47965655572644966
37023,"Burke County, North Carolina",88898,43908,44990,21885,63662,6873,2670,756,310,86617,6325,4947,11272,16660,7596,9064,36235,282,7.28,88.3,4.202569236653243,18.74057909064321,3736,97.43413800085492,40.76019707979932,0.4939143737766879
37025,"Cabarrus County, North Carolina",196716,95708,101008,29143,129485,26125,9779,1643,1243,195309,9249,8183,17432,22481,9834,12647,94251,501,7.14,91.1,6.438215498485126,11.428150226722789,12665,99.28475568840359,47.91221862990301,0.48652880294434614
37027,"Caldwell County, North Carolina",81805,40361,41444,21991,58549,5765,2213,432,271,80979,5890,5452,11342,13214,6120,7094,33985,552,8.71,88,3.564574292524907,16.153046879775076,2916,98.99028176761811,41.543915408593605,0.49338060020781127
37029,"Camden County, North Carolina",10336,5103,5233,27468,7131,800,303,83,105,10218,627,432,1059,930,412,518,4576,79,7.14,88,4.750386996904025,8.99767801857585,491,98.85835913312694,44.27244582043344,0.49371130030959753
37031,"Carteret County, North Carolina",68699,33760,34939,30903,51560,8112,4004,970,656,67074,4527,3658,8185,8458,3548,4910,30155,443,11,88.4,8.195170235374604,12.311678481491725,5630,97.63460894627288,43.894379830856344,0.4914190890697099
37033,"Caswell County, North Carolina",22833,11490,11343,21692,16611,1599,521,105,47,21970,1135,1040,2175,4666,2255,2411,9317,33,8.46,89.1,2.9474882845005035,20.435334822406166,673,96.22038277931064,40.80497525511321,0.5032190250952568
37035,"Catawba County, North Carolina",156182,76437,79745,25960,107371,15892,5423,1116,634,154701,9405,8090,17495,21816,9985,11831,70468,1301,6.43,89.1,4.592718751200523,13.968319012434211,7173,99.05174732043385,45.11915585662881,0.4894097911411046
37037,"Chatham County, North Carolina",68364,33000,35364,36933,49958,10683,5487,1902,1961,67647,4434,4033,8467,8988,4206,4782,30121,239,5.96,91,13.676788953250249,13.147270493242058,9350,98.95120238722134,44.059739043941256,0.4827101983500088
37039,"Cherokee County, North Carolina",27463,13483,13980,21152,20942,2438,1137,290,147,27175,2369,2043,4412,4561,2193,2368,9852,162,7.35,84.1,5.731347631358555,16.607799584896043,1574,98.95131631649856,35.87372100644504,0.49095146196701017
37041,"Chowan County, North Carolina",14370,6878,7492,23542,10492,1257,558,108,66,14100,968,966,1934,3211,1361,1850,5350,62,6.34,88.7,5.093945720250522,22.345163535142657,732,98.12108559498957,37.2303409881698,0.4786360473208072
37043,"Clay County, North Carolina",10753,5117,5636,25433,8212,1168,424,157,144,10716,805,863,1668,1877,791,1086,4261,89,7.77,82.8,6.742304473170278,17.455593787780156,725,99.65590997861062,39.626150841625595,0.4758671998512043
37045,"Cleveland County, North Carolina",97038,46733,50305,21664,66333,6464,3263,722,519,96786,6872,5714,12586,18977,7990,10987,39605,156,5.53,90.5,4.641480657062182,19.55625631196026,4504,99.74030792060842,40.81390795358519,0.48159483913518414
37047,"Columbus County, North Carolina",56589,27882,28707,21849,39263,3336,1223,226,140,53778,4345,3770,8115,12671,5405,7266,20113,149,9.07,90,2.8079662125147995,22.391277456749545,1589,95.03260350951598,35.542243192139814,0.4927105974659386
37049,"Craven County, North Carolina",103374,52488,50886,26830,67131,10303,4450,886,680,95058,6386,4972,11358,15103,6506,8597,46918,502,8.39,89.7,5.819645171900091,14.610056687368196,6016,91.955423994428,45.3866542844429,0.5077485634685704
37051,"Cumberland County, North Carolina",332766,165787,166979,23627,203986,32717,13305,1940,1515,300902,17860,15838,33698,57582,24231,33351,150646,1156,6.07,91.9,5.0365722459626285,17.304051495645588,16760,90.42450250326056,45.27085098838223,0.49820895163568396
37053,"Currituck County, North Carolina",25247,12522,12725,29340,17861,3022,916,97,56,24904,1866,1355,3221,2283,907,1376,12168,108,7.3,87.2,4.234166435616113,9.04265853368717,1069,98.64142274329623,48.19582524656395,0.4959797203628154
37055,"Dare County, North Carolina",35412,17441,17971,30898,26282,5284,1871,367,319,35239,3283,2350,5633,3116,1564,1552,18083,205,6.36,85.9,7.220716141420987,8.799277081215408,2557,99.5114650400994,51.06461086637298,0.49251666101886366
37057,"Davidson County, North Carolina",164118,80121,83997,24231,114428,14808,4586,730,542,162246,9842,8874,18716,25534,11083,14451,71416,418,6.55,89.3,3.5693830049111006,15.55831779573234,5858,98.85935729170475,43.51503186731498,0.4881914232442511
37059,"Davie County, North Carolina",41766,20394,21372,29234,29709,4282,1816,497,226,41422,2467,2224,4691,5802,2709,3093,18608,371,7.14,88.9,6.079107407939472,13.891682229564717,2539,99.17636354929847,44.552985682133794,0.48829191208159745
37061,"Duplin County, North Carolina",59350,29020,30330,18529,39829,2972,1034,187,90,58894,6109,5267,11376,15390,6914,8476,24332,232,7.42,90.2,2.2089300758213986,25.930918281381633,1311,99.23167649536647,40.997472620050544,0.4889637742207245
37063,"Durham County, North Carolina",300865,143946,156919,33151,204862,51502,28030,7950,9317,295299,20800,18016,38816,47237,21781,25456,150782,1165,8.24,91.5,15.05558971631795,15.700397188107623,45297,98.15000083093746,50.11616505741778,0.4784404965682283
37065,"Edgecombe County, North Carolina",54032,25088,28944,18946,36717,2692,1312,129,131,53260,3791,2927,6718,13050,5454,7596,21013,977,7.71,89.9,2.9093870299082027,24.152354160497485,1572,98.57121705655908,38.88991708617116,0.4643174415161386
37067,"Forsyth County, North Carolina",368362,174966,193396,28640,245413,52053,21131,5843,3955,365252,21929,20581,42510,67043,29317,37726,165098,1150,8.45,88.8,8.396360102290682,18.20030296284633,30929,99.15572181712554,44.819498210998965,0.4749838474109707
37069,"Franklin County, North Carolina",63866,31817,32049,23862,43826,6507,2276,230,199,62896,4276,3587,7863,10207,4548,5659,27410,186,7.74,91.1,4.23543043246798,15.9818996022923,2705,98.4811950020355,42.91798453010992,0.49818369711583627
37071,"Gaston County, North Carolina",214049,103191,110858,24937,146885,21333,6596,1360,775,212011,13768,12276,26044,34874,14642,20232,94216,594,6.6,90.4,4.078972571700872,16.292531149409715,8731,99.04788155982976,44.01608977383683,0.48209054936019324
37073,"Gates County, North Carolina",11601,5662,5939,24335,8277,794,364,108,35,11518,701,494,1195,1430,491,939,4961,76,6.37,88.7,4.370312904059995,12.326523575553832,507,99.2845444358245,42.76355486595983,0.4880613740194811
37075,"Graham County, North Carolina",8607,4212,4395,19095,6053,536,273,48,0,8493,672,775,1447,1606,772,834,3012,17,7.45,81.1,3.729522481700941,18.65923085860346,321,98.67549668874172,34.99477169745556,0.4893691181596375
37077,"Granville County, North Carolina",58503,29686,28817,24859,40925,5934,1941,458,243,55754,3074,2246,5320,7982,3585,4397,25038,174,7,91.1,4.516007726099517,13.643744765225716,2642,95.3010956703075,42.79780524075689,0.5074269695571167
37079,"Greene County, North Carolina",21059,11380,9679,18662,14841,1083,240,46,80,18864,1740,1305,3045,4851,2177,2674,7936,17,7.88,90.5,1.7379742627855075,23.035281827247257,366,89.57690298684648,37.68460040837647,0.5403865330737452
37081,"Guilford County, North Carolina",517197,245216,271981,28582,344396,77709,30166,6716,5765,513206,30015,27771,57786,83981,35875,48106,241350,1209,8.06,89.4,8.245794155805235,16.237719863030915,42647,99.22834045827798,46.66500385733096,0.4741249465870838
37083,"Halifax County, North Carolina",52300,25152,27148,20406,36513,3607,1136,172,190,50897,3560,2703,6263,13607,6380,7227,18931,162,6.52,90.7,2.864244741873805,26.017208413001914,1498,97.31739961759082,36.19694072657744,0.48091778202676866
37085,"Harnett County, North Carolina",128753,63747,65006,22351,82137,11267,4454,595,380,122560,7758,6853,14611,22535,9791,12744,52885,352,5.76,92,4.216600778234294,17.502504796004754,5429,95.19001498994199,41.07477107329538,0.49511079353490794
37087,"Haywood County, North Carolina",59854,29008,30846,27166,44811,6564,3251,578,501,59410,4011,3330,7341,9817,4645,5172,24818,259,9.8,77.9,7.234270057139038,16.401577171116383,4330,99.25819494102316,41.46422962542186,0.4846459718648712
37089,"Henderson County, North Carolina",112156,54226,57930,28290,82961,16894,6591,1284,1117,111062,7520,6213,13733,13134,6129,7005,49225,230,10.31,83.4,8.017404329683655,11.7104746959592,8992,99.02457291629516,43.88976069046685,0.4834872855665323
37091,"Hertford County, North Carolina",24262,12026,12236,18383,16877,1671,666,113,131,22145,1436,1299,2735,4999,2067,2932,9028,112,7.6,88.9,3.750721292556261,20.604237078559063,910,91.27442090511911,37.210452559558156,0.4956722446624351
37093,"Hoke County, North Carolina",52571,25993,26578,19654,33360,4381,1367,133,213,48448,3200,3476,6676,11177,5003,6174,20361,187,5.83,91.7,3.25845047649845,21.260771147590876,1713,92.15727302124746,38.73047878107702,0.49443609594643434
37095,"Hyde County, North Carolina",5507,2918,2589,19181,3968,193,82,11,0,4853,284,371,655,985,371,614,2038,52,8.02,88.2,1.6887597603050664,17.88632649355366,93,88.12420555656438,37.00744506991102,0.5298710731795896
37097,"Iredell County, North Carolina",169798,83570,86228,30393,115647,21711,7220,1404,819,168622,8722,9246,17968,21307,8903,12404,79161,844,6.54,88.8,5.561314031967396,12.548439910953014,9443,99.30741233701221,46.62069046749667,0.49217305268613293
37099,"Jackson County, North Carolina",41725,20395,21330,23674,26716,4455,2345,454,884,41452,3392,2348,5740,8205,3818,4387,17533,80,10.2,79.7,8.826842420611145,19.664469742360694,3683,99.34571599760335,42.0203714799281,0.48879568603954465
37101,"Johnston County, North Carolina",186308,91408,94900,24872,122671,19175,5654,994,745,184634,13181,11522,24703,26622,12353,14269,84416,449,7.72,91.9,3.9681602507675464,14.289241471112351,7393,99.10148785881444,45.30991691178049,0.49062842175322585
37103,"Jones County, North Carolina",9776,4771,5005,21058,7224,683,227,55,58,9686,749,774,1523,2570,1176,1394,3778,58,7.72,90,3.4779050736497545,26.28887070376432,340,99.07937806873977,38.645662847790504,0.488031914893617
37105,"Lee County, North Carolina",59805,29055,30750,23613,39706,5622,2169,290,345,58597,4514,4131,8645,10262,4362,5900,26602,118,5.51,91.6,4.688571189699858,17.159100409664745,2804,97.98010199816069,44.481230666332245,0.48582894406822175
37107,"Lenoir County, North Carolina",57934,27701,30233,21594,40180,3516,1449,170,270,56794,4712,3593,8305,12632,5714,6918,23412,108,7.49,90.7,3.2606068975040565,21.804121931853487,1889,98.03224358753064,40.411502744502364,0.47814754720889285
37109,"Lincoln County, North Carolina",80504,39867,40637,27359,56890,8087,2685,384,361,79907,4721,4718,9439,12103,5598,6505,36492,331,5.95,89.6,4.260657855510285,15.034035575872007,3430,99.25842194176687,45.329424624863364,0.49521762893769256
37111,"McDowell County, North Carolina",45069,22706,22363,20439,32336,3646,1079,274,133,44180,3085,2402,5487,8498,3990,4508,17809,119,11,87.1,3.297166566819765,18.855532627748563,1486,98.02746899199006,39.514965941112514,0.5038052763540349
37113,"Macon County, North Carolina",34160,16467,17693,27282,25576,3731,1506,302,143,33954,2858,2439,5297,5980,2655,3325,13399,465,9.19,81.3,5.71135831381733,17.505854800936767,1951,99.39695550351288,39.22423887587822,0.4820550351288056
37115,"Madison County, North Carolina",21347,10564,10783,22653,15174,2304,1231,200,200,21114,1322,935,2257,3622,1609,2013,9258,63,6.86,83.3,7.640417857310161,16.967255352040098,1631,98.90851173466997,43.369091675645286,0.4948704736028482
37117,"Martin County, North Carolina",23227,10910,12317,22161,16621,1775,567,167,124,23075,1504,1177,2681,4430,1950,2480,9222,28,6.65,89.5,3.6939768373014163,19.07263098979636,858,99.34558918500022,39.703792999526414,0.4697119731347139
37119,"Mecklenburg County, North Carolina",1034290,497122,537168,35669,688046,200706,77520,16925,8046,1028876,72196,62420,134616,136399,59283,77116,526553,4728,6.6,90.9,9.909309768053447,13.187693973643755,102491,99.47654913032129,50.90960949056841,0.4806408260739251
37121,"Mitchell County, North Carolina",15155,7433,7722,22302,11205,1344,464,150,69,15036,1030,953,1983,2263,977,1286,6028,43,8.99,79.5,4.506763444407786,14.932365555922138,683,99.21478060046189,39.77565160013197,0.4904651930056087
37123,"Montgomery County, North Carolina",27445,13584,13861,20900,18910,1927,544,109,70,26500,2053,2034,4087,5550,2344,3206,10431,60,5.84,91.5,2.6343596283476045,20.222262707232648,723,96.5567498633631,38.00692293678266,0.49495354345053744
37125,"Moore County, North Carolina",94191,45332,48859,31554,67957,14770,6590,1974,1106,91293,4927,4470,9397,12380,5355,7025,39679,254,6.07,91.6,10.266373645040396,13.143506279793186,9670,96.92327292416473,42.126105466552005,0.4812774044229279
37127,"Nash County, North Carolina",94125,45178,48947,25232,64512,8695,3216,707,480,92801,5566,5400,10966,14656,5686,8970,41090,156,8.38,90.4,4.677822045152722,15.57078353253652,4403,98.5933598937583,43.654714475431604,0.47997875166002657
37129,"New Hanover County, North Carolina",219866,105213,114653,31708,149505,38863,13192,3554,2555,217425,13816,10564,24380,38374,16098,22276,105969,949,9.7,89.2,8.778528740232687,17.453357954390402,19301,98.8897783195219,48.19708367824038,0.47853237881254945
37131,"Northampton County, North Carolina",20426,9944,10482,19126,15066,1179,585,123,43,19632,1621,1282,2903,4955,2162,2793,6858,19,5.62,90.3,3.676686575932635,24.258298247331833,751,96.11279741505923,33.574855576226376,0.48683051013414275
37133,"Onslow County, North Carolina",192685,107245,85440,23141,101561,14336,4670,1056,480,153922,8044,7286,15330,24112,10199,13913,98084,955,9.64,89.3,3.220800788852272,12.513688143861744,6206,79.88271012273918,50.9038067311934,0.5565819861431871
37135,"Orange County, North Carolina",141812,67598,74214,38348,87529,22592,15373,4824,7596,141148,6187,5081,11268,18379,7865,10514,70923,740,7.28,90,19.59848249795504,12.960116210193778,27793,99.53177446196372,50.01198770202804,0.4766733421713254
37137,"Pamlico County, North Carolina",12803,6561,6242,25461,9824,1209,489,71,135,12134,915,849,1764,1826,801,1025,4878,37,9.62,89,5.428415215183941,14.26228227759119,695,94.77466218854956,38.10044520815434,0.5124580176521127
37139,"Pasquotank County, North Carolina",39546,19203,20343,23714,26571,3422,1588,171,228,38101,2492,2641,5133,6730,2799,3931,16647,181,6.97,88.1,5.024528397309463,17.01815607141051,1987,96.34602741111617,42.09528144439387,0.4855864057047489
37141,"Pender County, North Carolina",57630,28562,29068,25997,40493,6505,2889,635,344,56059,3750,3534,7284,8877,3674,5203,24572,161,9.97,89.1,6.711782057955926,15.403435710567413,3868,97.27398924171439,42.63751518306437,0.4956099253860836
37143,"Perquimans County, North Carolina",13506,6485,7021,25848,10092,1390,427,90,80,13354,867,787,1654,2527,1160,1367,5156,4,6.74,88.5,4.420257663260773,18.710202872797275,597,98.87457426329038,38.17562564786021,0.48015696727380425
37145,"Person County, North Carolina",39240,18973,20267,24477,27663,3028,904,164,126,38813,2298,1783,4081,6998,3045,3953,16485,81,8.56,90,3.0428134556574924,17.833843017329254,1194,98.9118246687054,42.010703363914374,0.48351172273190623
37147,"Pitt County, North Carolina",176484,83309,93175,25462,105532,20457,8402,2035,1685,175431,10854,10188,21042,41319,17428,23891,81347,436,6.76,90.2,6.868611318873099,23.412320663629565,12122,99.40334534575372,46.09313025543392,0.47204845765055187
37149,"Polk County, North Carolina",20434,9782,10652,29728,15648,3144,1276,402,174,20148,1103,1305,2408,2197,1007,1190,8499,193,8.74,89.2,9.063325829499853,10.751688362533033,1852,98.60037192913771,41.59244396593912,0.4787119506704512
37151,"Randolph County, North Carolina",142827,70344,72483,22349,98075,10713,3291,448,566,141584,10579,9439,20018,23520,10789,12731,62760,577,7.11,90.2,3.014135982692348,16.467474637148438,4305,99.1297163701541,43.94127160830935,0.4925119200151232
37153,"Richmond County, North Carolina",45447,22193,23254,19966,30544,2932,1144,137,144,44066,3371,2831,6202,11448,5097,6351,17244,136,6.62,92.2,3.135520496402403,25.18978150372962,1425,96.96129557506546,37.94309855436003,0.4883270622923405
37155,"Robeson County, North Carolina",134187,64702,69485,17161,85584,7672,2602,488,201,132407,11552,9683,21235,38182,17208,20974,47478,340,5.92,91.2,2.452547564220081,28.454321208462815,3291,98.67349296131518,35.38196695656062,0.48217785627519805
37157,"Rockingham County, North Carolina",91566,44133,47433,22521,65455,6665,2312,330,314,90460,5118,5020,10138,16653,7316,9337,38209,203,8.3,89.5,3.2282725028940873,18.186881593604614,2956,98.79212808247603,41.72837079265229,0.4819802109953476
37159,"Rowan County, North Carolina",138940,68811,70129,23838,95078,12616,3781,617,439,136570,9168,8451,17619,22633,10154,12479,58306,557,6.65,89.8,3.4813588599395424,16.289765366345186,4837,98.2942277241975,41.96487692529149,0.49525694544407656
37161,"Rutherford County, North Carolina",66523,32275,34248,21092,47447,5429,2015,439,313,65620,4086,3990,8076,12804,5780,7024,25526,249,6.78,90,4.15946364415315,19.247478315770486,2767,98.6425747485832,38.37169099409227,0.4851705425191287
37163,"Sampson County, North Carolina",63664,31251,32413,20872,42499,3796,1135,233,132,63040,5982,5054,11036,15271,7054,8217,26033,167,6.56,91.3,2.356119628047248,23.986868559939683,1500,99.01985423473235,40.89124151796934,0.49087396330736366
37165,"Scotland County, North Carolina",35445,17546,17899,17103,23608,2424,941,230,147,33477,2270,1976,4246,9815,4201,5614,11375,56,5.06,91.8,3.7184370150938073,27.69078854563408,1318,94.44773592890394,32.0919734800395,0.4950204542248554
37167,"Stanly County, North Carolina",60875,30309,30566,23398,42321,5068,1524,222,182,59526,3523,3661,7184,9269,3759,5510,27282,153,5.14,91.5,3.167145790554415,15.226283367556467,1928,97.78398357289528,44.81642710472279,0.49788911704312117
37169,"Stokes County, North Carolina",46124,22555,23569,23500,33595,3585,915,111,75,45675,3017,2658,5675,6311,2660,3651,20216,53,8.79,88.7,2.3870436215419306,13.682681467348885,1101,99.02653716069725,43.82967652415228,0.48900789177001125
37171,"Surry County, North Carolina",72315,35166,37149,22533,50753,5517,2231,390,229,71514,5038,4485,9523,12534,5630,6904,29863,173,9.19,87.7,3.941091059946069,17.332503629952292,2850,98.89234598630989,41.2957201133928,0.4862891516282929
37173,"Swain County, North Carolina",14208,6865,7343,20918,9818,1031,345,65,36,14026,1702,1259,2961,2911,1380,1531,5435,60,8.76,79.1,3.1390765765765765,20.488457207207208,446,98.71903153153153,38.253096846846844,0.48317849099099097
37175,"Transylvania County, North Carolina",33291,16018,17273,26037,25011,4378,2245,382,477,32816,2801,2492,5293,5018,2183,2835,12988,21,12.43,81,9.323841278423599,15.07314289147217,3104,98.57318794869484,39.013547204950285,0.48115106184854767
37177,"Tyrrell County, North Carolina",4090,2367,1723,17736,3213,152,75,7,11,3480,298,304,602,931,376,555,1515,0,6.86,88.1,2.273838630806846,22.762836185819072,93,85.08557457212714,37.04156479217604,0.5787286063569682
37179,"Union County, North Carolina",222095,109435,112660,32754,140617,33350,10830,2339,1238,221079,11674,10197,21871,20626,9260,11366,105115,813,6.43,91,6.486863729485131,9.287016817127805,14407,99.542538103064,47.328845764200004,0.4927395934172314
37181,"Vance County, North Carolina",44420,20915,23505,21188,29738,2575,620,288,109,43979,2641,2422,5063,10026,4420,5606,17119,41,6.56,91.1,2.289509230076542,22.570914002701485,1017,99.0072039621792,38.53894642053129,0.4708464655560558
37183,"Wake County, North Carolina",1023811,497677,526134,37315,677119,217337,94286,16498,17000,1015242,52866,44862,97728,101256,45793,55463,528990,3780,8.85,91.4,12.481209910813616,9.890106670078755,127784,99.16302911377197,51.66871619859525,0.48610241538721505
37185,"Warren County, North Carolina",20190,10116,10074,21543,14468,1463,564,140,113,19271,1506,1183,2689,4281,1968,2313,7126,38,6.71,91.4,4.04655770183259,21.203566121842496,817,95.44824170381376,35.29470034670629,0.5010401188707281
37187,"Washington County, North Carolina",12331,5846,6485,21117,8516,538,203,25,12,12141,743,798,1541,2924,899,2025,4565,26,7.12,88.9,1.9463141675452114,23.71259427459249,240,98.45916795069337,37.02051739518287,0.47408969264455436
37189,"Watauga County, North Carolina",53421,26657,26764,24545,30171,7338,3233,611,1389,53092,2634,2367,5001,13556,6895,6661,23723,99,11.83,79.2,9.795773197806106,25.375788547574924,5233,99.38413732427323,44.407629958256116,0.49899852118080906
37191,"Wayne County, North Carolina",124496,61075,63421,23163,82263,11536,3528,587,560,120019,8770,7634,16404,25635,11099,14536,52954,316,8.01,91.3,3.755140727412929,20.591023004755172,4675,96.40390052692456,42.53469991003727,0.4905780105384912
37193,"Wilkes County, North Carolina",68525,33737,34788,21798,48844,5288,1767,304,162,67722,4966,3376,8342,14040,6396,7644,27656,81,9.45,87.1,3.2586647209047794,20.488872674206494,2233,98.82816490331996,40.35899306822328,0.492331265961328
37195,"Wilson County, North Carolina",81379,38532,42847,23383,55011,7465,2254,390,225,80308,5918,5174,11092,16458,7114,9344,34296,1376,8.95,90.4,3.525479546320304,20.223890684328882,2869,98.68393565907667,42.14355054743853,0.47348824635348186
37197,"Yadkin County, North Carolina",37825,18574,19251,23038,26554,2163,800,104,127,37534,2635,2315,4950,6479,2995,3484,15384,79,8.14,88.2,2.72571050892267,17.128883013879708,1031,99.23066754791805,40.67151354923992,0.49105089226701915
37199,"Yancey County, North Carolina",17605,8689,8916,21947,13035,1613,595,201,162,17427,1382,1106,2488,3419,1647,1772,6812,63,10.1,79.5,5.44163589889236,19.420619142289123,958,98.98892360124964,38.69355296790685,0.49355296790684466
38001,"Adams County, North Dakota",2368,1168,1200,35933,1686,310,61,36,55,2316,65,71,136,212,85,127,1271,13,2,92.2,6.418918918918919,8.952702702702704,152,97.80405405405405,53.673986486486484,0.49324324324324326
38003,"Barnes County, North Dakota",10971,5397,5574,32517,7728,1442,404,63,87,10775,381,168,549,1044,493,551,5624,40,3.67,85,5.049676419651809,9.515996718621821,554,98.213471880412,51.26241910491295,0.491933278643697
38005,"Benson County, North Dakota",6875,3520,3355,21658,3917,449,133,9,13,6861,554,359,913,2267,1124,1143,2349,28,4.44,83.7,2.2545454545454544,32.974545454545456,155,99.79636363636364,34.167272727272724,0.512
38007,"Billings County, North Dakota",983,566,417,44683,714,108,27,7,23,983,30,16,46,101,55,46,485,3,1.73,92.3,5.798575788402848,10.27466937945066,57,100,49.338758901322485,0.5757884028484231
38009,"Bottineau County, North Dakota",6651,3478,3173,35698,4644,831,131,26,31,6483,183,200,383,545,212,333,3246,11,2.45,83.9,2.8266426101338147,8.194256502781537,188,97.47406405051872,48.80469102390618,0.5229288828747557
38011,"Bowman County, North Dakota",3226,1544,1682,36318,2215,414,115,13,0,3165,95,99,194,267,96,171,1729,15,2.49,92,3.967761934283943,8.276503409795412,128,98.1091134531928,53.595784252944824,0.4786112833230006
38013,"Burke County, North Dakota",2253,1198,1055,35674,1472,216,72,2,6,2251,133,64,197,164,58,106,1115,4,2.34,85.5,3.5508211273857078,7.279183311140701,80,99.91122947181536,49.489569462938306,0.5317354638260098
38015,"Burleigh County, North Dakota",92372,46218,46154,36483,62512,15842,4176,1172,747,90369,3167,2557,5724,7596,3329,4267,50211,205,3.95,88.4,6.598319837180098,8.223271121118954,6095,97.83159398952063,54.35738102455289,0.5003464253236911
38017,"Cass County, North Dakota",170620,86284,84336,34193,106596,29143,7942,1932,1855,169233,6598,5021,11619,18612,8961,9651,98694,531,3.53,84.8,6.8743406400187554,10.908451529715157,11729,99.18708240534521,57.8443324346501,0.5057085921931779
38019,"Cavalier County, North Dakota",3817,1944,1873,43144,2774,443,56,0,23,3719,111,62,173,320,121,199,1855,0,3.25,79.8,2.0696882368352107,8.383547288446424,79,97.43253864291329,48.59837568771287,0.5093004977731203
38021,"Dickey County, North Dakota",5041,2513,2528,30510,3483,693,141,95,32,4902,90,166,256,299,121,178,2568,4,3.74,85.7,5.316405475104146,5.931362824836342,268,97.24261059313628,50.942273358460625,0.4985121999603253
38023,"Divide County, North Dakota",2378,1217,1161,39171,1823,335,12,0,7,2295,61,57,118,297,145,152,1187,3,1.56,87.8,0.798990748528175,12.489486963835155,19,96.50967199327165,49.91589571068125,0.5117746005046258
38025,"Dunn County, North Dakota",4349,2306,2043,42438,3035,527,111,32,27,4295,439,352,791,449,219,230,2053,27,2.76,90.2,3.90894458496206,10.324212462635089,170,98.75833524948264,47.20625431133594,0.5302368360542653
38027,"Eddy County, North Dakota",2321,1146,1175,35444,1634,277,70,28,5,2248,146,59,205,294,137,157,1166,42,4.01,83.2,4.437742352434295,12.666953899181387,103,96.8548039638087,50.23696682464455,0.49375269280482553
38029,"Emmons County, North Dakota",3389,1693,1696,29622,2530,352,28,3,10,3334,110,99,209,397,170,227,1441,9,3.78,88.3,1.209796400118029,11.71437002065506,41,98.37710239008557,42.51991737975804,0.49955739156093243
38031,"Foster County, North Dakota",3318,1645,1673,32665,2396,434,115,3,15,3243,101,72,173,229,81,148,1757,17,3.65,83.2,4.008438818565401,6.901748040988547,133,97.73960216998192,52.95358649789029,0.4957805907172996
38033,"Golden Valley County, North Dakota",1892,930,962,28840,1253,229,38,4,5,1836,166,112,278,173,78,95,992,17,2.01,92.3,2.4841437632135306,9.143763213530656,47,97.04016913319239,52.43128964059196,0.4915433403805497
38035,"Grand Forks County, North Dakota",70130,36438,33692,30465,40735,9054,3039,861,911,67954,2956,1915,4871,11119,5541,5578,38589,194,4.52,83,6.860116925709397,15.854841009553686,4811,96.89719093112791,55.02495365749323,0.5195779267075431
38037,"Grant County, North Dakota",2387,1188,1199,33537,1803,252,57,11,9,2338,86,60,146,299,131,168,1145,16,3.87,90.9,3.225806451612903,12.52618349392543,77,97.94721407624634,47.96816087138668,0.4976958525345622
38039,"Griggs County, North Dakota",2276,1153,1123,33416,1669,323,43,0,12,2179,61,85,146,175,81,94,1150,0,3.43,82.9,2.4165202108963095,7.6889279437609845,55,95.73813708260106,50.527240773286465,0.5065905096660809
38041,"Hettinger County, North Dakota",2601,1242,1359,32544,1935,231,35,10,5,2439,91,76,167,228,65,163,1171,3,2.62,91.1,1.9223375624759709,8.765859284890427,50,93.77162629757785,45.02114571318724,0.47750865051903113
38043,"Kidder County, North Dakota",2457,1316,1141,34455,1744,277,48,5,4,2453,204,130,334,169,98,71,1266,11,4.28,86.8,2.31990231990232,6.878306878306878,57,99.83719983719983,51.52625152625153,0.5356125356125356
38045,"LaMoure County, North Dakota",4106,2129,1977,36653,2938,532,132,6,11,4034,172,98,270,426,170,256,1989,6,3.68,85.4,3.6288358499756455,10.37506088650755,149,98.2464685825621,48.441305406721874,0.5185094982951778
38047,"Logan County, North Dakota",1932,993,939,31952,1441,172,20,0,5,1856,35,22,57,140,59,81,1013,6,4.33,85.2,1.2939958592132506,7.246376811594203,25,96.06625258799171,52.43271221532091,0.5139751552795031
38049,"McHenry County, North Dakota",5951,3091,2860,36874,4153,657,127,25,5,5869,187,127,314,462,236,226,2968,26,2.35,85.9,2.6382120651991263,7.763401109057301,157,98.62208032263486,49.873970761216604,0.5194085027726433
38051,"McIntosh County, North Dakota",2680,1310,1370,31133,2096,261,66,33,0,2571,65,27,92,253,91,162,1353,15,4.19,85.2,3.6940298507462686,9.440298507462687,99,95.93283582089552,50.485074626865675,0.48880597014925375
38053,"McKenzie County, North Dakota",11679,6243,5436,38324,7225,1338,326,95,66,11594,1012,1054,2066,1358,703,655,5845,27,2.42,91,4.1698775580101035,11.627707851699633,487,99.2721979621543,50.047093073037075,0.5345491908553814
38055,"McLean County, North Dakota",9607,4974,4633,36953,7026,1017,245,23,26,9419,291,308,599,837,349,488,4653,37,3.2,88.1,3.0602685541792445,8.71239721036744,294,98.04309357759966,48.433433954408244,0.5177474757988967
38057,"Mercer County, North Dakota",8637,4451,4186,36720,6130,999,251,91,51,8514,538,557,1095,611,148,463,4388,72,3.1,89.4,4.550191038555054,7.074215584114855,393,98.57589440778048,50.804677550075255,0.5153409748755355
38059,"Morton County, North Dakota",30059,15395,14664,37335,21029,4169,913,241,163,29494,995,742,1737,2318,1232,1086,17049,61,3.91,89.8,4.381383279550218,7.711500715259989,1317,98.12036328553845,56.71845370770817,0.5121594198077115
38061,"Mountrail County, North Dakota",9986,5519,4467,40113,6294,1048,201,72,46,9901,1042,809,1851,1101,533,568,4724,19,2.6,87.7,3.194472261165632,11.025435609853796,319,99.14880833166433,47.30622872020829,0.5526737432405368
38063,"Nelson County, North Dakota",2971,1530,1441,33599,2259,372,83,6,2,2891,133,128,261,243,86,157,1515,61,3.95,82.2,3.0629417704476607,8.179064288118479,91,97.30730393806799,50.99293167283743,0.5149781218444968
38065,"Oliver County, North Dakota",1822,950,872,38604,1339,215,22,21,4,1817,112,92,204,57,16,41,901,6,3.13,88.9,2.579582875960483,3.128430296377607,47,99.72557628979143,49.451152579582875,0.5214050493962679
38067,"Pembina County, North Dakota",7050,3667,3383,34824,5150,833,142,51,12,6862,298,193,491,387,218,169,3512,22,3.33,81.6,2.9078014184397163,5.48936170212766,205,97.33333333333333,49.815602836879435,0.5201418439716312
38069,"Pierce County, North Dakota",4272,2155,2117,26619,3061,366,98,20,0,4093,146,85,231,720,298,422,1948,0,3.05,84.5,2.762172284644195,16.853932584269664,118,95.80992509363296,45.59925093632959,0.5044475655430711
38071,"Ramsey County, North Dakota",11574,5897,5677,33884,7925,1450,351,132,28,11098,468,333,801,1344,698,646,6231,97,4.47,82.4,4.415068256436841,11.612234318299636,511,95.88733367893555,53.83618455158113,0.5095040608259893
38073,"Ransom County, North Dakota",5411,2772,2639,33574,3796,590,75,25,34,5259,131,82,213,347,146,201,2777,0,4.32,85.9,2.476436887821105,6.412862687118832,134,97.1909074108298,51.32138236924783,0.5122897800776197
38075,"Renville County, North Dakota",2543,1241,1302,30888,1732,241,31,8,0,2474,45,75,120,119,28,91,1193,0,2.87,85.7,1.533621706645694,4.679512386944554,39,97.28666928824224,46.91309476995674,0.4880062917813606
38077,"Richland County, North Dakota",16333,8434,7899,29818,10565,1763,441,100,38,16177,319,373,692,1461,619,842,8654,44,5.13,84.5,3.544970305516439,8.94508051184718,579,99.04487846690749,52.9847547909141,0.5163778852629646
38079,"Rolette County, North Dakota",14657,7250,7407,18075,8348,1383,270,39,39,14539,2376,1663,4039,4668,2145,2523,5045,1,2.78,81.8,2.3742921470969502,31.848263628300472,348,99.19492392713379,34.420413454322166,0.49464419731186465
38081,"Sargent County, North Dakota",3883,2008,1875,36207,2826,451,67,4,5,3844,77,64,141,163,62,101,2050,6,5,85.7,1.957249549317538,4.197785217615246,76,98.99562194179758,52.79423126448622,0.5171259335565285
38083,"Sheridan County, North Dakota",1403,686,717,34172,1104,123,29,4,0,1403,55,47,102,215,59,156,595,0,3.66,87.1,2.352102637205987,15.324305060584463,33,100,42.40912330719886,0.488952245188881
38085,"Sioux County, North Dakota",4420,2212,2208,15944,2312,289,73,17,22,4381,740,587,1327,1616,763,853,1299,17,3.79,90.9,2.5339366515837103,36.56108597285068,112,99.11764705882354,29.38914027149321,0.5004524886877828
38087,"Slope County, North Dakota",674,350,324,35118,503,113,19,3,0,674,36,20,56,46,24,22,304,4,2.53,92,3.264094955489614,6.824925816023739,22,100,45.103857566765576,0.5192878338278932
38089,"Stark County, North Dakota",30316,15719,14597,37978,19821,3454,865,181,223,29932,1382,1333,2715,2387,992,1395,16314,44,2.47,91,4.18590843119145,7.873730043541364,1269,98.73334212956854,53.81316796411136,0.5185050798258345
38091,"Steele County, North Dakota",1915,1003,912,40479,1411,321,38,0,2,1915,25,43,68,72,35,37,1042,4,3.98,81.3,2.088772845953003,3.759791122715405,40,100,54.41253263707572,0.5237597911227154
38093,"Stutsman County, North Dakota",21058,10781,10277,31182,14545,2713,577,140,63,20157,867,661,1528,2148,912,1236,10845,141,3.66,84.5,3.704055465856207,10.200398898280937,780,95.7213410580302,51.50061734257764,0.5119669484281508
38095,"Towner County, North Dakota",2258,1143,1115,36099,1643,230,62,5,0,2229,107,88,195,277,118,159,952,8,3.42,81.9,2.9672276350752878,12.267493356953056,67,98.7156775907883,42.16120460584588,0.5062001771479185
38097,"Traill County, North Dakota",8050,4091,3959,31774,5477,1013,369,17,28,7861,195,140,335,525,275,250,4153,28,4.28,82.3,5.142857142857143,6.521739130434782,414,97.65217391304348,51.590062111801245,0.5081987577639752
38099,"Walsh County, North Dakota",10920,5606,5314,30693,7682,963,208,97,25,10736,401,317,718,1054,480,574,5429,21,3.79,82.1,3.021978021978022,9.652014652014651,330,98.31501831501832,49.71611721611722,0.5133699633699633
38101,"Ward County, North Dakota",69628,36366,33262,33414,43084,8861,2327,595,242,65462,3029,1995,5024,5632,2091,3541,39636,140,2.22,86.7,4.544148905612684,8.088699948296663,3164,94.01677486068823,56.9253748491986,0.5222898833802493
38103,"Wells County, North Dakota",4089,2036,2053,33580,3059,572,101,7,19,3998,78,68,146,231,112,119,2028,24,4.25,84.3,3.1058938615798484,5.649303008070433,127,97.77451699682074,49.5964783565664,0.4979212521398875
38105,"Williams County, North Dakota",32916,18015,14901,44474,21218,3806,692,213,74,32554,1893,1692,3585,2900,1569,1331,17500,36,2.2,90,2.9742374529104385,8.810305018835825,979,98.90023089075221,53.16563373435412,0.5473022238425082
39001,"Adams County, Ohio",27926,13960,13966,20248,18982,1507,574,168,54,27656,1617,1163,2780,6537,2765,3772,9984,113,5.74,85.3,2.850390317267063,23.408293346702,796,99.03315906323856,35.75162930602306,0.49989257322924874
39003,"Allen County, Ohio",104157,52614,51543,24551,69226,7294,3479,918,555,101696,4880,3152,8032,15088,7159,7929,47348,381,8.07,82.4,4.754361204719798,14.485824284493601,4952,97.63722073408412,45.45829853010359,0.5051412771105158
39005,"Ashland County, Ohio",53299,26005,27294,24612,35269,4481,1968,238,437,52713,2497,2521,5018,7230,3404,3826,24409,182,5.96,81.9,4.958817238597347,13.564982457456988,2643,98.90054222405674,45.79635640443536,0.48790784067243287
39007,"Ashtabula County, Ohio",98622,49509,49113,21936,68750,6082,2531,343,240,95570,5287,4282,9569,18854,8731,10123,39360,237,5.7,80.1,3.157510494615806,19.117438299770843,3114,96.90535580296486,39.90995923830383,0.5020076656324147
39009,"Athens County, Ohio",65563,32641,32922,20062,36239,4953,3699,384,1677,64883,2482,2016,4498,16837,8431,8406,26829,48,7.33,83.4,8.78544300901423,25.680643045620243,5760,98.96282964476916,40.9209462654241,0.4978570230160304
39011,"Auglaize County, Ohio",45778,22866,22912,28340,30928,3678,1651,246,141,45256,1078,855,1933,4079,1525,2554,22938,114,7.88,82.2,4.451920136310018,8.91039363886583,2038,98.85971427323169,50.107038315347985,0.49949757525448907
39013,"Belmont County, Ohio",68889,35167,33722,25326,50566,5104,2483,302,266,65032,2610,2023,4633,9153,4085,5068,28724,252,7.11,82.2,4.428863824413186,13.28659147323956,3051,94.40113806268054,41.69606178054551,0.51048788630986075
39015,"Brown County, Ohio",43799,21693,22106,24525,30273,2753,956,81,85,43252,2153,1450,3603,7641,3000,4641,18808,93,6.3,85.1,2.561702321970821,17.44560378090824,1122,98.75111303911048,42.941619671682005,0.49528528048585585
39017,"Butler County, Ohio",375702,184149,191553,29745,239423,45304,19696,2356,3444,372296,13562,11744,25306,47018,20228,26790,177277,1018,5.98,85.3,6.786229511687455,12.514705804068118,25496,99.09343043156544,47.18553534450176,0.4901464458533625
39019,"Carroll County, Ohio",27825,13824,14001,26908,19793,1423,717,146,158,27540,1695,1482,3177,4053,1779,2274,12252,52,6.7,82.2,3.669362084456424,14.566037735849056,1021,98.97574123989219,44.03234501347709,0.49681940700808624
39021,"Champaign County, Ohio",39005,19453,19552,25528,26634,2758,1339,121,71,38525,1460,889,2349,4211,1859,2352,17573,34,7.13,81.6,3.925137802845789,10.796051788232278,1531,98.76938853993077,45.05319830790924,0.4987309319318036
39023,"Clark County, Ohio",135520,65575,69945,25270,92524,10389,5368,914,513,133707,5223,4514,9737,21956,9737,12219,59343,356,7.9,82.4,5.014020070838253,16.2012987012987,6795,98.66219008264463,43.789108618654076,0.48387691853600945
39025,"Clermont County, Ohio",202166,99940,102226,31812,137653,25552,10852,1686,874,200864,6533,5416,11949,19660,8897,10763,99124,524,6.14,85.4,6.634152132406043,9.724681697219117,13412,99.3559747929919,49.030994331391035,0.494346230325574
39027,"Clinton County, Ohio",41869,20707,21162,25238,27907,3290,1241,156,183,41542,1719,1374,3093,5962,2696,3266,18657,176,6.95,83.4,3.7736750340347274,14.239652248680407,1580,99.21899257207002,44.56041462657336,0.49456638563137406
39029,"Columbiana County, Ohio",104584,52586,51998,24758,74871,6907,2828,424,251,101017,4963,3794,8757,15538,6913,8625,44456,330,5.5,82.6,3.349460720569112,14.856957087126139,3503,96.58934445039394,42.50745811978888,0.5028111374588847
39031,"Coshocton County, Ohio",36602,18192,18410,21520,25208,2310,770,70,31,36206,2431,2253,4684,5424,2529,2895,15282,118,7.11,82.2,2.3796513851702095,14.818862357248237,871,98.91809190754604,41.751816840609806,0.49702202065460904
39033,"Crawford County, Ohio",42231,20626,21605,24386,29583,2793,1261,220,64,41665,1737,1292,3029,6751,2767,3984,18306,84,6.56,82.1,3.658449953825389,15.985887144514694,1545,98.65975231465038,43.34730411309228,0.48840898865762117
39035,"Cuyahoga County, Ohio",1257401,599033,658368,30441,874449,160928,76780,24900,12547,1242429,49229,37494,86723,225265,100303,124962,576149,3795,5.53,81.5,9.084373242903418,17.915128109489334,114227,98.80928995602835,45.82062524206677,0.4764056971483242
39037,"Darke County, Ohio",51919,25569,26350,24768,35392,3097,1681,175,80,51295,1845,1529,3374,5919,2729,3190,23997,165,6.93,83.4,3.7288853791482888,11.400450702055124,1936,98.79812785300179,46.22007357614746,0.4924786686954679
39039,"Defiance County, Ohio",38311,18969,19342,26941,25859,2859,1052,174,105,38007,1505,1132,2637,4113,1829,2284,18349,78,6.35,82.5,3.474198011015113,10.735819999477958,1331,99.20649421837071,47.89486048393412,0.4951319464383597
39041,"Delaware County, Ohio",193024,95515,97509,45116,125605,43247,17817,4099,2393,192150,4326,3439,7765,9625,4254,5371,98148,499,7.69,83.2,12.593770722811671,4.986426558355437,24309,99.54720656498674,50.84756299734748,0.4948348391909814
39043,"Erie County, Ohio",75369,36972,38397,30223,53623,7607,3110,866,407,74420,2993,2130,5123,9636,4112,5524,35120,151,5.75,81.6,5.815388289615094,12.785097321179796,4383,98.74086162745957,46.59740742214969,0.49054651116506787
39045,"Fairfield County, Ohio",151526,75440,76086,29582,101759,18159,7081,1172,687,148789,4621,3827,8448,14776,6390,8386,70025,425,10.06,83.2,5.899977561606589,9.751461795335453,8940,98.19370933041195,46.2131911355147,0.49786835262595197
39047,"Fayette County, Ohio",28659,14027,14632,24013,19567,2296,588,132,67,28227,1289,1170,2459,4944,2330,2614,12260,29,7.26,83.6,2.7460832548239646,17.25112530095258,787,98.49262011933423,42.77888272444956,0.48944485153006034
39049,"Franklin County, Ohio",1253507,611086,642421,31199,830824,203292,82166,20632,15201,1245449,63252,48674,111926,203877,93071,110806,636160,4846,8.37,84.1,9.413509457865015,16.26452823957106,117999,99.35716354196666,50.75041463669529,0.48750106700640683
39051,"Fulton County, Ohio",42296,20912,21384,27922,28437,3208,1313,279,114,41902,1291,774,2065,4417,2065,2352,20410,75,5,82.8,4.033478343105731,10.443067902402118,1706,99.06846983166257,48.25515415169283,0.4944202761490448
39053,"Gallia County, Ohio",30203,14814,15389,22293,20616,2008,1109,120,107,29822,1811,1491,3302,6143,2497,3646,11747,137,6.58,85,4.42340164884283,20.33903916829454,1336,98.7385359070291,38.89348740191372,0.4904810780386054
39055,"Geauga County, Ohio",93895,46220,47675,39513,63761,15660,6370,1413,755,93218,5258,4337,9595,6076,2856,3220,46305,305,5.7,80.6,9.093135949731083,6.471058096810267,8538,99.27898184141861,49.31572501198147,0.49225198359870065
39057,"Greene County, Ohio",164825,81014,83811,33138,110009,22359,14866,2318,3088,160786,5371,3574,8945,19093,8258,10835,77900,277,6.41,83.2,12.299105111481875,11.583801001061731,20272,97.54952222053693,47.262247838616716,0.49151524344001213
39059,"Guernsey County, Ohio",39414,19544,19870,22864,27364,2355,1184,185,87,38938,1960,1562,3522,7857,3525,4332,16030,202,8.02,82.8,3.694118841020957,19.934541026031358,1456,98.79230730197392,40.670827624701886,0.4958644136601208
39061,"Hamilton County, Ohio",808703,389496,419207,32638,543437,119701,54411,14031,9096,800780,34177,24420,58597,134499,59683,74816,387362,2332,6,85.8,9.587945141788765,16.631445660520612,77538,99.02028309527725,47.899166937676746,0.4816304626049365
39063,"Hancock County, Ohio",75508,37209,38299,29608,51339,8756,4148,620,406,74673,2263,2186,4449,8878,3822,5056,36711,117,7.11,82.6,6.8522540657943525,11.757694548921968,5174,98.89415691052604,48.6186894103936,0.4927822217513376
39065,"Hardin County, Ohio",31576,15620,15956,21099,19238,1663,1073,103,143,31383,1523,1488,3011,4844,2327,2517,13496,162,6.45,81.9,4.177223207499367,15.340765138079554,1319,99.38877628578668,42.74132252343552,0.49467950342031924
39067,"Harrison County, Ohio",15397,7606,7791,22965,11048,804,270,87,42,15136,697,672,1369,2371,1071,1300,6614,37,6.86,82.2,2.5914139118010002,15.39910372150419,399,98.30486458400988,42.956420081834125,0.49399233616938365
39069,"Henry County, Ohio",27463,13558,13905,27325,18768,1997,1048,104,118,27056,675,529,1204,2437,1107,1330,13293,90,5.65,82.8,4.624403743218148,8.873757419072934,1270,98.51800604449623,48.403306266613264,0.4936824090594618
39071,"Highland County, Ohio",43031,21262,21769,22079,29233,1937,1237,251,184,42611,2273,1772,4045,9150,4197,4953,17146,103,7.2,84.2,3.885570867514118,21.263740094350585,1672,99.023959471079,39.84569264018963,0.49410889823615534
39073,"Hocking County, Ohio",28547,14122,14425,23192,19928,1830,789,139,44,27897,1315,1056,2371,3947,1604,2343,12215,76,7.86,82.6,3.4049111990752094,13.826321504886678,972,97.72305321049497,42.78908466739062,0.4946929624829229
39075,"Holmes County, Ohio",43808,21874,21934,21143,25080,1525,416,129,54,42998,8515,8788,17303,5132,2264,2868,19293,452,7.3,81.9,1.3673301680058436,11.714755295836376,599,98.1510226442659,44.03990138787436,0.4993151935719503
39077,"Huron County, Ohio",58497,28837,29660,24193,39248,3552,1486,280,64,57967,2799,2090,4889,8224,3836,4388,26588,147,5.74,82,3.128365557208062,14.05884062430552,1830,99.09397063097254,45.45190351641965,0.4929654512197207
39079,"Jackson County, Ohio",32624,15953,16671,21730,22242,2380,1075,59,0,32289,1665,1459,3124,6627,2857,3770,13038,85,5.89,83.6,3.4759686120647375,20.31326630701324,1134,98.973148602256,39.96444335458558,0.48899583128984797
39081,"Jefferson County, Ohio",67349,32579,34770,24028,47783,4557,1885,347,326,66602,2657,2017,4674,11413,5102,6311,27198,153,5.52,82.4,3.7981261785624136,16.946057105524954,2558,98.89085212846516,40.38367310576252,0.48373398268719653
39083,"Knox County, Ohio",60945,29830,31115,24523,39653,6087,1951,291,671,60352,3166,2922,6088,7914,3359,4555,27963,270,7.57,81.4,4.779719419148413,12.985478710312577,2913,99.02699154975798,45.88235294117647,0.4894577077693002
39085,"Lake County, Ohio",229701,112214,117487,32125,164024,28556,12670,2032,1399,227606,7496,5703,13199,18837,8748,10089,115601,268,5.65,80.2,7.009547193960845,8.200660859116851,16101,99.08794476297447,50.326729095650435,0.48852203516745685
39087,"Lawrence County, Ohio",61057,29977,31080,22844,42715,3860,1728,383,207,60474,2688,2010,4698,11201,5035,6166,24341,249,5.91,85.5,3.7964524952093943,18.34515288992253,2318,99.04515452773637,39.8660268273908,0.4909674566388784
39089,"Licking County, Ohio",170678,83575,87103,29093,114884,18347,7330,1439,1104,169335,6706,5784,12490,19591,8619,10972,81448,738,8.73,82.2,5.784576805446513,11.478339329028932,9873,99.21313819004207,47.72026857591488,0.48966474882527333
39091,"Logan County, Ohio",45323,22419,22904,26525,30964,3295,1162,139,89,44989,2449,1736,4185,6116,2526,3590,20766,75,6.6,81.4,3.066875537806412,13.494252366348212,1390,99.26306731681487,45.81779670366039,0.49464951569843124
39093,"Lorain County, Ohio",305405,150419,154986,28555,209343,31130,14244,2609,1650,298973,9871,7679,17550,40477,16719,23758,138393,2348,5.59,82.1,6.058512467051948,13.25354856665739,18503,97.89394410700545,45.31458227599417,0.4925230431721812
39095,"Lucas County, Ohio",433404,210162,223242,27111,290699,45679,19753,5564,3548,428267,18357,12792,31149,83744,38870,44874,193604,1693,5.04,83,6.660067742798867,19.322387426050522,28865,98.81473175143746,44.67056141613829,0.4849101531134923
39097,"Madison County, Ohio",43732,23892,19840,27798,31005,3749,1154,197,93,38792,1853,1127,2980,3926,1747,2179,18312,168,8.72,83.1,3.3019299368883197,8.977407847800238,1444,88.70392390011891,41.87322784231227,0.5463276319399982
39099,"Mahoning County, Ohio",231857,112946,118911,25901,164310,25192,9538,2194,1221,227056,8439,6343,14782,39616,17169,22447,100852,1171,5.27,83.2,5.586633140254554,17.08639376857287,12953,97.92932712835929,43.49750061460297,0.48713646773657904
39101,"Marion County, Ohio",65483,34853,30630,22579,46284,3871,1985,313,73,59921,2567,1720,4287,9846,4421,5425,25327,183,6.26,82.6,3.6207870745078874,15.03596353251989,2371,91.50619244689462,38.67721393338729,0.5322450101553075
39103,"Medina County, Ohio",176362,87232,89130,34174,121783,26703,9652,1751,962,175201,4917,4173,9090,10764,4426,6338,90042,573,5.64,82.4,7.011147526111067,6.103355598144725,12365,99.34169492294258,51.055215976230706,0.4946190222383507
39105,"Meigs County, Ohio",23234,11517,11717,22396,16464,1343,644,82,64,23031,1074,847,1921,5179,2388,2791,8660,22,6.28,84.4,3.400189377636223,22.290608590858223,790,99.1262804510631,37.27296203839201,0.49569596281311873
39107,"Mercer County, Ohio",40723,20484,20239,27540,26909,2700,1607,128,38,40331,1098,850,1948,2989,1217,1772,20372,87,8.09,82.4,4.35380497507551,7.339832527073153,1773,99.03739901284287,50.02578395501314,0.5030081280848661
39109,"Miami County, Ohio",104081,51484,52597,28051,71937,9450,4766,670,212,103188,3621,2992,6613,10150,4317,5833,49593,323,7,83.6,5.426542788789501,9.752020061298412,5648,99.1420143926365,47.64846609851942,0.4946532027939778
39111,"Monroe County, Ohio",14239,7140,7099,23154,10251,708,386,52,21,14095,809,629,1438,2772,1342,1430,5280,15,8.28,82.6,3.2235409790013345,19.46765924573355,459,98.98869302619566,37.08125570615914,0.501439707844652
39113,"Montgomery County, Ohio",531987,256138,275849,27602,362689,58083,29664,5543,3822,523788,23407,18235,41642,92085,40661,51424,237519,1591,5.88,84.1,7.33645746982539,17.309633506081916,39029,98.45879692548878,44.64751958224543,0.48147417136133025
39115,"Morgan County, Ohio",14773,7395,7378,22122,10462,924,377,43,17,14589,818,625,1443,3110,1457,1653,5712,36,8.64,83.1,2.9580992350910447,21.051919041494617,437,98.75448453259324,38.66513233601841,0.5005753739930955
39117,"Morrow County, Ohio",34935,17467,17468,24864,23769,2221,856,148,17,34670,1222,942,2164,3347,1802,1545,16761,174,7.08,81.8,2.9225704880492342,9.580649778159438,1021,99.2414484041792,47.977672820953195,0.49998568770573926
39119,"Muskingum County, Ohio",85933,41718,44215,22877,58183,5808,2691,410,242,85105,3502,2680,6182,13877,6422,7455,37341,172,7.6,82.8,3.890240070752796,16.148627419035762,3343,99.0364586363795,43.45362084414602,0.4854712392212538
39121,"Noble County, Ohio",14498,8626,5872,23119,10992,622,521,10,7,11973,355,319,674,1534,701,833,4053,15,8.47,83.4,3.7108566698855014,10.580769761346392,538,82.5838046627121,27.955580080011035,0.594978617740378
39123,"Ottawa County, Ohio",40769,20272,20497,31574,30165,4255,1840,450,193,40364,1214,1074,2288,4219,1735,2484,18782,67,5.32,82.6,6.0904118325198064,10.348549142730997,2483,99.00659815055558,46.06931737349457,0.4972405504182099
39125,"Paulding County, Ohio",18951,9493,9458,24319,13041,1235,516,50,27,18845,717,610,1327,2006,888,1118,8554,102,7.43,83.4,3.129122473748087,10.58519339348847,593,99.44066276185953,45.13745976465622,0.5009234341195715
39127,"Perry County, Ohio",35983,18012,17971,21557,24368,1923,759,108,51,35728,1300,1477,2777,6838,3102,3736,14577,61,9.43,82.2,2.5512047355695744,19.00341828085485,918,99.29133201789735,40.51079676513909,0.500569713475808
39129,"Pickaway County, Ohio",57075,30052,27023,25460,39415,4430,1988,281,137,52578,2246,1802,4048,6253,2964,3289,24151,130,8.41,84.7,4.21550591327201,10.955759964958387,2406,92.12089356110381,42.31449846692948,0.5265352606219886
39131,"Pike County, Ohio",28291,14102,14189,21983,19382,1380,1000,111,79,27954,1815,1070,2885,5565,2732,2833,10112,32,6.41,84.5,4.20628468417518,19.67056661128981,1190,98.80880845498568,35.74281573645329,0.4984624085398183
39133,"Portage County, Ohio",162080,79258,82822,27985,103892,17476,8283,1095,1675,161013,5470,4954,10424,22493,9341,13152,79141,282,5.19,82.6,6.819471865745311,13.877714708785785,11053,99.34168311944718,48.828356367226064,0.4890054294175716
39135,"Preble County, Ohio",41328,20452,20876,25374,28599,2779,1071,152,117,40991,1400,1445,2845,5017,2292,2725,19088,168,7.03,83.5,3.2423538521099498,12.139469608981804,1340,99.18457220286489,46.18660472319009,0.4948703058459156
39137,"Putnam County, Ohio",34037,16979,17058,28568,22550,2682,1404,131,78,33778,493,633,1126,2416,996,1420,17327,38,7.48,82.8,4.738960542938567,7.098157887005318,1613,99.2390633722126,50.90636660105179,0.49883949819314277
39139,"Richland County, Ohio",121533,61682,59851,23439,84759,9997,3521,729,314,114868,5591,5313,10904,17674,7799,9875,49578,335,6.39,81.7,3.755358626875005,14.542552228612804,4564,94.51589280277784,40.79385845819654,0.5075329334419458
39141,"Ross County, Ohio",77125,40622,36503,22714,54199,5609,2397,400,249,71395,3142,2498,5640,12925,5659,7266,29970,228,6.58,84.5,3.9494327390599677,16.758508914100485,3046,92.57050243111831,38.85899513776337,0.5267034035656402
39143,"Sandusky County, Ohio",59559,29478,30081,25219,41001,4178,1725,206,111,58686,2014,2070,4084,7916,3503,4413,27795,131,6.51,82.8,3.428533051260095,13.291022347588106,2042,98.53422656525463,46.66800987256334,0.4949377927769103
39145,"Scioto County, Ohio",76871,37968,38903,22586,53021,4507,2749,480,329,74052,2870,2684,5554,17432,8045,9387,27593,92,6.14,85.1,4.628533517191139,22.67695229670487,3558,96.33281731732383,35.895201051111606,0.49391838274511846
39147,"Seneca County, Ohio",55549,27734,27815,25004,37041,3588,1743,217,135,54607,1874,1325,3199,7954,3525,4429,25080,175,7.52,82.5,3.7714450305136005,14.318889628976219,2095,98.30419989558769,45.149327620659236,0.49927091396784823
39149,"Shelby County, Ohio",48902,24685,24217,28410,32291,3319,1811,214,174,48565,1254,946,2200,4286,1813,2473,23999,156,8.28,82.4,4.496748599239295,8.764467710932069,2199,99.31086663122163,49.07570242525868,0.5047850803648113
39151,"Stark County, Ohio",374273,181773,192500,27401,259199,37494,16220,3228,2055,369531,13422,10514,23936,50921,22083,28838,173889,753,5.92,83.3,5.745271499680714,13.605309493337751,21503,98.73301039615468,46.460471367157126,0.48566955137025647
39153,"Summit County, Ohio",541318,262534,278784,30803,376758,76503,30513,7427,4650,536137,20498,15842,36340,72232,31789,40443,259293,1142,5.15,83.2,7.867833694796774,13.343727716425466,42590,99.04289160899877,47.9003099841498,0.48499033839628464
39155,"Trumbull County, Ohio",203341,99211,104130,25542,144530,18352,6395,1290,991,199734,9516,7137,16653,34254,15191,19063,86857,340,5.24,82.4,4.2667243694090224,16.845594346442674,8676,98.22613245730079,42.7149468134808,0.48790455441843994
39157,"Tuscarawas County, Ohio",92531,45562,46969,25054,63997,6390,2672,451,154,91574,5016,3846,8862,12610,5638,6972,42504,280,7.23,82.6,3.5415158163210165,13.62786525596827,3277,98.96575201824254,45.934875879435,0.4923971425792437
39159,"Union County, Ohio",54688,26167,28521,33066,36486,7591,2658,602,385,51476,1522,1213,2735,3799,1613,2186,26380,43,6.27,82.6,6.665081919251024,6.946679344645992,3645,94.12668227033353,48.23727325921592,0.47847791105909887
39161,"Van Wert County, Ohio",28262,13867,14395,26130,19353,1999,968,143,63,27985,1162,920,2082,3538,1610,1928,13279,194,8.27,82.8,4.1539876866463805,12.518576180029722,1174,99.01988535843182,46.98535135517656,0.49065883518505415
39163,"Vinton County, Ohio",13142,6608,6534,19876,9125,656,220,37,28,13065,667,497,1164,2747,1162,1585,5110,47,6.23,82.8,2.168619692588647,20.90245015979303,285,99.41409222340587,38.88297062851925,0.5028154010044134
39165,"Warren County, Ohio",223868,112736,111132,37479,149409,39973,17526,3126,1964,216797,5181,4457,9638,11016,4676,6340,107283,296,6.02,84.7,10.102381760680402,4.92075687458681,22616,96.84144227848553,47.92243643575679,0.503582468240213
39167,"Washington County, Ohio",60871,30077,30794,26608,43182,5305,2003,453,298,60177,2747,2213,4960,9120,4231,4889,26342,137,8.5,84.4,4.524321926697442,14.982503983834667,2754,98.8598840170196,43.27512280067684,0.4941104959668808
39169,"Wayne County, Ohio",115915,57412,58503,25762,75948,9987,4609,674,662,114790,7863,6884,14747,14611,6194,8417,54626,574,5.97,82.3,5.128758141741794,12.6049260233792,5945,99.02946124315231,47.12591122805504,0.4952939654056852
39171,"Williams County, Ohio",37061,18360,18701,24160,25656,2404,1027,207,100,35876,1086,699,1785,4835,2029,2806,17268,186,6.27,82,3.5994711421710153,13.046059199697796,1334,96.8025687380265,46.5934540352392,0.4953994765386795
39173,"Wood County, Ohio",129504,63767,65737,30042,79713,14867,7839,1346,1642,128164,3793,2714,6507,16409,7475,8934,65074,389,5.72,83,8.3603595255745,12.670651099579937,10827,98.96528292562392,50.24864096861873,0.4923940573264146
39175,"Wyandot County, Ohio",22190,10992,11198,25431,15312,1642,522,84,42,21928,874,556,1430,2474,1000,1474,10695,118,6.4,82.4,2.9202343397926995,11.149166291122127,648,98.81928796755295,48.19738621000451,0.4953582694907616
40001,"Adair County, Oklahoma",22136,10987,11149,16576,14315,1450,389,33,72,22006,3115,2808,5923,6744,3214,3530,8045,55,11.38,90.3,2.231658836284785,30.46620889049512,494,99.41272135887243,36.34351282977954,0.49634080231297434
40003,"Alfalfa County, Oklahoma",5877,3502,2375,28007,4331,651,217,13,25,4830,327,235,562,539,260,279,2194,40,4.32,96.6,4.338948443083206,9.171345924791561,255,82.18478815722307,37.331972094606094,0.5958822528500936
40005,"Atoka County, Oklahoma",13899,7340,6559,19439,9662,964,360,44,39,12255,1075,1199,2274,2420,1012,1408,4610,42,9.13,92.9,3.1872796604072233,17.411324555723432,443,88.17181092164904,33.16785380243183,0.52809554644219
40007,"Beaver County, Oklahoma",5445,2701,2744,25935,3624,562,124,14,20,5361,296,372,668,623,284,339,2471,30,4.89,95.8,2.9017447199265383,11.441689623507806,158,98.4573002754821,45.38108356290174,0.4960514233241506
40009,"Beckham County, Oklahoma",22971,12263,10708,23883,15126,1732,511,198,82,21284,1519,1579,3098,2661,1064,1597,9235,30,6.82,97.6,3.4434722040834096,11.584171346480344,791,92.65595751164511,40.20286448130251,0.5338470245091638
40011,"Blaine County, Oklahoma",9680,5070,4610,22823,6929,813,308,21,38,8178,440,529,969,1224,458,766,3393,21,7.24,96.7,3.791322314049587,12.644628099173554,367,84.48347107438016,35.05165289256198,0.5237603305785123
40013,"Bryan County, Oklahoma",45068,21890,23178,22171,29985,4341,1899,259,260,44611,3943,3740,7683,7643,3479,4164,18351,225,8.47,93.3,5.3652258808910975,16.958817786456024,2418,98.98597674625012,40.718469867755395,0.4857104819384042
40015,"Caddo County, Oklahoma",29437,15383,14054,21071,19403,2425,789,47,37,28419,3177,2893,6070,5879,2808,3071,11080,123,8.02,95.5,2.9656554676087916,19.97146448347318,873,96.54176716377349,37.63970513299589,0.522573631823895
40017,"Canadian County, Oklahoma",132922,66068,66854,29852,87615,16945,4745,715,539,131086,7449,6093,13542,10332,4836,5496,66015,610,7.73,96,4.513173139134229,7.772979642196175,5999,98.61873880922646,49.66446487413671,0.497043378823671
40019,"Carter County, Oklahoma",48407,23449,24958,24965,32059,4269,1618,402,240,47753,3523,3457,6980,7783,3360,4423,20142,157,6.27,93.8,4.668746255706819,16.078253145206272,2260,98.64895572954325,41.6096845497552,0.4844134112834921
40021,"Cherokee County, Oklahoma",48404,23854,24550,19799,30014,4760,1933,208,292,47972,5568,5491,11059,9824,4487,5337,19123,126,12.25,91.1,5.026444095529295,20.29584331873399,2433,99.1075117758863,39.50706553177423,0.4928105115279729
40023,"Choctaw County, Oklahoma",14979,7248,7731,19446,10236,935,280,42,23,14804,2095,1814,3909,4565,1987,2578,4997,55,9.77,92.5,2.303224514320048,30.475999732959476,345,98.83169771012751,33.36003738567327,0.48387742839975967
40025,"Cimarron County, Oklahoma",2221,1118,1103,28461,1568,277,43,0,13,2197,145,145,290,349,118,231,1013,20,4.75,92.3,2.5213867627194957,15.713642503376857,56,98.91940567312021,45.61008554705088,0.5033768572714993
40027,"Cleveland County, Oklahoma",274024,136970,137054,29231,172643,34763,14221,2771,3596,268406,14428,12728,27156,33054,15128,17926,136713,977,7.71,95.4,7.513210521706128,12.062447084926868,20588,97.94981461477826,49.89088546988585,0.4998467287536858
40029,"Coal County, Oklahoma",5666,2819,2847,24004,3797,382,196,25,26,5598,761,577,1338,1122,513,609,2181,19,10.12,93.4,4.3593363925167665,19.802329685845393,247,98.79985880691846,38.49276385457112,0.4975291210730674
40031,"Comanche County, Oklahoma",123066,63755,59311,25186,77391,10578,4783,843,710,110771,8035,7596,15631,18951,8248,10703,56360,542,8.18,95,5.148456925552143,15.399054166057237,6336,90.00942583654299,45.7965644450945,0.5180553524125266
40033,"Cotton County, Oklahoma",6000,2973,3027,21887,4100,447,147,23,29,5858,483,521,1004,895,376,519,2397,15,6.51,96,3.316666666666667,14.916666666666666,199,97.63333333333334,39.95,0.4955
40035,"Craig County, Oklahoma",14563,7416,7147,20666,10225,1078,295,67,58,13817,1166,1071,2237,2476,1168,1308,5623,104,10.61,91,2.88402114948843,17.001991347936553,420,94.87742910114675,38.611549818031996,0.5092357343953856
40037,"Creek County, Oklahoma",70899,35142,35757,24056,47963,5274,1607,319,282,70086,5094,4522,9616,10589,4576,6013,29970,123,11.32,93.4,3.114289341175475,14.935330540628218,2208,98.85329835399654,42.27140016079211,0.49566284432784663
40039,"Custer County, Oklahoma",29169,14654,14515,24621,17015,3064,1174,106,166,28686,2566,1896,4462,4366,2039,2327,13674,22,6.86,96.8,4.957317700298262,14.967945421509137,1446,98.34413246940245,46.8785354314512,0.5023826665295348
40041,"Delaware County, Oklahoma",41878,20687,21191,22175,30075,3213,1174,274,310,41497,3868,3870,7738,7861,3579,4282,15124,201,12.3,90.5,4.197908209561106,18.77119251158126,1758,99.09021443239887,36.11442762309566,0.4939825206552366
40043,"Dewey County, Oklahoma",4904,2464,2440,25821,3222,527,131,18,27,4801,430,340,770,889,402,487,2065,13,6.53,95.4,3.5889070146818924,18.128058727569332,176,97.89967373572594,42.10848287112561,0.5024469820554649
40045,"Ellis County, Oklahoma",4102,1983,2119,27272,2844,470,120,20,4,4060,289,230,519,696,328,368,1746,27,5.62,95.7,3.5104826913700635,16.96733300828864,144,98.97610921501706,42.56460263286202,0.4834227206240858
40047,"Garfield County, Oklahoma",62421,30927,31494,25787,40620,5952,2468,514,220,60342,4224,3781,8005,8241,3698,4543,28357,335,5.94,95.8,5.129683920475481,13.202287691642235,3202,96.6693901090979,45.4286217779273,0.49545825923967896
40049,"Garvin County, Oklahoma",27751,13765,13986,22433,18572,2015,674,117,69,27502,2129,2128,4257,4678,2080,2598,10643,55,7.69,94.1,3.098987423876617,16.85705019638932,860,99.10273503657525,38.35177110734748,0.4960181615076934
40051,"Grady County, Oklahoma",54351,27146,27205,27334,36548,5126,1338,239,189,53846,3555,3167,6722,6645,2760,3885,24183,193,8.09,95.8,3.249250243785763,12.2260859965778,1766,99.0708542621111,44.49412154330187,0.49945723169766887
40053,"Grant County, Oklahoma",4458,2265,2193,29002,3083,621,145,15,16,4375,185,169,354,420,157,263,1987,8,5.24,95.9,3.9479587258860476,9.421265141318978,176,98.13817855540601,44.571556751906684,0.5080753701211306
40055,"Greer County, Oklahoma",6018,3463,2555,20073,4290,457,131,18,8,4986,346,360,706,959,412,547,2096,19,6.95,97.4,2.608840146227983,15.935526753074111,157,82.85144566301096,34.82884679295447,0.5754403456297773
40057,"Harmon County, Oklahoma",2758,1344,1414,21620,1953,327,113,0,0,2655,292,149,441,426,156,270,1161,0,4.86,98,4.097171863669326,15.445975344452501,113,96.26540971718637,42.0957215373459,0.4873096446700508
40059,"Harper County, Oklahoma",3843,1948,1895,23536,2560,410,148,0,51,3824,336,245,581,505,287,218,1616,17,4.67,95.9,5.178246161852719,13.140775435857403,199,99.5055945875618,42.05048139474369,0.5068956544366381
40061,"Haskell County, Oklahoma",12746,6323,6423,20009,8663,858,230,13,14,12686,1349,1267,2616,2427,1090,1337,4565,35,7.96,92.4,2.0163188451278833,19.041267848736858,257,99.52926408284952,35.815157696532246,0.49607720069041267
40063,"Hughes County, Oklahoma",13519,7252,6267,18004,9414,754,326,41,49,11894,1226,1228,2454,2383,1187,1196,4207,56,7.38,93.1,3.077150676825209,17.62704342037133,416,87.97988016865153,31.119165618758785,0.53643020933501
40065,"Jackson County, Oklahoma",25574,12735,12839,22988,16280,2140,1034,110,150,24107,1506,1640,3146,4432,1809,2623,11361,84,5.8,97.5,5.059826386173458,17.330100883710017,1294,94.26370532572143,44.424024399781025,0.49796668491436613
40067,"Jefferson County, Oklahoma",6270,3158,3112,19130,4289,387,122,22,4,6126,631,586,1217,1274,543,731,2238,5,5.97,95.1,2.360446570972887,20.318979266347686,148,97.70334928229666,35.69377990430622,0.5036682615629984
40069,"Johnston County, Oklahoma",11039,5482,5557,21022,7395,729,381,89,27,10911,974,1120,2094,2147,859,1288,4030,27,6.71,93.4,4.502219403931515,19.44922547332186,497,98.8404746806776,36.50692997554126,0.49660295316604763
40071,"Kay County, Oklahoma",45173,22375,22798,24057,29785,4408,1076,292,203,44496,3440,3025,6465,7795,3446,4349,19002,204,6.53,94.5,3.47774112855024,17.255882938923694,1571,98.50131715847962,42.06495030217165,0.49531799969008034
40073,"Kingfisher County, Oklahoma",15510,7669,7841,31885,10122,1652,550,93,106,15350,953,925,1878,1357,675,682,6997,48,8.5,96.7,4.829142488716957,8.749194068343005,749,98.96840747904578,45.11283043197937,0.49445519019987105
40075,"Kiowa County, Oklahoma",9127,4493,4634,23076,6315,786,264,29,0,8933,685,672,1357,2110,943,1167,3858,33,7.15,96.3,3.2102552865125453,23.118220663964063,293,97.87443847923743,42.270187356195905,0.49227566560753805
40077,"Latimer County, Oklahoma",10621,5387,5234,24233,7150,741,339,36,50,10424,1093,986,2079,1932,789,1143,3751,23,8.41,91.6,4.0015064494868655,18.190377553902646,425,98.14518406929668,35.31682515770643,0.5072027116090764
40079,"Le Flore County, Oklahoma",49860,25028,24832,20264,33599,3145,1614,128,117,48731,4982,4660,9642,10791,4845,5946,18460,172,7.36,91.7,3.7284396309667067,21.642599277978338,1859,97.7356598475732,37.023666265543525,0.5019655034095467
40081,"Lincoln County, Oklahoma",34759,17278,17481,23911,23526,2371,771,114,100,34384,2527,2454,4981,4895,2243,2652,14176,187,10.19,95,2.8337984406916195,14.0826836215081,985,98.92114272562502,40.783681924105984,0.4970798929773584
40083,"Logan County, Oklahoma",45326,22593,22733,28265,29783,5671,2093,246,328,44956,2891,2919,5810,5775,2359,3416,20716,180,8.78,95.7,5.884040065304681,12.741031637470767,2667,99.18369147950403,45.70445219079557,0.49845563252879144
40085,"Love County, Oklahoma",9843,4850,4993,20965,6513,672,269,24,2,9758,691,548,1239,1184,570,614,3939,44,6.92,94.6,2.9970537437773035,12.028852991973991,295,99.13644214162349,40.01828710758915,0.4927359544854211
40087,"McClain County, Oklahoma",37919,18800,19119,28353,25078,4371,1212,299,161,37598,2359,2295,4654,3574,1676,1898,17413,85,7.82,95.5,4.409398982040666,9.425354044146733,1672,99.15345868825655,45.9215696616472,0.49579366544476383
40089,"McCurtain County, Oklahoma",33026,16268,16758,19040,21791,2063,704,122,62,32623,3386,3542,6928,7690,3382,4308,12148,115,8.72,91.6,2.688790649791074,23.284684793798824,888,98.7797492884394,36.783140555925634,0.49258160237388726
40091,"McIntosh County, Oklahoma",19874,9812,10062,22241,14439,1323,517,68,53,19577,1783,1701,3484,3617,1671,1946,6962,54,10.86,92.6,3.210224413806984,18.199657844419846,638,98.50558518667606,35.03069336821979,0.4937103753647982
40093,"Major County, Oklahoma",7730,3836,3894,28294,5246,673,192,8,5,7636,422,442,864,996,422,574,3302,7,5.65,96.5,2.652005174644243,12.884864165588615,205,98.78395860284606,42.716688227684344,0.496248382923674
40095,"Marshall County, Oklahoma",16226,8049,8177,22431,11159,1090,433,89,22,15974,1315,1343,2658,2344,988,1356,6264,64,8.05,94.2,3.3526439048440775,14.445950942931098,544,98.44693701466781,38.604708492542834,0.4960557130531246
40097,"Mayes County, Oklahoma",40929,20424,20505,22575,27701,2941,1129,95,97,40487,3401,3012,6413,7726,3632,4094,16893,80,10.2,91.5,3.2275403747953773,18.87659117007501,1321,98.92008111607906,41.273913362163746,0.49901048156563804
40099,"Murray County, Oklahoma",13797,6918,6879,24804,9544,1245,483,65,95,13411,1076,1157,2233,1889,772,1117,5956,15,7.88,92.7,4.660433427556716,13.69138218453287,643,97.20229035297528,43.16880481264043,0.5014133507284192
40101,"Muskogee County, Oklahoma",69471,33978,35493,21800,46106,6141,1931,362,268,66591,6256,6251,12507,14375,6127,8248,26326,360,12.3,92.5,3.686430309049819,20.692087345798967,2561,95.85438528306776,37.894948971513294,0.4890961696247355
40103,"Noble County, Oklahoma",11421,5599,5822,28054,7791,1361,410,54,36,11325,500,437,937,1316,579,737,5129,26,8.02,94.8,4.377900358987829,11.522633744855968,500,99.15944313107434,44.908501882497156,0.4902372821994571
40105,"Nowata County, Oklahoma",10448,5150,5298,21491,7205,582,195,19,36,10254,920,927,1847,1849,815,1034,4219,13,9.73,91.7,2.392802450229709,17.697166921898926,250,98.143185298621745,40.38093415007657,0.49291730474732004
40107,"Okfuskee County, Oklahoma",12160,6518,5642,17656,8249,667,253,40,36,11177,1251,1324,2575,2796,1397,1399,3810,77,8.93,93.6,2.705592105263158,22.99342105263158,329,91.91611842105263,31.332236842105264,0.5360197368421052
40109,"Oklahoma County, Oklahoma",774203,378842,395361,29127,502958,100887,38615,11605,5792,761515,61005,55205,116210,128566,55534,73032,362406,2025,7.98,95.6,7.23479500854427,16.60623893216637,56012,98.36115334091963,46.81020352543196,0.48933160940993514
40111,"Okmulgee County, Oklahoma",39121,19298,19823,21436,25862,2621,942,130,79,38447,3470,3125,6595,7332,3138,4194,14575,85,11.03,93.2,2.9421538304235577,18.741852202142073,1151,98.27714015490402,37.25620510723141,0.49329004882288285
40113,"Osage County, Oklahoma",47350,23748,23602,24195,32961,4170,1450,180,125,45964,3009,2964,5973,7203,3063,4140,19071,208,10.51,92.3,3.706441393875396,15.212249208025343,1755,97.07286166842661,40.276663146779306,0.5015417106652588
40115,"Ottawa County, Oklahoma",31725,15570,16155,19415,20627,1839,746,188,119,31274,2733,2537,5270,6685,3170,3515,12648,84,12.95,91.7,3.3191489361702127,21.07171000788022,1053,98.57840819542947,39.867612293144205,0.4907801418439716
40117,"Pawnee County, Oklahoma",16448,8214,8234,22965,11242,1188,400,114,63,16286,1336,1272,2608,2427,1110,1317,6454,81,10.75,92.9,3.508025291828794,14.755593385214008,577,99.01507782101167,39.23881322957198,0.4993920233463035
40119,"Payne County, Oklahoma",80634,41317,39317,22785,43342,8900,4111,821,2130,79490,5549,4417,9966,19108,9131,9977,35407,256,8.77,94.4,8.758092119949401,23.697199692437433,7062,98.58124364412035,43.910757248803236,0.5124017163975494
40121,"Pittsburg County, Oklahoma",44673,22664,22009,24408,31384,3309,1296,273,225,42801,3855,3656,7511,7287,3331,3956,17818,119,8.65,92.6,4.015848499093412,16.311866227922906,1794,95.80954939225035,39.88538938508719,0.5073310500749894
40123,"Pontotoc County, Oklahoma",38289,18680,19609,23862,24756,4337,2104,229,297,37829,3437,3077,6514,6351,2797,3554,16951,68,8.44,92.7,6.868813497349108,16.58700932382669,2630,98.79861056700358,44.271200605918146,0.48786857844289483
40125,"Pottawatomie County, Oklahoma",71614,34122,37492,22284,47015,5694,2050,462,274,69464,5483,5129,10612,11581,5171,6410,29151,682,7.13,95,3.890300779177256,16.17141899628564,2786,96.99779372748345,40.70572793029296,0.4764710810735331
40127,"Pushmataha County, Oklahoma",11132,5441,5691,22596,7855,735,376,63,20,11013,1112,967,2079,2233,1001,1232,4108,16,9.06,91.2,4.123248293208768,20.059288537549406,459,98.93100970176069,36.90262306863097,0.4887711103126123
40129,"Roger Mills County, Oklahoma",3734,1816,1918,27797,2447,368,124,11,5,3715,212,247,459,677,261,416,1685,2,6.19,96.9,3.7493304767005893,18.130690948044993,140,99.49116229244778,45.125870380289236,0.4863417246920193
40131,"Rogers County, Oklahoma",90098,44923,45175,29824,59989,10040,3051,605,421,89050,5312,4894,10206,8315,3442,4873,42719,492,10.29,92.1,4.525072698617062,9.228839707873648,4077,98.83682212701724,47.413927057204376,0.4986015227862994
40133,"Seminole County, Oklahoma",25246,12357,12889,19605,16523,1498,679,98,16,24787,2580,2462,5042,5548,2432,3116,9178,86,7.27,93.9,3.141091658084449,21.975758536005703,793,98.18189020042779,36.35427394438723,0.48946367741424385
40135,"Sequoyah County, Oklahoma",41364,20451,20913,19253,28253,2768,771,214,135,40984,4434,4044,8478,10048,4944,5104,15407,168,9.24,92.3,2.7076685040131516,24.291654578860847,1120,99.08132675756697,37.24736485833092,0.49441543371047286
40137,"Stephens County, Oklahoma",44293,21476,22817,25177,30383,3865,965,261,197,43669,3088,3079,6167,6561,2821,3740,18175,233,6.59,94.4,3.2126972659336688,14.812724358250739,1423,98.59119951233829,41.033571896236424,0.4848621678369043
40139,"Texas County, Oklahoma",21409,11444,9965,23324,13024,1891,585,132,95,21285,1862,1501,3363,3506,1582,1924,11253,85,3.7,93.8,3.7927974216451026,16.376290345181932,812,99.42080433462563,52.562006632724554,0.534541547947125
40141,"Tillman County, Oklahoma",7591,3881,3710,21422,5173,585,153,25,23,7237,598,517,1115,1600,718,882,3030,21,6.55,96.9,2.647872480569095,21.077591885127124,201,95.33658279541562,39.91568963245949,0.5112633381636148
40143,"Tulsa County, Oklahoma",637123,310812,326311,29797,416441,87487,28663,8545,4175,632310,48989,43874,92863,97358,42743,54615,304436,3590,10.95,93,6.495292117848516,15.280879830111298,41383,99.24457286897507,47.78292417633644,0.48783672854378196
40145,"Wagoner County, Oklahoma",76830,37961,38869,27337,51623,8482,2426,406,388,76551,4916,4507,9423,8151,3639,4512,35197,509,11.41,92.6,4.191071196147338,10.609137055837563,3220,99.63686060132761,45.81153195366393,0.4940908499284134
40147,"Washington County, Oklahoma",51867,25196,26671,28913,35422,6559,2243,221,531,51477,3743,3563,7306,7134,2928,4206,22425,134,10.37,92.5,5.774384483390209,13.754410318699751,2995,99.24807681184568,43.235583318873275,0.48578093971118436
40149,"Washita County, Oklahoma",11550,5729,5821,26409,7717,1200,387,43,32,11292,577,595,1172,1595,577,1018,4833,9,8.08,96.5,4,13.80952380952381,462,97.76623376623377,41.84415584415584,0.496017316017316
40151,"Woods County, Oklahoma",9132,4949,4183,28322,5767,1082,476,55,188,8512,606,379,985,1067,537,530,4599,36,5.29,95.7,7.87341217696014,11.68418747262374,719,93.21068769163381,50.36136662286465,0.541940429259746
40153,"Woodward County, Oklahoma",21140,11155,9985,27413,13813,1784,773,113,72,20142,1081,1137,2218,2348,916,1432,9219,79,5.53,95.1,4.531693472090823,11.106906338694419,958,95.279091769158,43.609271523178805,0.5276726584673604
41001,"Baker County, Oregon",15980,8156,7824,25820,11828,1740,691,144,102,15491,720,700,1420,2356,1146,1210,6247,84,3.75,88.2,5.863579474342929,14.74342928660826,937,96.93992490613266,39.09261576971214,0.5103879849812265
41003,"Benton County, Oregon",88249,44598,43651,30873,53410,15512,8324,1584,3309,87986,3118,2442,5560,17119,9383,7736,40959,197,17.68,87.8,14.976940248614715,19.398520096545003,13217,99.70197962583146,46.41299051547326,0.50536549989235
41005,"Clackamas County, Oregon",399962,196834,203128,37551,280125,63746,24826,6832,3645,398339,15093,12065,27158,35549,15941,19608,193657,1315,14.72,82,8.826588525909962,8.888094368965051,35303,99.59421145008776,48.41884979073012,0.49213175251648905
41007,"Clatsop County, Oregon",38021,18909,19112,28115,27397,4101,1946,340,312,37244,1992,1588,3580,4548,2045,2503,17130,185,18.9,76,6.833065937245206,11.961810578364588,2598,97.9563925199232,45.05404907814103,0.49733042266116095
41009,"Columbia County, Oregon",50207,25179,25028,28460,35566,4660,1630,208,134,49946,2235,1770,4005,6102,2774,3328,20615,114,12.86,83.4,3.927739159878105,12.15368374927799,1972,99.48015217001614,41.060011552174,0.5015037743740912
41011,"Coos County, Oregon",62921,30820,32101,26007,46700,5198,2434,614,447,62058,3299,2992,6291,11105,5049,6056,23810,216,17.81,78.8,5.554584320020343,17.64911555760398,3495,98.6284388360007,37.841102334673636,0.48982056864957646
41013,"Crook County, Oregon",21717,10627,11090,24239,16223,1926,678,173,121,21644,922,900,1822,3311,1539,1772,8364,72,2.54,87.7,4.4757563199336925,15.246120550720633,972,99.66385780724778,38.51360685177511,0.4893401482709398
41015,"Curry County, Oregon",22377,10898,11479,26925,17848,2664,907,346,269,22226,941,700,1641,3429,1637,1792,7555,98,24,82.3,6.801626670241766,15.323769942351522,1522,99.3251999821245,33.76234526522769,0.4870179201859052
41017,"Deschutes County, Oregon",175321,86629,88692,31575,125844,26914,11321,2622,1596,174746,10483,8279,18762,21102,10071,11031,81947,577,3.91,84.3,8.863170983510248,12.036207870135351,15539,99.67203016181746,46.74112057312016,0.494116506294169
41019,"Douglas County, Oregon",107576,53134,54442,25002,79050,8276,3769,902,452,106896,4388,4055,8443,18075,8019,10056,39708,355,11.91,85,4.762214620361419,16.802074812225776,5123,99.36788874841972,36.911578790808356,0.49392057708038967
41021,"Gilliam County, Oregon",1910,962,948,24178,1373,200,64,0,0,1906,115,91,206,188,93,95,739,6,1.88,90,3.350785340314136,9.842931937172775,64,99.79057591623037,38.69109947643979,0.5036649214659686
41023,"Grant County, Oregon",7209,3647,3562,25154,5515,634,372,95,32,7087,304,263,567,970,447,523,2961,10,3.26,86.3,6.9219031765848245,13.455402968511583,499,98.307670966847,41.07365792759051,0.5058954085171313
41025,"Harney County, Oregon",7195,3633,3562,24398,5191,622,302,23,48,7090,260,291,551,1239,590,649,2821,37,2.62,89.7,5.184155663655316,17.22029186935372,373,98.5406532314107,39.20778318276581,0.5049339819318972
41027,"Hood River County, Oregon",22938,11512,11426,29595,15415,2864,1284,314,200,22852,1499,1190,2689,2756,1123,1633,10997,170,11.82,80.7,7.838521231144825,12.014996948295405,1798,99.62507629261488,47.94227918737466,0.5018746185369256
41029,"Jackson County, Oregon",212070,103422,108648,27081,150788,25454,10182,2907,1829,210868,10690,9673,20363,35120,15511,19609,90161,605,8.58,87.4,7.034469750554062,16.560569623237612,14918,99.43320601688121,42.51473570047626,0.48767859668977226
41031,"Jefferson County, Oregon",22707,11605,11102,22957,15437,1787,644,98,83,21943,1637,1239,2876,4559,2097,2462,7809,50,2.98,88.1,3.6332408508389484,20.077509138151232,825,96.63539877570793,34.39027612630466,0.5110758796846787
41033,"Josephine County, Oregon",84514,41320,43194,24349,62130,6755,3207,727,249,83876,4345,3562,7907,15529,7454,8075,29688,406,17.75,87,4.949475826490286,18.374470501928673,4183,99.24509548713823,35.12790780225762,0.4889130794897887
41035,"Klamath County, Oregon",66018,32995,33023,23793,46067,5540,2321,537,327,65424,3513,3358,6871,12202,5450,6752,25781,211,5.82,84.6,4.824441818897876,18.482838013875003,3185,99.10024538762156,39.05147081099094,0.49978793662334514
41037,"Lake County, Oregon",7807,4165,3642,21005,5825,600,227,25,8,7274,425,339,764,1448,704,744,3006,35,3.27,87.2,3.330344562572051,18.54745741001665,260,93.1727936467273,38.50390675035225,0.5334955808889458
41039,"Lane County, Oregon",363471,179116,184355,27032,247148,43756,19662,4901,4795,361882,18438,14312,32750,66941,31624,35317,163115,1241,13.24,83,8.077123071716864,18.41715019905302,29358,99.56282619521227,44.87703283067975,0.4927930976611614
41041,"Lincoln County, Oregon",47307,22779,24528,25782,36212,5269,2388,604,461,46983,2806,2692,5498,8578,3913,4665,18471,137,22.99,79.4,7.299131206798148,18.13262307903693,3453,99.31511192846725,39.04496163358488,0.4815143636248335
41043,"Linn County, Oregon",121074,59757,61317,24448,83348,10874,3407,765,490,120409,5536,4513,10049,19278,8839,10439,50113,416,14.23,83.5,3.8505376876951285,15.922493681550126,4662,99.45074912863208,41.3903893486628,0.49355765895237624
41045,"Malheur County, Oregon",30421,16514,13907,17567,19716,1796,612,110,83,27073,1688,1658,3346,6761,2966,3795,10612,69,2.83,92.9,2.6461983498241346,22.224778935603695,805,88.99444462706683,34.88379737681207,0.5428486900496368
41047,"Marion County, Oregon",330453,164623,165830,24791,215512,32302,11605,3110,1745,323937,18103,13936,32039,51053,23573,27480,142995,1065,14.38,83.6,4.981041176808805,15.449398250280675,16460,98.02816134215759,43.27241695490736,0.49817371910680186
41049,"Morrow County, Oregon",11153,5724,5429,21743,7091,544,136,0,14,11143,671,681,1352,1635,757,878,4687,80,2.22,89.1,1.34492961535013,14.659732807316416,150,99.91033802564333,42.02456738097373,0.5132251412176096
41051,"Multnomah County, Oregon",788459,390542,397917,34848,568260,150503,67046,20200,10973,783195,40062,30000,70062,126836,59247,67589,407283,3205,13.44,84.6,12.457084008172904,16.086568864075367,98219,99.33236858225983,51.65557118379015,0.49532315567455
41053,"Polk County, Oregon",79666,38699,40967,25928,50916,9213,4850,896,643,79298,3659,2810,6469,11949,5517,6432,34152,196,17.06,86.6,8.019732382697763,14.998870283433334,6389,99.53807144829663,42.868977983079354,0.4857655712600105
41055,"Sherman County, Oregon",1635,864,771,34226,1305,152,66,4,8,1634,175,119,294,223,113,110,716,6,2.39,91.2,4.770642201834862,13.63914373088685,78,99.93883792048929,43.79204892966361,0.5284403669724771
41057,"Tillamook County, Oregon",25840,13059,12781,25458,19174,2397,1136,267,178,25201,1247,1092,2339,3894,1753,2141,9872,105,21.34,76.3,6.118421052631579,15.069659442724458,1581,97.52708978328174,38.204334365325074,0.5053792569659443
41059,"Umatilla County, Oregon",76736,40006,36730,22153,49897,4871,2459,359,260,72331,3938,3789,7727,12817,5237,7580,31251,189,3.67,88,4.011155129274395,16.702721017514595,3078,94.25953919933278,40.72534403669725,0.5213459132610508
41061,"Union County, Oregon",25810,12738,13072,26586,17161,2789,863,310,160,25572,1341,1052,2393,4365,1785,2580,10954,34,4.99,84.2,5.164664858581945,16.91204959318094,1333,99.07787679194111,42.44091437427354,0.4935296396745448
41063,"Wallowa County, Oregon",6864,3297,3567,26898,5390,869,333,124,62,6763,277,134,411,927,437,490,2967,27,5.02,84.3,7.561188811188811,13.505244755244755,519,98.52855477855478,43.22552447552447,0.4803321678321678
41065,"Wasco County, Oregon",25687,12804,12883,24727,17862,2330,908,183,110,25272,1193,1176,2369,3449,1524,1925,10937,28,3.32,88.2,4.675516798380504,13.427025343558999,1201,98.38439677657959,42.57795772180481,0.498462257172889
41067,"Washington County, Oregon",572071,282381,289690,35369,387890,103494,42910,8454,9668,568631,25566,20252,45818,58214,26784,31430,287379,1675,14.12,84,10.66860581990697,10.176009621183384,61032,99.39867603846376,50.234848471605794,0.4936118069260634
41069,"Wheeler County, Oregon",1415,686,729,21268,1110,123,27,10,15,1412,47,54,101,287,132,155,483,7,2.28,86.9,3.674911660777385,20.28268551236749,52,99.78798586572438,34.13427561837456,0.48480565371024736
41071,"Yamhill County, Oregon",102366,51188,51178,28540,68229,11017,4483,889,910,100149,4588,3155,7743,13334,5650,7684,45285,203,15.96,85.2,6.13680323544927,13.025809350760994,6282,97.83424183811032,44.238321317624994,0.5000488443428482
42001,"Adams County, Pennsylvania",101589,50055,51534,29685,70861,9072,5098,791,716,100343,3433,3226,6659,8548,3766,4782,49517,168,7.01,85.6,6.501688174900826,8.414296823474983,6605,98.7734892557265,48.74248196162971,0.49272066857632224
42003,"Allegheny County, Pennsylvania",1229605,593177,636428,35280,882896,207014,100056,26304,19568,1215219,36558,26259,62817,149568,64487,85081,610735,4546,6.81,82.7,11.867876269208404,12.163906295111031,145928,98.83003078224307,49.66920271143985,0.4824126447111064
42005,"Armstrong County, Pennsylvania",66737,33176,33561,25502,48920,5002,1895,301,247,66207,2053,1863,3916,8577,3813,4764,29235,273,7.36,82.1,3.66063802688164,12.851941202031856,2443,99.20583784107767,43.80628436998966,0.4971155431020274
42007,"Beaver County, Pennsylvania",168161,81606,86555,29162,121982,20085,7066,1413,742,166757,4863,3601,8464,17867,8007,9860,80263,556,5.32,82.8,5.483435517153205,10.624936816503231,9221,99.16508584035537,47.72985412788935,0.4852849352703659
42009,"Bedford County, Pennsylvania",48891,24404,24487,24219,35495,2839,1536,327,194,48407,2050,1715,3765,6585,2935,3650,21586,229,7.01,83.3,4.207318320345258,13.468736577284163,2057,99.01004274815406,44.15127528583993,0.4991511730175288
42011,"Berks County, Pennsylvania",415500,204283,211217,29041,279980,43700,17930,3222,2099,410592,17069,14071,31140,54762,24410,30352,197240,2038,7.49,84.8,5.5959085439229845,13.179783393501806,23251,98.81877256317689,47.470517448856796,0.4916558363417569
42013,"Blair County, Pennsylvania",124736,61106,63630,25531,88352,12370,4261,755,569,123288,4475,3198,7673,18479,8059,10420,55583,473,6.74,81.6,4.477456387891226,14.81448819907645,5585,98.83914828116983,44.56051180092355,0.4898826321190354
42015,"Bradford County, Pennsylvania",61546,30348,31198,26937,43396,5197,1989,419,215,60936,2789,1978,4767,7430,3322,4108,26100,132,6.07,79.6,4.261852923016931,12.07227114678452,2623,99.00887141325188,42.40730510512462,0.4930945959120008
42017,"Bucks County, Pennsylvania",626486,307319,319167,41924,443646,104639,51854,10272,7985,620739,16798,12749,29547,37912,15469,22443,320937,1665,5.89,85.3,11.191151917201662,6.051531877807325,70111,99.08266106505174,51.228120021836084,0.4905440823897102
42019,"Butler County, Pennsylvania",185984,91847,94137,35101,130903,29117,12855,1769,1585,183979,4368,3553,7921,15194,6636,8558,91282,441,6.35,81.8,8.715265829318652,8.169519958706125,16209,98.9219502752925,49.08056607019959,0.49384355643496214
42021,"Cambria County, Pennsylvania",135871,66777,69094,24838,96941,12538,5437,1522,804,132115,4328,3015,7343,20115,8853,11262,55963,415,7.18,79.4,5.713507665359054,14.804483664652501,7763,97.2356131919247,41.18833305120298,0.49147353003952277
42023,"Cameron County, Pennsylvania",4754,2419,2335,24933,3588,391,121,42,18,4715,159,68,227,674,288,386,2072,9,6.2,79.1,3.8073201514514095,14.17753470761464,181,99.17963819941102,43.584350021034915,0.5088346655448044
42025,"Carbon County, Pennsylvania",63987,31716,32271,25680,46941,4826,2086,369,248,63160,2301,1782,4083,8053,3734,4319,28624,136,7.6,80,4.224295560035633,12.585368903058434,2703,98.70754997108787,44.73408661134293,0.4956631815837592
42027,"Centre County, Pennsylvania",160646,84313,76333,28545,96043,22186,12116,1551,6123,156272,5536,3683,9219,26291,13679,12612,75073,699,7.18,80.4,12.319011989094033,16.365798090210774,19790,97.27724313085916,46.7319447729791,0.5248372197253589
42029,"Chester County, Pennsylvania",514652,253509,261143,46256,347586,105643,51687,10512,9422,509840,18691,14311,33002,34446,15150,19296,262958,1628,6.08,85.5,13.91639399050232,6.693066382720751,71621,99.06499926163698,51.09433170375321,0.4925833378671413
42031,"Clarion County, Pennsylvania",38747,18932,19815,23595,26281,3488,1657,308,283,38353,1790,1406,3196,6553,2938,3615,16883,145,7.11,81.4,5.801739489508865,16.912277079515835,2248,98.98314708235476,43.57240560559527,0.48860556946344236
42033,"Clearfield County, Pennsylvania",80539,41950,38589,22568,59080,5836,1820,372,323,75111,3234,2500,5734,11463,4994,6469,32856,295,7.37,79.9,3.122710736413415,14.232856131811918,2515,93.26040800109264,40.795142725884354,0.5208656675647823
42035,"Clinton County, Pennsylvania",39321,19293,20028,22794,25238,2852,1294,187,202,38733,2029,1655,3684,6431,2799,3632,17277,262,6.95,80.8,4.280155642023346,16.355128302942447,1683,98.50461585412376,43.93835355153735,0.4906538490882734
42037,"Columbia County, Pennsylvania",66615,32085,34530,24908,43966,5961,2592,399,566,65871,1868,1708,3576,9821,4451,5370,29717,116,8.34,81.6,5.3396382196202055,14.742925767469789,3557,98.88313442918262,44.61007280642498,0.4816482774149966
42039,"Crawford County, Pennsylvania",86847,42498,44349,24716,60171,7531,3450,637,669,85418,4684,4370,9054,12032,5522,6510,37470,301,5.83,80.2,5.476297396570981,13.8542494271535,4756,98.3545775904752,43.14484092714774,0.48934332792151713
42041,"Cumberland County, Pennsylvania",245801,121449,124352,34246,171176,36349,17164,3602,2333,239154,8262,6396,14658,18112,7728,10384,121827,531,6.05,85.3,9.397439392028511,7.368562373627446,23099,97.2957799195284,49.56326459208872,0.494094816538582
42043,"Dauphin County, Pennsylvania",273329,132330,140999,31152,188832,34904,14373,4863,2188,270039,10435,8718,19153,35516,15853,19663,133024,1215,7.23,83.8,7.8381730442067985,12.993864536876805,21424,98.79632238072067,48.668088640429666,0.4841418217605889
42045,"Delaware County, Pennsylvania",563384,270775,292609,36747,380274,82534,41912,10838,7977,555828,18426,15892,34318,56639,24417,32222,268246,1432,6.08,86.8,10.778971358789033,10.053356147849424,60727,98.65881885179557,47.61335075188504,0.48062245289181094
42047,"Elk County, Pennsylvania",30781,15435,15346,27163,22527,2833,1086,170,88,30450,855,348,1203,2846,1253,1593,14878,21,6.47,79.3,4.366329878821351,9.245963418992236,1344,98.92466131704623,48.33501185796433,0.5014456970208895
42049,"Erie County, Pennsylvania",277794,137134,140660,26361,188102,33980,13513,2408,1731,272099,9867,7353,17220,44492,19590,24902,124998,576,6.26,79.1,6.354348906023888,16.016184654816158,17652,97.94991972468807,44.996652195511786,0.49365357063147514
42051,"Fayette County, Pennsylvania",133160,65640,67520,24247,97009,10311,3483,649,519,129734,4949,3595,8544,24348,10549,13799,53049,325,8.82,81.1,3.492790627816161,18.28477020126164,4651,97.42715530189245,39.838540102132775,0.492940823069991
42053,"Forest County, Pennsylvania",7388,5972,1416,14989,6072,272,129,1,25,2901,83,38,121,404,200,204,718,11,6.85,80.6,2.097996751488901,5.468327016783974,155,39.266377910124525,9.718462371413102,0.8083378451543043
42055,"Franklin County, Pennsylvania",153003,75535,77468,28985,106187,13003,6745,1303,838,151587,8885,6937,15822,15643,7059,8584,71002,369,7.08,84.8,5.807729260210584,10.223982536290139,8886,99.07452795043234,46.405626033476466,0.49368313039613604
42057,"Fulton County, Pennsylvania",14631,7376,7255,25273,10462,823,476,50,59,14594,636,470,1106,1665,763,902,6504,31,7.54,84.4,3.9983596473241745,11.379946688538036,585,99.74711229581027,44.45355751486569,0.5041350557036429
42059,"Greene County, Pennsylvania",37338,19397,17941,25574,26529,3051,1326,141,254,34890,1175,1040,2215,5012,2161,2851,14313,161,9.6,82.3,4.609245272912315,13.423322084739407,1721,93.44367668327173,38.333601156998235,0.5194975628046494
42061,"Huntingdon County, Pennsylvania",45686,24129,21557,22908,32575,3395,1196,132,245,41754,1580,1225,2805,5517,2348,3169,18110,177,6.35,82.9,3.4430678982620497,12.075909468983934,1573,91.3934246815217,39.640152344263015,0.5281486669876987
42063,"Indiana County, Pennsylvania",86551,43449,43102,25014,55950,7622,3533,467,1102,85107,4511,3858,8369,13362,6390,6972,37243,434,7.44,81.2,5.894790354819702,15.438296495707734,5102,98.33161950757356,43.03012096913958,0.5020045984448476
42065,"Jefferson County, Pennsylvania",44258,21963,22295,23895,31358,3341,1228,255,145,43723,1945,1829,3774,6157,2637,3520,19494,178,6.91,79.9,3.678431018121018,13.911609200596502,1628,98.79117899588775,44.046274119933116,0.49624926566948346
42067,"Juniata County, Pennsylvania",24448,12210,12238,24068,17088,1497,767,72,59,24203,1689,1293,2982,3155,1455,1700,11096,52,6.58,83.8,3.673102094240838,12.90494109947644,898,98.99787303664921,45.38612565445026,0.4994273560209424
42069,"Lackawanna County, Pennsylvania",211960,102652,109308,27258,149213,25419,10891,2341,1625,208088,6987,4698,11685,31419,13317,18102,95459,481,6.51,79.6,7.009341385167013,14.823079826382337,14857,98.17324023400641,45.03632760898283,0.4842989243253444
42071,"Lancaster County, Pennsylvania",536494,262686,273808,29280,357748,60405,25951,4901,3445,530084,32482,31229,63711,54244,24160,30084,262905,2158,6.42,84.8,6.392802156221691,10.110830689625606,34297,98.80520565001659,49.00427590988902,0.48963455322892707
42073,"Lawrence County, Pennsylvania",88231,42663,45568,26918,62962,8535,3327,758,450,87203,2578,2453,5031,12051,5124,6927,38460,287,6.19,83.3,5.139916809284719,13.658464711949314,4535,98.83487663066269,43.590121385907445,0.4835375321598985
42075,"Lebanon County, Pennsylvania",137616,67390,70226,27916,94169,11992,5473,1105,612,135907,7624,6342,13966,14084,6344,7740,64767,204,8.69,83.8,5.22468317637484,10.234275084292523,7190,98.75813858853621,47.063568189745375,0.489695965585397
42077,"Lehigh County, Pennsylvania",360774,176067,184707,30988,245179,43443,20550,4083,3296,355811,15896,12288,28184,46596,20116,26480,171147,995,7.53,85.1,7.741411520785866,12.915564868865273,27929,98.62434654381968,47.438839827703774,0.48802574464900467
42079,"Luzerne County, Pennsylvania",318222,156922,161300,26809,226690,32366,14547,2916,1866,310400,11589,8774,20363,46537,20645,25892,145813,668,7.01,79.8,6.074061504232894,14.624067474907454,19329,97.54196755723991,45.82115629969015,0.493121154414214
42081,"Lycoming County, Pennsylvania",115398,56644,58754,26265,80444,11549,4591,1046,554,112226,4149,3189,7338,15375,6856,8519,52999,439,7.19,81.4,5.364911003656909,13.323454479280404,6191,97.25125218807952,45.92713911852892,0.4908577271703149
42083,"McKean County, Pennsylvania",42070,21802,20268,24868,29718,3277,1491,226,181,40024,1354,1115,2469,6738,3025,3713,18080,135,6.12,78.7,4.51152840503922,16.016163536962207,1898,95.13667696695983,42.97599239362967,0.5182315188970763
42085,"Mercer County, Pennsylvania",113623,55992,57631,25499,79399,11097,4824,913,864,109671,4592,3519,8111,14521,6263,8258,48926,373,6.1,81.5,5.809563204632865,12.779982925992096,6601,96.52183096732176,43.05994384939669,0.49278755181609357
42087,"Mifflin County, Pennsylvania",46452,22748,23704,23568,32506,2744,927,180,115,45853,3103,2662,5765,6133,2671,3462,20487,334,7.08,82.9,2.6306725221734264,13.202876087143718,1222,98.71049685697064,44.10359080340997,0.48970980797382246
42089,"Monroe County, Pennsylvania",167306,82610,84696,27439,114267,17826,7609,1031,945,166303,7915,6434,14349,18309,8670,9639,76460,515,6.27,79,5.729023465984484,10.943421036902443,9585,99.40049968321519,45.70069214493204,0.49376591395407216
42091,"Montgomery County, Pennsylvania",818677,397990,420687,45048,573128,154681,83838,22492,15502,804641,19439,16509,35948,50942,22194,28748,419127,1998,5.89,86.8,14.881571120234232,6.2224784622018205,121832,98.28552652633456,51.195648589126115,0.4861380007011312
42093,"Montour County, Pennsylvania",18302,8858,9444,31818,13425,2263,1087,512,237,17682,535,549,1084,1851,750,1101,8545,73,8.85,83,10.031690525625615,10.113648781553929,1836,96.61239208829636,46.68888646049612,0.48399082067533605
42095,"Northampton County, Pennsylvania",300941,147829,153112,32608,209237,38279,16335,3101,2546,298131,11221,7866,19087,26583,12094,14489,145381,1876,6.93,83.7,7.304421796963524,8.833292904589271,21982,99.06626215769869,48.30880471587454,0.49122253199132054
42097,"Northumberland County, Pennsylvania",93038,46851,46187,24278,67574,6702,2875,534,267,89131,3607,2724,6331,12762,6009,6753,40748,377,9.57,82.6,3.9510737548098627,13.716975859326297,3676,95.80064059846514,43.797158150433155,0.5035684344031471
42099,"Perry County, Pennsylvania",45878,23135,22743,28900,32359,3666,1363,246,95,45351,2337,1937,4274,3791,1720,2071,22743,117,6.23,83.9,3.7141985265268755,8.263219843933912,1704,98.85130127730066,49.57277998169057,0.5042722001830943
42101,"Philadelphia County, Pennsylvania",1569657,742412,827245,24811,1051996,166567,78460,24746,15063,1555692,93129,71704,164833,393924,175972,217952,649574,6437,6,87.2,7.534703441579912,25.09618343370558,118269,99.11031518350825,41.38318116633124,0.4729772173156301
42103,"Pike County, Pennsylvania",55687,27956,27731,31156,40380,6575,3230,622,284,55290,2087,1487,3574,5452,2447,3005,24252,136,6.34,79.7,7.427227180490958,9.79043582882899,4136,99.28708675274301,43.55055937651517,0.5020202201591035
42105,"Potter County, Pennsylvania",17070,8604,8466,23213,12212,1125,575,115,22,16832,870,701,1571,2415,1017,1398,6628,77,5.76,78.1,4.171060339777387,14.14762741652021,712,98.60574106619801,38.82835383714119,0.5040421792618629
42107,"Schuylkill County, Pennsylvania",144287,73691,70596,25224,105438,10914,4566,862,507,137432,5115,4242,9357,17134,7539,9595,61756,340,8.14,81.3,4.113329683200843,11.874943688620597,5935,95.2490522361682,42.80080672548463,0.5107251519540915
42109,"Snyder County, Pennsylvania",40570,20076,20494,24961,26871,3022,1119,308,257,40254,2710,2586,5296,4310,1835,2475,19516,144,9.65,83.1,4.150850382055706,10.62361350751787,1684,99.22109933448361,48.10451072220853,0.49484841015528713
42111,"Somerset County, Pennsylvania",75619,39289,36330,23877,56253,5819,2277,473,271,70780,2880,2498,5378,8935,3632,5303,32256,315,8.39,79.1,3.995027704677396,11.815813486028643,3021,93.60081461008477,42.65594625689311,0.5195651886430659
42113,"Sullivan County, Pennsylvania",6192,3234,2958,26720,4901,497,236,36,42,5995,381,174,555,783,422,361,2547,3,6.73,77.2,5.071059431524548,12.645348837209303,314,96.81847545219638,41.133720930232556,0.5222868217054264
42115,"Susquehanna County, Pennsylvania",41716,20988,20728,27823,30675,3363,1526,221,264,41421,2127,1516,3643,5350,2440,2910,18157,63,7.29,79.3,4.820692300316425,12.824815418544443,2011,99.2928372806597,43.52526608495541,0.5031163102886183
42117,"Tioga County, Pennsylvania",41550,20599,20951,25353,29294,3563,1872,304,170,41133,1973,1609,3582,5461,2287,3174,17942,121,6.32,79,5.646209386281589,13.143200962695548,2346,98.99638989169675,43.18170878459687,0.4957641395908544
42119,"Union County, Pennsylvania",45056,24776,20280,25089,30664,3907,1981,582,813,39522,2532,1570,4102,3639,1469,2170,17980,215,8.81,82.5,7.4928977272727275,8.076615767045455,3376,87.71750710227273,39.90589488636363,0.5498934659090909
42121,"Venango County, Pennsylvania",52880,26094,26786,25190,38339,4359,1868,258,103,52137,2087,1724,3811,7032,3222,3810,22552,88,7.49,81.5,4.215204236006051,13.29803328290469,2229,98.59493192133132,42.64750378214826,0.4934568835098336
42123,"Warren County, Pennsylvania",40345,20152,20193,26558,29457,3756,1356,292,152,39658,1468,1161,2629,5281,2347,2934,17828,195,6.19,79.3,4.46151939521626,13.08960218118726,1800,98.29718676415912,44.18887098773082,0.4994918825133226
42125,"Washington County, Pennsylvania",207661,101746,105915,32828,148476,28447,11212,2000,1447,205980,5829,4539,10368,19629,8815,10814,96911,428,7,82.2,7.059101131170514,9.452424865526025,14659,99.19050760614655,46.66788660364729,0.4899620053837745
42127,"Wayne County, Pennsylvania",51656,27404,24252,25569,39052,4717,2528,409,307,48066,1891,1297,3188,5323,2359,2964,20646,171,6.39,79.8,6.280006194827319,10.304708068762583,3244,93.05017810128543,39.96825150998916,0.5305095245470033
42129,"Westmoreland County, Pennsylvania",356835,174211,182624,31827,261570,46745,20039,3503,2908,353333,8820,6878,15698,36111,15865,20246,169827,694,7.03,81.6,7.412389479731528,10.119803270419101,26450,99.01859402805218,47.59258480810458,0.4882116384323287
42131,"Wyoming County, Pennsylvania",27760,13958,13802,28046,19657,2431,1062,142,69,27511,896,830,1726,2810,1087,1723,12832,36,6.58,80.3,4.585734870317003,10.122478386167147,1273,99.10302593659942,46.22478386167147,0.5028097982708933
42133,"York County, Pennsylvania",442216,218524,223692,30178,306293,47480,19201,4061,1806,437185,16110,12441,28551,44343,19051,25292,217475,1080,6.3,85.1,5.668722977006712,10.027452647574941,25068,98.8623206758688,49.17845577726722,0.4941567017023355
44001,"Bristol County, Rhode Island",49028,23625,25403,42360,34043,8420,4841,1705,956,48386,1075,977,2052,3203,1297,1906,24316,147,6.83,80.4,15.301460389981235,6.533001550134617,7502,98.69054417883659,49.59614913926736,0.4818675042832667
44003,"Kent County, Rhode Island",164012,79338,84674,37157,120189,24534,10471,2110,1482,162788,4570,3090,7660,12687,5183,7504,85273,273,7.23,80.2,8.574372606882424,7.735409604175304,14063,99.25371314294075,51.99192741994488,0.48373289759285903
44005,"Newport County, Rhode Island",83204,40952,42252,43603,60267,16852,7970,1698,1503,79839,2610,2055,4665,7178,2808,4370,43171,387,6.84,79.7,13.42603720974953,8.626989087063121,11171,95.95572328253449,51.885726647757316,0.49218787558290467
44007,"Providence County, Rhode Island",633704,307512,326192,29025,429318,72891,32274,7580,6650,624252,29682,20673,50355,101489,45261,56228,298178,2985,7.73,80.3,7.338441922411725,16.015205837425675,46504,98.5084518955222,47.053198338656536,0.485261257621855
44009,"Washington County, Rhode Island",126190,61154,65036,39568,85444,21818,11762,2378,2501,125258,3054,1995,5049,11569,5188,6381,62950,234,7.59,79.8,13.187257310404945,9.167921388382597,16641,99.26143117521198,49.88509390601474,0.4846184325223869
45001,"Abbeville County, South Carolina",24788,12044,12744,19234,17110,1708,587,120,102,24567,1404,1575,2979,5474,2706,2768,9245,99,6.03,90.9,3.2636759722446347,22.083266096498306,809,99.10843956753267,37.29627238986606,0.48588026464418266
45003,"Aiken County, South Carolina",165707,80260,85447,26222,115170,18831,8073,1432,1435,163863,9884,9069,18953,27183,12016,15167,69348,274,8.81,92.1,6.602014398908918,16.404255704345623,10940,98.887192454151,41.849770981310385,0.48434888085596867
45005,"Allendale County, South Carolina",9402,4952,4450,13439,6676,457,157,0,15,8262,608,593,1201,2508,1127,1381,2623,26,6.39,91.8,1.8293980004254413,26.675175494575623,172,87.87492022973835,27.898319506487983,0.526696447564348
45007,"Anderson County, South Carolina",194174,93474,100700,24485,132734,17584,7531,1168,1271,192782,11082,10934,22016,29776,12783,16993,83648,758,6.92,90.5,5.1345700248230965,15.33469980532924,9970,99.2831172041571,43.07888800766323,0.481392977432612
45009,"Bamberg County, South Carolina",14842,7218,7624,19256,9902,1245,556,49,41,14692,1069,1282,2351,3406,1829,1577,5418,47,5.49,92.1,4.3525131383910525,22.948389704891525,646,98.98935453442932,36.50451421641288,0.4863225980326102
45011,"Barnwell County, South Carolina",21788,10369,11419,20018,14386,1187,423,40,31,21485,1629,1544,3173,5766,2509,3257,7754,89,7.2,92.5,2.2673031026252985,26.46410868367909,494,98.60932623462456,35.58839728290802,0.47590416743161373
45013,"Beaufort County, South Carolina",179316,88524,90792,34966,126904,29771,14603,3873,2313,171558,12362,10096,22458,20786,9109,11677,78413,1372,7.73,90.1,11.593499743469629,11.591826719311161,20789,95.67355952619955,43.728947779339265,0.49367596868098773
45015,"Berkeley County, South Carolina",204632,101773,102859,27010,134623,20946,8296,1288,874,199002,12464,11661,24125,25648,11195,14453,95947,694,7.7,91.9,5.110637632432855,12.533719066421675,10458,97.24871965284022,46.887583564642874,0.49734645607725086
45017,"Calhoun County, South Carolina",14808,7071,7737,24766,10738,1260,490,164,45,14693,785,1001,1786,2659,1267,1392,6198,72,6.66,91.5,4.720421393841167,17.956509994597514,699,99.22339276066991,41.85575364667747,0.4775121555915721
45019,"Charleston County, South Carolina",387847,187854,199993,35587,272967,72787,27045,9206,5297,380893,25079,21672,46751,57569,25019,32550,195293,1684,9.79,90.4,10.712471670529874,14.843224261113274,41548,98.20702493509039,50.353103156657134,0.48435078781065727
45021,"Cherokee County, South Carolina",56549,27527,29022,20516,37714,3656,1516,312,188,56233,3399,3665,7064,12292,5291,7001,21287,76,5.29,91,3.5650497798369556,21.736900740950325,2016,99.4411925940335,37.643459654458965,0.48678137544430494
45023,"Chester County, South Carolina",32424,15850,16574,20518,22373,2266,721,58,152,32248,2197,1662,3859,7019,3270,3749,12532,140,6.48,91.1,2.8713298791019,21.647545028374044,931,99.45719220330619,38.65038243276585,0.4888354305452751
45025,"Chesterfield County, South Carolina",46127,22685,23442,19768,31679,2329,822,241,173,45699,3420,2617,6037,10844,5221,5623,18790,551,5.94,91.4,2.679558609924773,23.50900773950181,1236,99.07212695384482,40.73536106835476,0.4917943937390249
45027,"Clarendon County, South Carolina",34156,16822,17334,20616,23956,2357,991,115,109,32608,2155,1870,4025,7551,3153,4398,11489,125,8.41,91.4,3.557208103993442,22.10738962407776,1215,95.46785337861576,33.63684272163017,0.4925049771636023
45029,"Colleton County, South Carolina",37581,18265,19316,21059,26057,2701,1015,215,70,36858,2592,2153,4745,8200,3607,4593,15410,267,7.79,90.9,3.459194805885953,21.81953646789601,1300,98.07615550411111,41.0047630451558,0.48601687022697637
45031,"Darlington County, South Carolina",67572,31915,35657,21225,46063,5290,2054,244,623,66826,4407,4245,8652,14997,6102,8895,26285,38,5.97,91.7,4.322796424554549,22.19410406677322,2921,98.89599242289705,38.89924820931747,0.4723110163973243
45033,"Dillon County, South Carolina",31073,14568,16505,15638,20367,1574,547,93,60,30739,3106,2047,5153,9381,4215,5166,11122,46,5.43,91.2,2.2527596305474207,30.190197277379074,700,98.92511183342452,35.79313230135487,0.4688314613973546
45035,"Dorchester County, South Carolina",151716,73919,77797,27317,100767,17690,8070,1105,763,148945,8530,7415,15945,17600,7014,10586,70325,604,7.4,91.8,6.550396794009861,11.600622215191542,9938,98.17356112736955,46.35305439109916,0.4872195417754225
45037,"Edgefield County, South Carolina",26620,14332,12288,23804,19340,2372,971,184,241,23993,1431,973,2404,3715,1464,2251,10244,73,8.4,91.7,5.244177310293013,13.955672426746807,1396,90.13148009015778,38.482344102178814,0.5383921863260707
45039,"Fairfield County, South Carolina",22868,10782,12086,21972,16425,2103,522,143,127,22565,1788,1414,3202,4808,2102,2706,8570,0,5.72,91.7,3.463354906419451,21.025013118768584,792,98.67500437292286,37.475948924260976,0.4714885429421025
45041,"Florence County, South Carolina",138537,64593,73944,23797,92623,13549,5667,814,837,136996,7451,7025,14476,26444,10859,15585,58671,414,7.18,91.6,5.282343345099143,19.088041461847737,7318,98.88766177988552,42.35041902163321,0.4662508932631716
45043,"Georgetown County, South Carolina",61065,28957,32108,28748,44790,7486,3490,702,465,60500,4551,4095,8646,11268,4568,6700,23609,279,9.41,89.8,7.626299844428068,18.452468680913782,4657,99.07475640710719,38.662081388684186,0.4741996233521657
45045,"Greenville County, South Carolina",490332,238009,252323,29132,330804,70027,29413,6290,4520,485740,31935,27441,59376,64347,27251,37096,230140,1616,7.78,89.1,8.203217411876034,13.123149213186167,40223,99.06349167502835,46.935545711885005,0.48540376724341877
45047,"Greenwood County, South Carolina",69981,32489,37492,22636,47073,7105,2884,504,478,68853,5412,4784,10196,16297,6578,9719,28816,153,6.19,91.2,5.52435661108015,23.287749532015834,3866,98.38813392206455,41.176890870379104,0.46425458338691933
45049,"Hampton County, South Carolina",20066,10350,9716,17676,13920,1069,514,32,10,18619,1023,965,1988,3407,1429,1978,7437,91,8.09,90.5,2.7708561746237415,16.978969400976776,556,92.788796969999,37.062693112728,0.5157978670387721
45051,"Horry County, South Carolina",310186,150251,159935,25804,226485,34246,13462,2601,1724,308646,26329,21812,48141,51863,23119,28744,135714,1142,10.21,90.2,5.734301354671068,16.719968019188485,17787,99.50352369223627,43.752458202497856,0.48439001115459757
45053,"Jasper County, South Carolina",27465,14058,13407,20067,19161,1894,711,115,120,26917,3121,1863,4984,6084,2933,3151,11952,74,7.84,90.7,3.4443837611505552,22.15182960131076,946,98.00473329692336,43.51720371381759,0.5118514472965593
45055,"Kershaw County, South Carolina",63734,30877,32857,23530,43847,5489,2927,296,249,63314,4060,3453,7513,10366,4716,5650,26596,215,6.26,91.5,5.447641761069445,16.26447422098095,3472,99.34101107728999,41.72968901998933,0.48446668967897827
45057,"Lancaster County, South Carolina",86544,42328,44216,26425,61355,10066,4422,533,357,84630,5695,3925,9620,13096,5817,7279,35542,321,6.2,90.8,6.1379182843409135,15.132187095581438,5312,97.78840820854133,41.06812719541505,0.48909225365132186
45059,"Laurens County, South Carolina",66508,32342,34166,20748,45268,4320,1912,225,161,65244,4457,3609,8066,13280,6101,7179,27499,179,5.77,91.2,3.4552234317676067,19.967522704035606,2298,98.09947675467613,41.346905635412284,0.48628736392614424
45061,"Lee County, South Carolina",17897,9246,8651,16972,12389,979,368,81,12,16310,1023,887,1910,4310,1917,2393,5954,122,5.85,91.7,2.575850701234844,24.08224842152316,461,91.13259205453429,33.268145499245684,0.5166228976923507
45063,"Lexington County, South Carolina",281870,137467,144403,29311,192759,37529,15619,2724,2180,278820,16460,14038,30498,35665,15512,20153,134607,2630,6.74,92.2,7.281016071238514,12.652996062014404,20523,98.9179408947387,47.754993436690675,0.48769645581296345
45065,"McCormick County, South Carolina",9694,5440,4254,22836,7963,1073,360,42,64,8445,458,296,754,1696,775,921,2624,24,6.55,91.3,4.807097173509387,17.49535795337322,466,87.11574169589437,27.06828966370951,0.5611718588817826
45067,"Marion County, South Carolina",31765,14675,17090,18556,21698,2431,963,62,113,31641,2310,2114,4424,8306,3888,4418,11514,43,6.76,90.9,3.582559420746104,26.148276404848104,1138,99.60963324413663,36.24744215331339,0.4619864630883047
45069,"Marlboro County, South Carolina",27505,14565,12940,16561,19603,1137,565,23,15,24436,1541,1461,3002,6482,2521,3961,9499,28,5.55,91.8,2.1923286675149973,23.56662425013634,603,88.84202872205054,34.53553899291038,0.5295400836211598
45071,"Newberry County, South Carolina",37914,18494,19420,22190,25802,3004,1086,74,260,37478,2213,1501,3714,7282,3214,4068,16020,12,6.2,91.9,3.745318352059925,19.206625520915757,1420,98.85002901302948,42.25352112676056,0.48778815213377646
45073,"Oconee County, South Carolina",75926,37417,38509,26798,54468,7719,3789,777,888,75390,5121,4697,9818,13993,6209,7784,30489,238,8.61,88.9,7.183310065063351,18.42978689776888,5454,99.29404946922003,40.15620472565393,0.49280878750362195
45075,"Orangeburg County, South Carolina",89116,41789,47327,19489,59344,7166,3619,484,681,88419,6962,5309,12271,20069,8573,11496,33972,339,5.78,91.9,5.368284034292383,22.520086179810583,4784,99.21787333363257,38.12110058799767,0.468928138605862
45077,"Pickens County, South Carolina",121449,60358,61091,23501,76092,10740,4869,969,1353,120761,6588,5991,12579,20987,9714,11273,52049,244,8.22,88.6,5.921003878171084,17.280504573936383,7191,99.43350706881078,42.856672348063796,0.4969822723941737
45079,"Richland County, South Carolina",404869,196424,208445,28018,251220,57016,27599,5906,4239,381029,20219,17767,37986,62671,27124,35547,197646,3672,6.67,92.2,9.322521605753959,15.479327881364096,37744,94.11167562841314,48.8172717595074,0.48515445736769175
45081,"Saluda County, South Carolina",20228,10050,10178,20390,14049,1554,599,78,58,19971,1674,1454,3128,4091,1733,2358,8393,67,6.39,91.6,3.6335772196954714,20.22444136840024,735,98.72948388372554,41.491991299189245,0.49683606881550324
45083,"Spartanburg County, South Carolina",297732,144327,153405,24786,199413,30238,12927,2526,1787,293493,18719,16546,35265,45020,19136,25884,132407,703,7.05,90.6,5.790442411296065,15.120981285182648,17240,98.57623634678167,44.47187403436648,0.48475474587884404
45085,"Sumter County, South Carolina",107379,51688,55691,21733,69550,8504,3862,797,408,103229,6533,6394,12927,22200,9699,12501,44254,357,7.32,91.5,4.71879976531724,20.674433548459195,5067,96.1351847195448,41.212900101509604,0.48136041497872023
45087,"Union County, South Carolina",27772,13346,14426,21183,19686,1566,704,90,105,27282,1659,1046,2705,5258,2163,3095,11413,86,5.99,91.6,3.2370733112487398,18.93273800950598,899,98.23563301166642,41.09534783234913,0.48055595563877285
45089,"Williamsburg County, South Carolina",32256,15564,16692,17440,22550,1910,712,170,48,30477,1747,1827,3574,8575,3730,4845,11301,106,7.75,91.6,2.8831845238095237,26.58420138888889,930,94.48474702380952,35.03534226190476,0.48251488095238093
45091,"York County, South Carolina",251664,121451,130213,30387,167738,35168,13521,2002,1399,250153,11998,11880,23878,30418,12839,17579,119947,626,6.53,90.8,6.724044758090152,12.086750588085701,16922,99.39959628711297,47.66156462585034,0.4825918685231102
46003,"Aurora County, South Dakota",2739,1445,1294,30872,1819,305,53,3,6,2608,79,52,131,162,69,93,1448,34,4.35,90.5,2.2635998539612996,5.9145673603504925,62,95.21723256663016,52.866009492515516,0.5275648046732384
46005,"Beadle County, South Dakota",18163,9219,8944,24950,12066,1919,366,15,59,17847,612,658,1270,4232,1993,2239,8983,72,4.73,89.1,2.422507295050377,23.300115619666354,440,98.260199306282,49.457688707812586,0.5075703352970324
46007,"Bennett County, South Dakota",3440,1567,1873,15287,1907,272,48,4,6,3400,382,319,701,1272,477,795,1174,74,3.88,93,1.686046511627907,36.97674418604651,58,98.83720930232558,34.127906976744185,0.4555232558139535
46009,"Bon Homme County, South Dakota",6972,4057,2915,24858,5113,660,199,68,43,5557,152,167,319,562,246,316,2828,17,4.87,89.7,4.44635685599541,8.060814687320711,310,79.7045324153758,40.562248995983936,0.581899024670109
46011,"Brookings County, South Dakota",33697,17153,16544,27197,17794,4629,1570,228,766,33558,1201,958,2159,4815,2590,2225,18638,42,5.5,83.9,7.6089859631421195,14.289105855120633,2564,99.58750037095291,55.310561771077545,0.5090364127370389
46013,"Brown County, South Dakota",38637,18909,19728,31493,25488,5155,1584,300,307,38089,1598,1372,2970,4116,1861,2255,20476,172,3.05,87.7,5.670730129150814,10.653001009395139,2191,98.58167041954603,52.99583300980925,0.4894013510365712
46015,"Brule County, South Dakota",5280,2626,2654,26074,3549,642,176,50,35,5121,260,237,497,745,337,408,2656,129,4.46,93,4.943181818181818,14.109848484848484,261,96.98863636363636,50.303030303030305,0.4973484848484849
46017,"Buffalo County, South Dakota",2048,984,1064,10960,1030,75,11,6,0,2048,486,478,964,825,395,430,583,3,3.83,92.4,0.830078125,40.283203125,17,100,28.466796875,0.48046875
46019,"Butte County, South Dakota",10194,5078,5116,26178,7006,1164,212,72,10,10076,815,595,1410,1099,510,589,5033,3,2.59,93.7,2.884049440847557,10.780851481263488,294,98.8424563468707,49.372179713556996,0.49813615852462234
46021,"Campbell County, South Dakota",1443,720,723,36158,1091,214,13,11,20,1443,13,50,63,67,31,36,741,0,3.69,89,3.049203049203049,4.643104643104643,44,100,51.351351351351354,0.498960498960499
46023,"Charles Mix County, South Dakota",9319,4637,4682,21805,5747,728,151,75,36,9069,891,985,1876,1930,913,1017,3725,90,5.29,91.9,2.8114604571305932,20.710376649855135,262,97.31730872411202,39.97210001073076,0.4975855778517008
46025,"Clark County, South Dakota",3642,1877,1765,26759,2440,345,72,20,2,3579,137,131,268,475,222,253,1736,18,4.64,85.4,2.5809994508511807,13.042284459088412,94,98.27018121911038,47.66611751784734,0.5153761669412411
46027,"Clay County, South Dakota",13907,6955,6952,24541,6954,1887,835,155,548,13713,628,602,1230,2901,1497,1404,7001,25,6.42,88.8,11.059178830804631,20.859998561875315,1538,98.60501905515208,50.341554612784925,0.5001078593514058
46029,"Codington County, South Dakota",27963,14163,13800,29249,18824,3336,533,189,17,27642,869,885,1754,3214,1477,1737,15211,77,4.87,83.5,2.642777956585488,11.493759610914422,739,98.85205450059007,54.39688159353431,0.5064907198798412
46031,"Corson County, South Dakota",4177,2125,2052,15160,2311,350,58,0,2,4177,547,452,999,1985,951,1034,1248,10,3.09,91.8,1.4364376346660281,47.5221450802011,60,100,29.877902801053388,0.5087383289442183
46033,"Custer County, South Dakota",8519,4275,4244,31015,6739,1254,270,27,102,8219,406,448,854,1081,454,627,3941,59,2.82,89,4.683648315529992,12.689282779668975,399,96.47845991313534,46.26129827444536,0.5018194623782134
46035,"Davison County, South Dakota",19753,9895,9858,28086,13256,2356,576,192,51,19415,957,416,1373,2376,1265,1111,10159,90,3.6,89.8,4.146205639649674,12.028552624917735,819,98.28886751379537,51.43016250696097,0.5009365665974789
46037,"Day County, South Dakota",5524,2834,2690,30841,3999,575,114,40,14,5364,339,239,578,878,412,466,2759,30,3.94,85,3.041274438812455,15.894279507603185,168,97.10354815351195,49.945691527878346,0.5130340333091963
46039,"Deuel County, South Dakota",4282,2246,2036,29204,3016,458,91,41,15,4216,172,84,256,422,203,219,2253,9,6.89,82.3,3.4329752452125177,9.85520784680056,147,98.45866417561886,52.61560018682859,0.524521251751518
46041,"Dewey County, South Dakota",5709,2823,2886,17267,3096,330,105,7,10,5664,913,782,1695,1776,826,950,1924,12,3.98,93.2,2.1369767034506917,31.10877561744614,122,99.21177088807147,33.70117358556665,0.49448239621650025
46043,"Douglas County, South Dakota",2940,1448,1492,27603,2056,261,94,30,3,2843,209,153,362,232,76,156,1454,14,4.59,90.6,4.319727891156463,7.891156462585034,127,96.70068027210884,49.45578231292517,0.4925170068027211
46045,"Edmunds County, South Dakota",3971,2008,1963,31836,2724,463,184,13,21,3859,150,73,223,228,63,165,1989,9,3.24,87.7,5.489801057668093,5.741626794258373,218,97.17955175018886,50.088139007806596,0.5056660790732813
46047,"Fall River County, South Dakota",6783,3424,3359,26584,5172,944,149,51,45,6567,319,291,610,978,356,622,3132,56,2.68,92.8,3.611971104231166,14.418398938522778,245,96.8155683325962,46.174259177355154,0.5047913902403066
46049,"Faulk County, South Dakota",2327,1196,1131,29714,1664,294,114,21,15,2266,129,111,240,244,142,102,1108,3,3.1,88.2,6.446067898581865,10.485603781693166,150,97.37859905457671,47.61495487752471,0.5139664804469274
46051,"Grant County, South Dakota",7133,3652,3481,29363,5027,637,93,17,2,7092,169,91,260,540,156,384,3705,0,6.28,84.7,1.5701668302257115,7.57044721715968,112,99.4252067853638,51.94167951773447,0.5119865414271695
46053,"Gregory County, South Dakota",4209,2156,2053,26169,2965,509,81,25,11,4156,231,222,453,634,301,333,2000,6,5.89,93.1,2.77975766215253,15.06296032311713,117,98.7407935376574,47.51722499406035,0.5122356854359705
46055,"Haakon County, South Dakota",2084,1047,1037,22863,1437,198,44,6,8,2047,97,68,165,352,187,165,899,0,2,95.3,2.783109404990403,16.89059500959693,58,98.22456813819578,43.13819577735125,0.5023992322456814
46057,"Hamlin County, South Dakota",5911,3024,2887,27060,3568,597,133,23,18,5757,213,129,342,321,169,152,2817,44,4.86,83.7,2.9436643545931314,5.430553205887329,174,97.39468787007274,47.6569108441888,0.5115885636948063
46059,"Hand County, South Dakota",3303,1673,1630,33109,2362,445,104,31,0,3249,113,37,150,264,115,149,1661,5,3.77,89.6,4.087193460490464,7.992733878292461,135,98.36512261580381,50.28761731759007,0.50650923402967
46061,"Hanson County, South Dakota",3404,1714,1690,24805,2070,360,80,11,1,3402,105,75,180,222,159,63,1613,3,4.1,88.8,2.7027027027027026,6.521739130434782,92,99.94124559341951,47.385428907168034,0.5035252643948296
46063,"Harding County, South Dakota",1281,684,597,30464,883,213,52,7,0,1261,60,36,96,163,79,84,658,4,2.74,93.5,4.605776736924278,12.724434035909447,59,98.43871975019516,51.36612021857923,0.5339578454332553
46065,"Hughes County, South Dakota",17572,8599,8973,32000,12152,2909,839,249,184,16522,748,529,1277,1847,895,952,9328,13,3.15,93.9,7.238788982472115,10.511040291372638,1272,94.02458456635557,53.08445253812884,0.4893580696562713
46067,"Hutchinson County, South Dakota",7277,3616,3661,29869,4987,906,200,56,21,7035,301,200,501,909,413,496,3532,23,4.77,88.6,3.806513673216985,12.49141129586368,277,96.67445375841693,48.536484815171086,0.49690806651092484
46069,"Hyde County, South Dakota",1373,686,687,30277,1011,158,31,3,6,1334,55,33,88,190,82,108,665,13,3.35,91,2.9133284777858703,13.838310269482884,40,97.15950473415877,48.4340859431901,0.4996358339402768
46071,"Jackson County, South Dakota",3275,1659,1616,16939,1889,300,95,10,7,3228,416,382,798,1430,718,712,1087,13,2.66,95,3.4198473282442747,43.66412213740458,112,98.56488549618321,33.19083969465649,0.5065648854961832
46073,"Jerauld County, South Dakota",2034,955,1079,38776,1480,214,56,16,0,1992,85,58,143,176,52,124,948,14,4.79,89.4,3.5398230088495577,8.652900688298919,72,97.93510324483776,46.607669616519175,0.4695181907571288
46075,"Jones County, South Dakota",740,375,365,26526,599,76,18,1,0,740,55,56,111,80,44,36,422,8,3.41,95.7,2.5675675675675675,10.81081081081081,19,100,57.027027027027025,0.5067567567567568
46077,"Kingsbury County, South Dakota",5000,2527,2473,33333,3608,580,160,57,4,4913,130,92,222,467,200,267,2590,10,5.32,85.4,4.42,9.34,221,98.26,51.8,0.5054
46079,"Lake County, South Dakota",12350,6387,5963,31145,8271,1924,505,87,103,12205,414,371,785,1799,856,943,6268,56,4.5,85,5.627530364372469,14.566801619433198,695,98.82591093117409,50.75303643724696,0.517165991902834
46081,"Lawrence County, South Dakota",25018,12441,12577,28606,17197,3535,1201,214,359,24763,1368,1178,2546,2976,1276,1700,12682,50,3.28,88.2,7.090894555919737,11.895435286593653,1774,98.98073387161244,50.691502118474695,0.4972819569909665
46083,"Lincoln County, South Dakota",53147,26250,26897,39404,34099,9626,2766,1095,480,52863,1073,1377,2450,1601,556,1045,28960,134,5.78,87.3,8.167911641296781,3.0123995710011853,4341,99.46563305548761,54.49037575027753,0.4939131089243043
46085,"Lyman County, South Dakota",3882,2024,1858,21155,2437,332,86,17,2,3856,418,310,728,835,390,445,1715,6,4.51,95.3,2.704791344667697,21.509531169500256,105,99.330242143225135,44.17825862957238,0.521380731581659
46087,"McCook County, South Dakota",5515,2784,2731,29254,3639,575,165,19,23,5369,218,164,382,496,227,269,2826,11,4.72,86.8,3.7533998186763373,8.99365367180417,207,97.35267452402539,51.24206708975521,0.5048050770625566
46089,"McPherson County, South Dakota",2366,1180,1186,25975,1744,203,48,7,9,2270,207,58,265,385,249,136,1022,0,3.86,86.2,2.7049873203719357,16.272189349112427,64,95.9425190194421,43.19526627218935,0.4987320371935757
46091,"Marshall County, South Dakota",4759,2477,2282,28861,3266,593,110,44,24,4693,230,152,382,389,120,269,2414,31,4.44,85,3.7402815717587727,8.17398613154024,178,98.6131540239546,50.724942214750996,0.5204874973733977
46093,"Meade County, South Dakota",27066,14134,12932,26896,17665,3261,848,207,53,25767,1389,1400,2789,2304,989,1315,14711,19,2.05,94,4.093696889085938,8.512524939037908,1108,95.20062070494347,54.35232394886574,0.5222049804182369
46095,"Mellette County, South Dakota",2062,1017,1045,14264,1263,166,26,0,0,2026,377,292,669,855,416,439,680,0,4.1,96.2,1.2609117361784674,41.46459747817653,26,98.25412221144519,32.97769156159069,0.49321047526673134
46097,"Miner County, South Dakota",2255,1167,1088,28633,1556,234,36,22,20,2211,101,100,201,257,132,125,1091,22,4.45,86.7,3.458980044345898,11.39689578713969,78,98.04878048780488,48.38137472283814,0.5175166297117516
46099,"Minnehaha County, South Dakota",183660,92360,91300,29551,120239,26035,7816,2154,1126,180940,7759,6514,14273,19599,8556,11043,100856,666,5.06,86.3,6.041598606120004,10.671349232277034,11096,98.51900250462812,54.91451595339214,0.502885767178482
46101,"Moody County, South Dakota",6496,3312,3184,27774,4398,841,183,17,12,6440,440,245,685,1009,498,511,3248,61,5.22,85,3.2635467980295565,15.532635467980295,212,99.13793103448276,50,0.5098522167487685
46103,"Pennington County, South Dakota",108126,54305,53821,28910,73154,14214,5378,1130,897,105356,6158,5733,11891,14803,6412,8391,54150,387,2.39,91.7,6.848491574644396,13.69050922072397,7405,97.43817398220594,50.080461683591366,0.5022381295895529
46105,"Perkins County, South Dakota",2964,1485,1479,30120,2106,276,89,38,6,2920,175,118,293,348,143,205,1507,1,1.98,93.1,4.487179487179487,11.740890688259109,133,98.51551956815115,50.84345479082321,0.5010121457489879
46107,"Potter County, South Dakota",2318,1130,1188,32853,1709,266,70,40,4,2238,71,61,132,145,86,59,1134,0,3.97,89.9,4.918032786885246,6.255392579810181,114,96.54874892148403,48.921484037963765,0.48748921484037966
46109,"Roberts County, South Dakota",10250,5192,5058,25767,6475,770,226,87,47,10061,1066,1022,2088,1879,851,1028,4422,28,5.18,85.1,3.5121951219512195,18.33170731707317,360,98.15609756097561,43.141463414634146,0.5065365853658537
46111,"Sanborn County, South Dakota",2366,1212,1154,31965,1683,240,53,16,2,2303,75,68,143,224,98,126,1267,0,5.05,89.4,3.0008453085376163,9.467455621301776,71,97.33727810650888,53.55029585798817,0.5122569737954353
46115,"Spink County, South Dakota",6478,3221,3257,31957,4477,752,164,53,12,6347,223,256,479,626,273,353,3187,8,3.66,88.6,3.5350416795307193,9.663476381599258,229,97.97777091694968,49.197283112071624,0.49722136461870947
46117,"Stanley County, South Dakota",2994,1552,1442,32862,2111,324,184,55,26,2994,156,37,193,172,73,99,1740,0,2.98,95.2,8.851035404141616,5.744822979291917,265,100,58.11623246492986,0.518370073480294
46119,"Sully County, South Dakota",1390,756,634,39888,936,197,32,4,0,1390,80,45,125,45,16,29,725,0,3.53,92.4,2.5899280575539567,3.237410071942446,36,100,52.15827338129496,0.543884892086331
46121,"Todd County, South Dakota",10016,4905,5111,11665,4903,515,219,43,19,9985,1619,1383,3002,5082,2487,2595,2732,102,4.51,94.7,2.805511182108626,50.7388178913738,281,99.69049520766774,27.276357827476037,0.4897164536741214
46123,"Tripp County, South Dakota",5480,2781,2699,27613,3858,643,112,37,61,5346,269,253,522,1045,484,561,2815,13,6.65,96.2,3.832116788321168,19.06934306569343,210,97.55474452554745,51.36861313868613,0.5074817518248175
46125,"Turner County, South Dakota",8242,4140,4102,27844,5782,945,267,47,46,8086,288,255,543,851,302,549,4252,56,6.42,87.5,4.367871875758311,10.32516379519534,360,98.10725552050474,51.58942004367872,0.5023052657122058
46127,"Union County, South Dakota",14929,7525,7404,37093,10188,1964,739,237,181,14800,490,587,1077,1084,376,708,7866,20,6.19,88.5,7.750016745930739,7.261035568356889,1157,99.13590997387635,52.68939647665617,0.504052515238797
46129,"Walworth County, South Dakota",5502,2678,2824,29457,3938,655,110,81,34,5352,236,299,535,539,138,401,2654,20,4.11,89.6,4.089422028353326,9.79643765903308,225,97.27371864776445,48.23700472555434,0.4867320974191203
46135,"Yankton County, South Dakota",22660,11786,10874,30395,15859,2792,1058,287,229,21269,822,520,1342,2770,1191,1579,11190,29,5.02,88.8,6.946160635481024,12.224183583406884,1574,93.86142983230361,49.382171226831424,0.5201235657546337
46137,"Ziebach County, South Dakota",2837,1421,1416,13461,1574,192,28,6,8,2837,406,246,652,1216,616,600,928,32,3.12,94.8,1.4804370814240395,42.86217835741981,42,100,32.71060979908354,0.5008812125484667
47001,"Anderson County, Tennessee",75538,36803,38735,26972,53674,7217,3531,772,1233,74641,3891,2569,6460,12085,5084,7001,31489,159,9.63,86.5,7.3287616828616065,15.998570256030078,5536,98.81251820275888,41.68630358230295,0.48721173449124944
47003,"Bedford County, Tennessee",46854,23127,23727,22953,30826,3360,1079,256,130,46458,3241,2571,5812,7828,3253,4575,20995,131,7.98,89.2,3.1267341102147097,16.70721816707218,1465,99.15482135996926,44.809407948094076,0.4935971315149187
47005,"Benton County, Tennessee",16154,7794,8360,21282,11827,976,384,72,85,16002,835,914,1749,3566,1457,2109,5528,49,6.67,89.6,3.349015723659775,22.075027856877554,541,99.05905658041353,34.22062647022409,0.4824811192274359
47007,"Bledsoe County, Tennessee",14413,8385,6028,21402,10989,791,474,65,31,13234,1307,765,2072,2735,1484,1251,5144,49,8.84,85.3,3.954763061125373,18.975924512592798,570,91.81988482619857,35.690002081454246,0.5817664608339693
47009,"Blount County, Tennessee",127135,61640,65495,28334,90409,13897,4682,1648,888,125993,6756,5322,12078,16196,7028,9168,57626,511,7.12,86.8,5.677429504070476,12.739214221103552,7218,99.10174224249813,45.326621308058364,0.4848389507216738
47011,"Bradley County, Tennessee",103666,50468,53198,25144,70006,9433,4260,860,694,102666,6871,5877,12748,18048,7927,10121,45524,472,8.89,88.8,5.608396195473926,17.409758262111012,5814,99.03536357146992,43.91410877240368,0.48683271275056433
47013,"Campbell County, Tennessee",39824,19411,20413,21282,28593,2115,916,255,78,39285,2671,2309,4980,8071,3517,4554,14683,48,8.67,84.2,3.1362997187625554,20.266673362796304,1249,98.64654479710727,36.86972679791081,0.48741964644435515
47015,"Cannon County, Tennessee",13839,6738,7101,24595,9834,791,294,70,42,13653,720,468,1188,2317,1038,1279,5989,11,7.52,88.6,2.9337379868487607,16.742539200809308,406,98.65597225233037,43.276248283835535,0.48688489052677214
47017,"Carroll County, Tennessee",28137,13758,14379,20557,19385,1931,934,69,128,27646,1577,1020,2597,5400,2503,2897,10794,237,7.02,90.1,4.019618296193624,19.19181149376266,1131,98.2549667697338,38.362298752532254,0.48896470839108647
47019,"Carter County, Tennessee",56500,27736,28764,21001,41355,4166,1674,324,234,55450,3735,3211,6946,13432,6067,7365,22423,285,8.75,83.1,3.950442477876106,23.773451327433627,2232,98.14159292035399,39.686725663716814,0.49090265486725665
47021,"Cheatham County, Tennessee",39713,19642,20071,25673,27319,3514,1397,170,220,39386,1882,1679,3561,4966,1998,2968,18806,157,7.11,91.2,4.4997859642938085,12.504721375871881,1787,99.176592047944,47.354770478180946,0.4945987460025684
47023,"Chester County, Tennessee",17097,8199,8898,20497,10863,983,541,70,196,16966,1098,970,2068,2902,1455,1447,6951,67,6.77,90.9,4.720126337954027,16.973738082704568,807,99.23378370474352,40.65625548341814,0.4795578171609054
47025,"Claiborne County, Tennessee",31566,15284,16282,20184,22478,1679,800,195,245,30973,1469,1204,2673,6768,2899,3869,11429,51,8.37,84.6,3.9282772603434073,21.44079072419692,1240,98.12139643920675,36.20667807134259,0.4841918519926503
47027,"Clay County, Tennessee",7684,3777,3907,17667,5600,368,246,81,20,7591,517,520,1037,2018,982,1036,2547,14,7.12,87.9,4.515877147319105,26.262363352420614,347,98.78969286829776,33.14679854242582,0.4915408641332639
47029,"Cocke County, Tennessee",35262,17221,18041,20189,25364,1793,755,254,88,34979,2259,2234,4493,8688,3880,4808,14044,143,6.19,86.8,3.1109976745505077,24.6384209630764,1097,99.19743633373037,39.827576427882704,0.48837275253814305
47031,"Coffee County, Tennessee",54074,26397,27677,24748,36721,4414,1963,321,253,53471,3164,2505,5669,8111,3550,4561,22614,111,7.04,87.5,4.691718755779117,14.999815068239819,2537,98.88486148611163,41.82046824721678,0.4881643673484484
47033,"Crockett County, Tennessee",14554,6915,7639,21056,9854,805,393,33,51,14342,1113,924,2037,2522,1193,1329,5949,16,6.92,91,3.2774494984196783,17.328569465439056,477,98.54335577848015,40.87536072557373,0.47512711282121756
47035,"Cumberland County, Tennessee",58178,28515,29663,23668,44068,5237,2207,463,282,57531,3928,2858,6786,9129,4025,5104,20284,98,7.74,83.6,5.074082986696002,15.691498504589363,2952,98.88789576815978,34.86541304273093,0.49013372752586887
47037,"Davidson County, Tennessee",678322,327080,351242,32347,464026,114156,45394,12817,9058,671589,50422,39682,90104,111103,51266,59837,355699,2678,7.17,90.7,9.916971585766053,16.379094294450127,67269,99.00740356349934,52.43807513245922,0.4821898744254204
47039,"Decatur County, Tennessee",11681,5744,5937,21098,8390,656,245,30,35,11444,609,641,1250,2584,1163,1421,4431,66,7.02,90.7,2.653882373084496,22.121393716291415,310,97.9710641212225,37.93339611334646,0.4917387209999144
47041,"DeKalb County, Tennessee",19380,9705,9675,25443,13623,1214,399,105,136,19143,1262,1074,2336,3592,1603,1989,7880,63,7.34,88.5,3.3023735810113517,18.53457172342621,640,98.77708978328174,40.66047471620227,0.5007739938080495
47043,"Dickson County, Tennessee",51341,25100,26241,25211,35020,3379,1155,321,285,50838,3148,3017,6165,7344,3105,4239,22248,159,6.86,89.6,3.43000720671588,14.304357141465886,1761,99.0202761925167,43.33378781091136,0.4888880232173117
47045,"Dyer County, Tennessee",37751,18201,19550,24695,25448,2959,1180,268,197,37227,1871,1789,3660,6674,2628,4046,15968,142,5.44,89.7,4.357500463563879,17.67900188074488,1645,98.6119572991444,42.298217265767796,0.4821329236311621
47047,"Fayette County, Tennessee",39336,19329,20007,30471,28528,4233,1735,212,217,38844,1921,1480,3401,5602,2590,3012,17287,243,7.1,91.1,5.501321944274965,14.241407362212732,2164,98.74923733984137,43.947020540980276,0.4913819402074436
47049,"Fentress County, Tennessee",17940,8846,9094,18171,12735,936,412,106,40,17709,1258,750,2008,4059,2053,2006,6493,45,7.87,84.5,3.1103678929765888,22.62541806020067,558,98.7123745819398,36.19286510590858,0.4930880713489409
47051,"Franklin County, Tennessee",41397,20224,21173,25637,28183,3446,1539,417,394,41048,1805,1404,3209,5918,2858,3060,17400,91,8.02,88,5.6767398603763555,14.29572191221586,2350,99.15694373988454,42.032031306616425,0.488537816750006
47053,"Gibson County, Tennessee",49222,23447,25775,21858,33168,3751,1622,359,166,48088,2460,1898,4358,8231,3373,4858,20358,258,6.46,90.3,4.361870708219902,16.722197391410344,2147,97.69615212709763,41.35955467067571,0.4763520377067165
47055,"Giles County, Tennessee",29024,14119,14905,22994,20447,1973,746,180,121,28614,1763,1227,2990,4498,1935,2563,11995,171,7.56,89.3,3.6073594266813673,15.497519294377067,1047,98.58737596471886,41.32786659316428,0.4864594818081588
47057,"Grainger County, Tennessee",22942,11383,11559,20966,16468,1269,358,98,101,22795,1385,1052,2437,4253,1823,2430,9126,47,7.35,86.9,2.4278615639438583,18.53805248016738,557,99.35925377037748,39.7785720512597,0.496164240258042
47059,"Greene County, Tennessee",68520,33482,35038,21960,49161,4743,2017,385,213,67319,3969,3269,7238,11422,5276,6146,27103,435,5.85,87.4,3.8164039696438996,16.669585522475188,2615,98.24722708698191,39.55487448920023,0.4886456509048453
47061,"Grundy County, Tennessee",13359,6575,6784,15824,9312,647,289,20,66,13179,1496,980,2476,3746,1718,2028,4116,29,8.59,84.4,2.8070963395463733,28.04102103450857,375,98.65259375701774,30.810689422860992,0.4921775582004641
47063,"Hamblen County, Tennessee",63465,31109,32356,21962,43565,4580,1960,410,205,62687,4681,3409,8090,12232,5709,6523,25764,549,6.24,87.7,4.057354447333176,19.27361537855511,2575,98.77412747183487,40.59560387615221,0.4901756873867486
47065,"Hamilton County, Tennessee",354589,170993,183596,29711,247228,48601,19133,4958,2632,350600,18904,14575,33479,50043,21901,28142,163225,1034,9.82,88.2,7.536330794243476,14.112958946837042,26723,98.87503560460138,46.03216681848563,0.48222872113912163
47067,"Hancock County, Tennessee",6605,3273,3332,19396,4776,273,149,18,47,6440,412,325,737,1652,688,964,2165,27,7.7,85.6,3.2399697199091597,25.0113550340651,214,97.50189250567752,32.778198334595004,0.4955336866010598
47069,"Hardeman County, Tennessee",25784,14076,11708,16938,18313,1233,650,93,23,22096,1397,1167,2564,4664,2049,2615,8085,18,6.92,91.1,2.9708346261247285,18.088737201365188,766,85.696556003723245,31.35665529010239,0.5459199503568104
47071,"Hardin County, Tennessee",25813,12669,13144,23328,18652,1568,665,155,16,25398,1954,1374,3328,5449,2265,3184,9615,127,6.44,90.6,3.238678185410452,21.109518459690854,836,98.39228295819936,37.24867314918839,0.4907992097005385
47073,"Hawkins County, Tennessee",56402,27525,28877,22141,40470,3582,1221,354,169,55776,3267,2447,5714,10737,4524,6213,21146,215,7.06,87.1,3.0920889330165595,19.036558987269956,1744,98.89011027977732,37.49157831282579,0.48801460941101377
47075,"Haywood County, Tennessee",17944,8404,9540,21453,12427,966,418,85,67,17708,1098,751,1849,3377,1397,1980,7617,74,6.73,91.2,3.1765492643780653,18.819661168078465,570,98.68479714667856,42.448729380294246,0.4683459652251449
47077,"Henderson County, Tennessee",27889,13446,14443,21344,19337,1904,664,112,97,27562,1393,1216,2609,5365,2417,2948,11200,79,7.25,90.6,3.130266413281222,19.23697515149342,873,98.82749471117646,40.159202552977874,0.48212556922083977
47079,"Henry County, Tennessee",32263,15627,16636,22952,23243,2074,1215,174,223,31806,2064,1225,3289,6254,2657,3597,12470,300,7.49,89.1,4.996435545361559,19.38443418157022,1612,98.58351672194155,38.65108638378328,0.48436289247745096
47081,"Hickman County, Tennessee",24502,12830,11672,20936,17137,1196,536,103,46,22982,1331,1269,2600,4523,2105,2418,9435,222,6.48,89.1,2.7956901477430414,18.459717574075587,685,93.79642478165047,38.50706064811036,0.5236307240225287
47083,"Houston County, Tennessee",8188,4106,4082,20819,5714,474,104,12,24,7983,439,433,872,1349,663,686,2910,13,6.6,88.9,1.709819247679531,16.47532975085491,140,97.49633610161212,35.53981436248168,0.5014655593551539
47085,"Humphreys County, Tennessee",18281,8985,9296,23498,12890,921,598,59,38,18064,875,759,1634,3299,1507,1792,7100,53,5.78,89.2,3.8017613916087742,18.04605874952136,695,98.81297522017395,38.83813795744215,0.4914939007712926
47087,"Jackson County, Tennessee",11573,5827,5746,18643,8551,409,185,25,70,11388,796,613,1409,2532,1076,1456,3954,13,7.13,88.2,2.4194245225956967,21.87851032575823,280,98.40145165471355,34.1657305797978,0.5034995247558973
47089,"Jefferson County, Tennessee",52887,25886,27001,23724,37176,3653,1775,322,282,51964,2946,2471,5417,7001,3395,3606,22484,174,6.44,88.5,4.498269896193771,13.237657647436988,2379,98.25476960311607,42.513283037419406,0.48945865713691455
47091,"Johnson County, Tennessee",17846,9625,8221,19183,13489,1029,341,65,32,15947,875,930,1805,4030,1984,2046,5543,99,9.17,81.8,2.4543315028577832,22.58209122492435,438,89.35895999103441,31.06018155328925,0.5393365460047069
47093,"Knox County, Tennessee",452286,219839,232447,30541,300733,66004,28539,8011,7245,448739,22368,18199,40567,69448,31258,38190,219159,1339,8.12,88.3,9.683032417541114,15.35488606766515,43795,99.21576170829961,48.45584431090062,0.48606191657491055
47095,"Lake County, Tennessee",7588,4761,2827,14232,5666,306,197,28,2,4871,300,253,553,1431,569,862,1821,32,5.8,89,2.9915656299420137,18.858724301528728,227,64.19346336320505,23.998418555614126,0.6274380600948867
47097,"Lauderdale County, Tennessee",26497,13524,12973,17178,17960,954,411,145,33,23619,1370,1131,2501,5451,2326,3125,8875,63,6.09,90,2.222893157715968,20.57214024229158,589,89.13839302562555,33.494357851832284,0.5103974034796392
47099,"Lawrence County, Tennessee",42591,20989,21602,19879,28675,2035,975,421,73,42143,3304,3072,6376,7688,3249,4439,15796,183,8.59,89.3,3.4490854875443167,18.05076189805358,1469,98.94813458242352,37.08764762508511,0.49280364396233944
47101,"Lewis County, Tennessee",11944,5864,6080,20099,8530,711,238,68,7,11725,908,780,1688,2603,1243,1360,4743,150,9.5,89,2.6205626255860683,21.793369055592766,313,98.16644340254521,39.710314802411254,0.49095780308104486
47103,"Lincoln County, Tennessee",33543,16488,17055,24029,23620,2865,1213,116,120,33191,1827,1264,3091,5578,2541,3037,13806,97,7.87,89.1,4.319828280118058,16.629401067286768,1449,98.95060072146201,41.15910920311242,0.49154816206063856
47105,"Loudon County, Tennessee",51024,24934,26090,30177,37341,5991,2683,547,558,50654,2937,2720,5657,6923,3141,3782,19926,105,7.94,88.3,7.42395735340232,13.568124804013797,3788,99.27485105048605,39.052210724365004,0.48867199749137663
47107,"McMinn County, Tennessee",52569,25630,26939,21583,36911,3647,1479,301,243,51800,3197,2202,5399,10069,4524,5545,20313,60,8.3,88.8,3.848275599688029,19.153873956133843,2023,98.53716068405333,38.64064372538949,0.48754969658924463
47109,"McNairy County, Tennessee",25945,12672,13273,19745,18111,1497,547,110,63,25601,1797,1558,3355,5520,2548,2972,9220,90,6.25,90.8,2.7751011755636923,21.275775679321644,720,98.67411832723069,35.5367122759684,0.4884178068992099
47111,"Macon County, Tennessee",23239,11381,11858,20666,15655,871,463,118,55,22892,1431,971,2402,4235,1883,2352,9496,31,6.85,88.4,2.7367786909935883,18.223675717543784,636,98.50682043117173,40.862343474331944,0.489737079908774
47113,"Madison County, Tennessee",97887,46449,51438,24600,64697,11038,3729,1019,1111,96630,5221,3743,8964,19100,8204,10896,42260,1162,7.41,91.1,5.985473045450366,19.51229478888923,5859,98.71586625394588,43.172229203060674,0.47451653437126484
47115,"Marion County, Tennessee",28355,13830,14525,23807,20220,1716,651,175,88,27992,1460,1317,2777,5045,1916,3129,11800,47,9.38,86.4,3.223417386704285,17.792276494445424,914,98.71980250396756,41.615235408217245,0.4877446658437665
47117,"Marshall County, Tennessee",31753,15700,16053,23920,21771,2104,557,192,71,31417,1570,1654,3224,4213,1762,2451,13494,92,7.44,89.7,2.582433155922275,13.268037665732372,820,98.94183226781722,42.496771958555094,0.49444147009731365
47119,"Maury County, Tennessee",87606,42201,45405,25872,60140,8403,2956,781,290,86444,4834,4496,9330,11212,4978,6234,40051,395,6.89,89.7,4.596717119831975,12.798210168253316,4027,98.67360683058239,45.71718832043467,0.48171358126155744
47121,"Meigs County, Tennessee",11830,5767,6063,22542,8549,419,290,115,15,11708,588,625,1213,1911,715,1196,4192,48,9.09,88.7,3.5502958579881656,16.153846153846153,420,98.9687235841082,35.43533389687236,0.4874894336432798
47123,"Monroe County, Tennessee",45698,22571,23127,20353,32041,2407,975,287,90,45185,2619,2287,4906,9132,4025,5107,16064,161,7.23,86.8,2.9585539848571054,19.983369075233053,1352,98.87741257823099,35.15252308634951,0.4939165827826163
47125,"Montgomery County, Tennessee",192120,96196,95924,24827,117962,21201,7801,1021,923,178128,9283,7539,16822,26641,12031,14610,88334,913,8.19,90.2,5.0723506141994585,13.866854049552362,9745,92.71705184259838,45.978555069748076,0.5007078909015199
47127,"Moore County, Tennessee",6302,3108,3194,31479,4566,595,225,38,31,6195,297,368,665,480,175,305,2767,0,8.31,88.6,4.665185655347509,7.616629641383688,294,98.30212630910822,43.90669628689305,0.4931767692795938
47129,"Morgan County, Tennessee",21639,12088,9551,18649,15609,742,396,23,38,18782,1201,963,2164,4279,1946,2333,6885,64,8.42,85,2.111927538241139,19.774481260686724,457,86.79698692176163,31.817551642867045,0.558621008364527
47131,"Obion County, Tennessee",30659,14679,15980,21939,21400,2179,795,276,91,30243,1840,1721,3561,6937,3203,3734,12307,156,6.22,88.5,3.7900779542711764,22.62630875110082,1162,98.64313904563097,40.141557128412536,0.47878273916305164
47133,"Overton County, Tennessee",21995,10914,11081,19961,15314,1298,510,151,33,21715,1279,883,2162,4241,2103,2138,8599,31,7.87,86,3.1552625596726527,19.281654921573086,694,98.72698340531939,39.09524892020914,0.4962036826551489
47135,"Perry County, Tennessee",7882,3960,3922,20204,5578,400,140,49,15,7736,535,609,1144,2274,1004,1270,2616,115,7.74,90.1,2.588175589951789,28.85054554681553,204,98.1476782542502,33.189545800558236,0.5024105556965237
47137,"Pickett County, Tennessee",5071,2566,2505,21300,3950,185,49,27,15,4983,251,226,477,936,363,573,2112,0,7.78,86.4,1.794517846578584,18.457897850522578,91,98.2646420824295,41.64859002169197,0.5060145927824886
47139,"Polk County, Tennessee",16722,8321,8401,24247,12097,798,383,107,23,16488,809,708,1517,2802,1261,1541,6633,40,8,87.2,3.0678148546824544,16.756368855400073,513,98.60064585575888,39.66630785791173,0.49760794163377586
47141,"Putnam County, Tennessee",75565,37302,38263,23337,48159,7615,2844,629,853,74695,4535,3508,8043,16843,7612,9231,32106,138,7.83,86.4,5.7248726262158405,22.28941970488983,4326,98.84867332759876,42.487924303579696,0.49364123602196786
47143,"Rhea County, Tennessee",32478,16027,16451,22031,22093,2011,815,221,88,32102,1831,1677,3508,6849,3066,3783,12856,95,9.35,86.9,3.4608042367140834,21.088121189728433,1124,98.84229324465792,39.58371820924934,0.49347250446456065
47145,"Roane County, Tennessee",52926,25970,26956,25555,38880,4461,2262,372,423,52261,2589,2307,4896,8045,3712,4333,20863,87,8.64,87.9,5.775989116880172,15.200468578770359,3057,98.74352870044969,39.419189056418396,0.4906851075085969
47147,"Robertson County, Tennessee",68575,33839,34736,26441,46223,5617,2172,310,273,67688,3800,2619,6419,7661,3460,4201,32039,493,8.33,89.8,4.017499088589136,11.171709806780896,2755,98.70652570178636,46.721108275610646,0.49345971563981045
47149,"Rutherford County, Tennessee",298456,147195,151261,27932,185540,41285,13096,2490,2153,296123,16395,13564,29959,34716,16056,18660,152647,936,6.31,89.6,5.943589674859946,11.63186533358351,17739,99.2183102366848,51.145562494974136,0.4931882756587236
47151,"Scott County, Tennessee",21949,10831,11118,18748,14877,650,409,130,53,21619,1511,1067,2578,5630,2517,3113,8116,246,8.33,84.4,2.697161601895303,25.650371315321884,592,98.49651464759215,36.97662763679439,0.49346211672513557
47153,"Sequatchie County, Tennessee",14654,7229,7425,22744,10320,882,352,161,100,14423,758,719,1477,2073,901,1172,5843,7,9.64,85,4.18315818206633,14.146308175242254,613,98.42363859697011,39.873072198717075,0.4933124061689641
47155,"Sevier County, Tennessee",95523,46856,48667,23298,67341,7853,3128,737,394,94605,8374,8112,16486,14396,6361,8035,44644,123,7.22,84.9,4.458612062016478,15.070715953225925,4259,99.038974906567,46.736388095013766,0.49052060760235755
47157,"Shelby County, Tennessee",937847,446846,491001,28117,607366,113166,50510,13420,8619,925195,66106,52155,118261,191520,85688,105832,424378,4900,7.25,91.3,7.73569676077228,20.42124141784321,72549,98.65095266072184,45.25023804522486,0.47645937983487713
47159,"Smith County, Tennessee",19279,9617,9662,23015,13197,903,356,93,124,19058,785,771,1556,2681,1215,1466,8285,40,6.57,88.8,2.972145858187665,13.90632294206131,573,98.85367498314228,42.97422065459827,0.49883292701903625
47161,"Stewart County, Tennessee",13248,6582,6666,22680,9417,909,375,52,88,13023,818,439,1257,2489,1203,1286,5116,127,5.88,88.6,3.88737922705314,18.78774154589372,515,98.30163043478261,38.617149758454104,0.49682971014492755
47163,"Sullivan County, Tennessee",156519,75908,80611,25946,113348,15032,6769,1644,1445,154897,8562,6087,14649,25508,11638,13870,65290,694,7.64,87,6.2982768865121805,16.297062976379863,9858,98.96370408704375,41.713785546802626,0.48497626486241285
47165,"Sumner County, Tennessee",175730,85968,89762,30669,119289,21302,7703,1667,988,174148,8889,7499,16388,16911,6999,9912,86052,1012,6.91,89,5.89426961816423,9.62328572241507,10358,99.09975530643601,48.96830364764127,0.4892050304444318
47167,"Tipton County, Tennessee",61434,30363,31071,26110,40435,3826,1922,374,67,60611,3400,2237,5637,8839,3979,4860,27391,178,6.52,90.2,3.8464042712504476,14.38779828759319,2363,98.66035094573037,44.58605983657258,0.49423771852719994
47169,"Trousdale County, Tennessee",8773,4654,4119,22863,5999,645,229,27,12,8684,977,438,1415,1152,576,576,3749,0,6.66,89,3.0548273110680495,13.13119799384475,268,98.98552376610054,42.733386526843724,0.5304912800638322
47171,"Unicoi County, Tennessee",17830,8880,8950,21374,13171,1329,435,97,101,17481,989,733,1722,3502,1389,2113,6852,212,8.57,82.2,3.550196298373528,19.64105440269209,633,98.04262478968032,38.4296130117779,0.49803701626472235
47173,"Union County, Tennessee",19176,9516,9660,20478,13463,729,364,51,40,19008,1128,1132,2260,4080,1834,2246,7112,44,8.57,86.6,2.3727576136837714,21.27659574468085,455,99.12390488110138,37.088026700041716,0.49624530663329164
47175,"Van Buren County, Tennessee",5675,2870,2805,20672,4160,211,118,63,19,5573,396,363,759,1083,557,526,2222,9,7.81,85.2,3.5242290748898677,19.083700440528634,200,98.20264317180617,39.15418502202643,0.505726872246696
47177,"Warren County, Tennessee",40210,19846,20364,21339,27431,2352,1122,308,156,39705,3201,2003,5204,8548,3933,4615,16867,73,7.95,87.2,3.9442924645610544,21.25839343446904,1586,98.74409350907735,41.94727679681671,0.4935588162148719
47179,"Washington County, Tennessee",126437,61427,65010,27334,86310,16158,7612,1688,2056,124652,6706,6129,12835,20127,8627,11500,57590,1126,7.94,87.4,8.981548122780515,15.918599776964022,11356,98.58822971123959,45.54837587098713,0.4858308881102842
47181,"Wayne County, Tennessee",16713,9273,7440,18702,12263,781,335,123,120,14687,865,889,1754,2882,1284,1598,5765,263,7.06,90,3.4583856877879495,17.244061509004965,578,87.87769999401664,34.49410638425178,0.5548375516065338
47183,"Weakley County, Tennessee",33776,16466,17310,19699,21476,2868,1159,156,290,33341,1906,1309,3215,6383,2774,3609,13845,212,5.43,89.3,4.7518948365703455,18.898034107058265,1605,98.71210326859308,40.990644244433916,0.48750592136428234
47185,"White County, Tennessee",26394,12929,13465,19867,18577,1511,562,118,102,25982,1546,1320,2866,4562,2179,2383,9726,83,7.83,86.6,2.962794574524513,17.284231264681367,782,98.4390391755702,36.84928392816549,0.4898461771614761
47187,"Williamson County, Tennessee",212161,103812,108349,48482,137338,50465,21055,4830,3452,211662,6136,5152,11288,9704,4114,5590,103722,1118,6.93,90.1,13.827706317372185,4.573884927012976,29337,99.7648012594209,48.88834422914673,0.48930764843680036
47189,"Wilson County, Tennessee",128874,63009,65865,31155,88039,18391,5962,1066,716,127842,5118,4243,9361,11712,4604,7108,61983,485,6.38,89.2,6.008970001707094,9.087946366218167,7744,99.1992178406816,48.09581451650449,0.488919409655943
48001,"Anderson County, Texas",57747,35292,22455,17466,41873,3221,1425,223,325,44367,3102,2973,6075,6935,3149,3786,18851,106,8.13,94.1,3.4166277036036505,12.009281867456318,1973,76.82996519299704,32.644120040867925,0.6111486310977193
48003,"Andrews County, Texas",17577,8980,8597,29903,10390,663,270,43,42,17478,1309,1388,2697,2082,815,1267,8013,36,3.4,94.3,2.01968481538374,11.845024748250555,355,99.43676395289299,45.58798429766172,0.51089491949707
48005,"Angelina County, Texas",87700,42707,44993,21974,56963,6426,2405,504,202,85494,8598,8083,16681,16222,7355,8867,35448,252,14.85,93.2,3.547320410490308,18.49714937286203,3111,97.48460661345496,40.419612314709234,0.48696693272519953
48007,"Aransas County, Texas",24832,12448,12384,29999,18258,2251,860,325,124,24416,2473,1984,4457,4344,1974,2370,9971,19,6.81,92.9,5.271423969072165,17.49355670103093,1309,98.32474226804123,40.1538337628866,0.5012886597938144
48009,"Archer County, Texas",8793,4335,4458,31103,6171,1122,255,71,7,8725,546,453,999,769,302,467,4294,48,5.7,97.1,3.787103377686796,8.7455930854088475,333,99.22665756852041,48.83430001137268,0.4930058000682361
48011,"Armstrong County, Texas",1929,974,955,31219,1400,237,84,5,4,1861,92,21,113,140,51,89,961,2,5.36,94.4,4.821150855365475,7.257646448937273,93,96.47485743908761,49.81855883877657,0.5049248315189218
48013,"Atascosa County, Texas",48139,24051,24088,23973,30432,2926,1143,175,96,47655,4087,4100,8187,6961,2892,4069,19739,158,4.08,99.8,2.937327322960593,14.46020897816739,1414,98.99457820062734,41.00417540871227,0.4996156962130497
48015,"Austin County, Texas",29292,14474,14818,30101,19933,3075,1028,196,144,29021,1920,2081,4001,3891,1423,2468,13281,152,23.77,97.2,4.670217124129455,13.283490372798033,1368,99.07483271883108,45.34002458009013,0.4941280895807729
48017,"Bailey County, Texas",7098,3678,3420,18662,4338,478,100,4,42,6920,1110,966,2076,1529,667,862,3058,236,6.25,92.3,2.056917441532826,21.541279233586927,146,97.49225133840518,43.082558467173854,0.518174133558749
48019,"Bandera County, Texas",21316,10570,10746,29177,16297,2588,914,118,255,21125,1852,1632,3484,3467,1726,1741,8459,32,3.57,97.8,6.03771814599362,16.264777631825858,1287,99.10395946706699,39.683805592043534,0.4958716457121411
48021,"Bastrop County, Texas",80306,40845,39461,25172,53159,7527,2192,512,545,78172,7080,7039,14119,10322,4783,5539,32819,317,20.45,99.4,4.045774910965557,12.853335989838866,3249,97.342664309018,40.86743207232336,0.5086170398226783
48023,"Baylor County, Texas",3602,1740,1862,30820,2559,515,90,15,15,3526,280,250,530,458,183,275,1414,20,4.95,97.4,3.331482509716824,12.715158245419211,120,97.89006107717934,39.25596890616324,0.4830649639089395
48025,"Bee County, Texas",32729,19883,12846,17504,22180,1263,490,137,157,25162,2486,3003,5489,4926,2116,2810,10003,99,7.11,96.9,2.395429130129243,15.05087231507226,784,76.87983134223471,30.56310916923829,0.6075040483974457
48027,"Bell County, Texas",336506,168147,168359,25017,202550,32377,12039,2913,1728,315444,19430,19271,38701,46671,20546,26125,151273,950,7.08,98.7,4.9568209779320425,13.869292078001582,16680,93.7409734150357,44.954027565630334,0.4996849981872537
48029,"Bexar County, Texas",1892004,932577,959427,26158,1197716,208782,84743,21220,12814,1861276,154836,141102,295938,304792,139182,165610,870205,8035,5.92,99,6.277840850230761,16.109479683975298,118777,98.37590195369566,45.993824537368845,0.4929043490394312
48031,"Blanco County, Texas",11089,5576,5513,31249,8208,1453,560,222,102,10978,1044,1117,2161,1180,535,645,4941,30,6.17,97.6,7.971864009378663,10.64117594012084,884,98.99900802597169,44.55766976282803,0.5028406528992695
48033,"Borden County, Texas",602,309,293,38923,417,116,46,0,0,602,8,19,27,17,6,11,253,0,3.69,96.6,7.641196013289036,2.823920265780731,46,100,42.0265780730897,0.5132890365448505
48035,"Bosque County, Texas",17955,8831,9124,25763,12842,1596,566,72,135,17584,1721,1526,3247,2737,1270,1467,7312,73,7.22,95.9,4.3052074631022,15.243664717348928,773,97.93372319688109,40.72403230297967,0.49184071289334447
48037,"Bowie County, Texas",93635,47173,46462,24761,63181,8340,2848,751,220,88253,6889,6257,13146,15750,6697,9053,36209,484,9.97,92,4.078603086452715,16.820633310193838,3819,94.25214930314519,38.67036898595611,0.5037966572328724
48039,"Brazoria County, Texas",345995,175156,170839,32343,224410,42804,16900,3790,3237,334943,22866,22827,45693,33043,14064,18979,160496,1081,28.53,92.4,6.915417852859146,9.55013800777468,23927,96.80573418691021,46.38679749707366,0.5062385294585182
48041,"Brazos County, Texas",214231,108478,105753,25337,111064,23839,11393,2515,6244,210275,15369,13504,28873,51704,24557,27147,101160,716,17.6,96.6,9.406668502691021,24.134695725641947,20152,98.15339516689929,47.220056854516855,0.5063599572424159
48043,"Brewster County, Texas",9220,4464,4756,26073,6737,1492,720,91,104,9135,942,822,1764,981,447,534,4108,17,2.72,95.9,9.92407809110629,10.63991323210412,915,99.07809110629067,44.55531453362256,0.4841648590021692
48045,"Briscoe County, Texas",1591,796,795,23199,1136,197,41,11,0,1591,149,136,285,220,80,140,708,2,5.62,95.5,3.268384663733501,13.827781269641735,52,100,44.50031426775613,0.5003142677561282
48047,"Brooks County, Texas",7251,3750,3501,13549,4173,412,181,0,20,6709,760,590,1350,2781,1285,1496,2374,1,4.52,99.3,2.772031443938767,38.35333057509309,201,92.52516894221486,32.740311681147425,0.517170045510964
48049,"Brown County, Texas",37787,18741,19046,24040,25710,3183,1043,192,151,36768,3000,2455,5455,5913,2436,3477,15034,47,4.69,96.1,3.6679281234286925,15.648238812289941,1386,97.30330536957155,39.7861698467727,0.49596422049911343
48051,"Burleson County, Texas",17596,8781,8815,27112,12293,1129,537,95,56,17413,1552,1819,3371,2620,1095,1525,7483,37,18.82,97.4,3.9099795408047284,14.889747669924983,688,98.95999090702432,42.5267106160491,0.4990338713343942
48053,"Burnet County, Texas",45017,22234,22783,29247,31237,4998,1974,299,250,44582,3281,3161,6442,5473,2544,2929,19310,166,6.66,98,5.604549392451741,12.157629340027102,2523,99.03369838061177,42.89490636870516,0.4939023035742053
48055,"Caldwell County, Texas",40544,20563,19981,23366,26065,2525,1029,76,96,38735,4498,3756,8254,6819,3159,3660,18009,283,16.09,100.2,2.9622138910812943,16.818764798737174,1201,95.53818074191003,44.41840962904499,0.5071773875295975
48057,"Calhoun County, Texas",21821,10976,10845,26909,14444,1587,597,98,61,21606,1940,1995,3935,3409,1501,1908,9479,77,14.91,92,3.4645524953026903,15.622565418633426,756,99.01471059988084,43.43980569176481,0.5030016956143165
48059,"Callahan County, Texas",13660,6650,7010,22205,9547,1080,357,69,23,13569,1560,1438,2998,2109,893,1216,5038,16,4.3,95.5,3.28696925329429,15.439238653001464,449,99.33382137628111,36.881405563689604,0.4868228404099561
48061,"Cameron County, Texas",420201,203657,216544,16085,243247,29742,8932,2129,1084,417802,58456,63075,121531,129912,60284,69628,151936,2334,2.85,96.6,2.890283459582438,30.916632754324716,12145,99.42908274849417,36.15793394113769,0.4846656719046361
48063,"Camp County, Texas",12670,6215,6455,21069,8177,964,274,64,61,12606,995,1043,2038,2191,1006,1185,5234,70,8.17,92.8,3.149171270718232,17.29281767955801,399,99.49486977111286,41.310181531176006,0.4905288082083662
48065,"Carson County, Texas",6033,2888,3145,31788,4056,753,376,10,46,5997,291,425,716,381,114,267,2805,0,5.58,94.2,7.160616608652412,6.315266036797613,432,99.40328194927896,46.49428145201392,0.47870048068954085
48067,"Cass County, Texas",30118,14599,15519,22145,21048,2248,782,130,56,29687,2264,2353,4617,5471,2423,3048,11849,399,7.11,91.9,3.214024835646457,18.165216813865463,968,98.5689620824756,39.341921774354205,0.48472674148349826
48069,"Castro County, Texas",7891,3958,3933,22292,4738,414,130,28,62,7798,1257,1027,2284,1232,630,602,3162,21,8.85,91.7,2.7879863135217335,15.612723355721709,220,98.821442149284,40.07096692434419,0.5015840831326828
48071,"Chambers County, Texas",39283,19679,19604,31412,24857,3492,1402,153,55,39077,3029,3329,6358,5031,2144,2887,16537,213,40.45,91.2,4.098464984853499,12.807066670060841,1610,99.47560013237278,42.0970903444238,0.5009546114095156
48073,"Cherokee County, Texas",51594,26307,25287,21102,33664,4229,1412,226,228,49083,4926,4750,9676,9090,4038,5052,20269,127,8.67,93.2,3.616699616234446,17.618327712524714,1866,95.13315501802535,39.28557584215219,0.5098848703337597
48075,"Childress County, Texas",7064,3933,3131,18694,4763,581,262,8,31,5745,577,410,987,1124,380,744,2482,0,4.19,98.4,4.261041902604757,15.911664779161947,301,81.32785956964892,35.13590033975085,0.556766704416761
48077,"Clay County, Texas",10369,5184,5185,27593,7446,953,313,33,33,10295,799,830,1629,1539,834,705,4252,43,5.16,96.2,3.655125855916675,14.842318449223647,379,99.28633426559938,41.00684733339763,0.49995177934227025
48079,"Cochran County, Texas",2932,1492,1440,19195,1820,125,51,16,0,2899,462,371,833,717,344,373,1178,6,4.39,93.6,2.2851296043656206,24.454297407912687,67,98.87448840381992,40.177353342428376,0.5088676671214188
48081,"Coke County, Texas",3238,1609,1629,24623,2406,336,116,29,14,3132,219,185,404,516,261,255,1411,6,3.6,96.9,4.910438542310068,15.935762816553428,159,96.72637430512663,43.576281655342804,0.496911673872761
48083,"Coleman County, Texas",8422,4282,4140,26436,6131,639,135,51,55,8382,1005,1012,2017,1701,544,1157,3274,25,3.83,96.4,2.8615530752790312,20.19710282593208,241,99.52505343148896,38.87437663262883,0.508430301591071
48085,"Collin County, Texas",914075,448915,465160,41609,594927,194541,84355,14854,9305,911167,52359,48985,101344,62439,27851,34588,468951,4607,7.13,93.4,11.871454749336761,6.830839920137844,108514,99.68186417963516,51.30333944151191,0.491113967672237
48087,"Collingsworth County, Texas",3026,1508,1518,21356,2062,221,86,4,11,2958,359,272,631,445,162,283,1354,0,4.62,97.1,3.3377395902181095,14.705882352941176,101,97.75280898876404,44.74553866490417,0.4983476536682089
48089,"Colorado County, Texas",20913,10487,10426,26689,14213,2137,380,109,62,20568,1522,1228,2750,2466,1022,1444,9396,27,22.11,97.6,2.634724812317697,11.791708506670492,551,98.35030842059963,44.92899153636494,0.5014584229904844
48091,"Comal County, Texas",129100,63732,65368,35841,89549,21295,8500,1377,1047,127955,8390,8296,16686,11827,5167,6660,58978,605,6.81,98.8,8.461657629744384,9.161115414407437,10924,99.1130906274206,45.683965917893104,0.4936638264910922
48093,"Comanche County, Texas",13492,6710,6782,22751,9415,1204,428,38,80,13279,1511,1379,2890,2407,1267,1140,5400,80,6.92,97.3,4.046842573376816,17.84020160094871,546,98.42128668840795,40.02371775867181,0.4973317521494219
48095,"Concho County, Texas",3858,2622,1236,17513,2868,237,66,13,7,2587,149,239,388,221,73,148,1017,0,4.55,97,2.2291342664593055,5.728356661482634,86,67.0554691550026,26.36080870917574,0.6796267496111975
48097,"Cooke County, Texas",39064,19358,19706,29067,26188,4098,1419,309,119,38565,2846,2942,5788,5313,2213,3100,18152,123,6.23,94.6,4.728138439483923,13.600757730903133,1847,98.72260905181241,46.46733565431087,0.49554577104239195
48099,"Coryell County, Texas",75818,37921,37897,21171,47102,5159,1783,236,63,58228,3113,3379,6492,8174,3281,4893,31018,435,5.75,98.4,2.746049750718827,10.781081009786595,2082,76.79970455564641,40.91112928328365,0.5001582737608483
48101,"Cottle County, Texas",1498,758,740,20566,1061,114,47,12,4,1498,130,119,249,364,154,210,636,19,4.31,98.2,4.205607476635514,24.299065420560748,63,100,42.456608811749,0.5060080106809078
48103,"Crane County, Texas",4836,2515,2321,24582,2889,213,101,25,0,4732,325,433,758,551,253,298,1987,27,3.11,98.7,2.6054590570719602,11.393713813068652,126,97.84946236559139,41.08767576509512,0.5200578990901572
48105,"Crockett County, Texas",3836,1903,1933,23296,2460,166,42,0,11,3757,398,429,827,787,296,491,1733,0,3.3,94.2,1.3816475495307612,20.51616266944734,53,97.9405630865485,45.177267987486964,0.49608967674661103
48107,"Crosby County, Texas",5895,2918,2977,20057,3723,387,86,5,5,5809,632,654,1286,1209,506,703,2465,75,4.31,94.1,1.6284987277353689,20.508905852417303,96,98.54113655640373,41.81509754028838,0.4949957591178965
48109,"Culberson County, Texas",2257,1162,1095,16763,1567,104,26,2,9,2248,230,223,453,660,302,358,961,44,2.73,94.8,1.639344262295082,29.24235711120957,37,99.60124058484715,42.57864421798848,0.5148427115640231
48111,"Dallam County, Texas",7207,3880,3327,25221,4378,367,158,0,16,7168,1113,987,2100,1139,552,587,3463,14,4.25,93.2,2.4143194116830857,15.80407936728181,174,99.45885944220896,48.050506452060496,0.5383654780074927
48113,"Dallas County, Texas",2552213,1257751,1294462,29810,1621762,311327,127313,35198,14777,2532552,296199,264655,560854,446611,199315,247296,1231172,20083,7.77,94.9,6.94644216607313,17.498970501286532,177288,99.229648936041,48.239390677815685,0.49280800622832027
48115,"Dawson County, Texas",13095,7274,5821,21360,8404,771,258,27,13,11336,811,1059,1870,2078,818,1260,4756,12,3.54,95.8,2.2756777395952654,15.868652157311951,298,86.56739213440244,36.31920580374189,0.5554791905307369
48117,"Deaf Smith County, Texas",18947,9499,9448,21209,11084,1186,260,104,23,18733,1755,1621,3376,3373,1487,1886,8278,29,9.11,93.4,2.0425397160500345,17.802290600095002,387,98.87053359370877,43.69029397793846,0.5013458595028236
48119,"Delta County, Texas",5172,2552,2620,22732,3591,454,132,7,31,5099,367,416,783,1168,504,664,1911,20,9.36,93.6,3.2869296210363497,22.583139984532096,170,98.58855375096674,36.94895591647332,0.4934261407579273
48121,"Denton County, Texas",781321,384390,396931,37928,506132,148204,55781,8654,6825,776789,48358,46635,94993,64503,28295,36208,411284,3322,7.72,94.9,9.120451133400996,8.2556337280068,71260,99.41995671433381,52.63956811604962,0.4919744893584071
48123,"DeWitt County, Texas",20474,10697,9777,28116,14430,1423,423,39,80,18636,1251,1136,2387,2975,1327,1648,7802,61,12.45,98.4,2.6472599394353815,14.530624206310442,542,91.02276057438702,38.106867246263555,0.5224675197811859
48125,"Dickens County, Texas",2224,1186,1038,24171,1607,158,67,0,19,2082,198,234,432,345,147,198,737,46,4.89,96.3,3.866906474820144,15.512589928057555,86,93.61510791366906,33.138489208633096,0.533273381294964
48127,"Dimmit County, Texas",10822,5284,5538,17939,6561,400,250,8,3,10713,1697,1268,2965,3237,1385,1852,3765,37,6.42,100.9,2.4117538347810017,29.911291812973573,261,98.99279245980411,34.79024209942709,0.4882646460912955
48129,"Donley County, Texas",3433,1714,1719,23212,2250,290,132,2,2,3365,335,189,524,468,185,283,1403,4,4.39,95.2,3.961549665016021,13.632391494319837,136,98.019225167492,40.86804544130498,0.49927177395863676
48131,"Duval County, Texas",11434,5891,5543,19085,7395,394,227,10,10,10935,1353,1434,2787,2731,1085,1646,3848,45,5.07,100,2.160223893650516,23.884904670281617,247,95.63582298408257,33.65401434318699,0.5152177715585097
48133,"Eastland County, Texas",18278,9337,8941,20433,12529,1032,458,56,48,18001,2295,1619,3914,3023,1534,1489,6847,44,5.38,96.2,3.074734653682022,16.539008644271803,562,98.48451690556954,37.46033482875588,0.5108326950432214
48135,"Ector County, Texas",155744,78798,76946,27728,92135,10084,2792,707,276,154456,17328,17480,34808,18882,8365,10517,71555,415,4.07,96.4,2.4238493938771315,12.123741524553113,3775,99.17300184918841,45.94398500102733,0.5059456544072324
48137,"Edwards County, Texas",2111,965,1146,28968,1605,308,23,0,0,2100,118,205,323,147,110,37,847,25,2.85,95.1,1.0895310279488395,6.963524396020843,23,99.4789199431549,40.12316437707248,0.4571293225959261
48139,"Ellis County, Texas",164092,80837,83255,28612,104692,16526,5282,717,617,162784,13834,12416,26250,17014,7927,9087,77018,311,6.27,94.7,4.031884552568072,10.368573726933672,6616,99.2028861857982,46.935865246325235,0.4926321819467128
48141,"El Paso County, Texas",834825,409199,425626,19950,503599,76291,26420,5578,3260,809637,87722,92638,180360,177980,77229,100751,351018,6709,3.68,98.5,4.223400113796305,21.319438205611956,35258,96.98284071511993,42.04689605605965,0.4901614110741772
48143,"Erath County, Texas",41016,20118,20898,23511,23213,4288,1557,362,239,40492,4160,3418,7578,8807,3388,5419,18784,76,7.35,96.6,5.261361419933684,21.47210844548469,2158,98.72244977569729,45.796762239126195,0.49049151550614395
48145,"Falls County, Texas",17289,8135,9154,17755,11990,1148,214,49,35,15547,1708,1273,2981,3917,1921,1996,5738,150,5.22,96.8,1.723639308230667,22.65602406154202,298,89.92422927873214,33.18873272022673,0.470530395048875
48147,"Fannin County, Texas",33787,17846,15941,23212,23829,2603,925,91,248,30882,2743,2426,5169,4580,2174,2406,13169,105,10.46,93.2,3.7410838488175924,13.555509515494125,1264,91.40201852783615,38.97652943439785,0.528191316186699
48149,"Fayette County, Texas",24963,12188,12775,30405,17974,2412,590,138,105,24504,1309,1592,2901,2220,923,1297,11463,117,24.32,98.6,3.3369386692304612,8.89316187958178,833,98.16127869246485,45.919961543083765,0.48824259904658895
48151,"Fisher County, Texas",3875,1867,2008,27750,2743,368,113,9,3,3853,337,338,675,666,254,412,1704,10,4.72,97.3,3.225806451612903,17.18709677419355,125,99.43225806451613,43.9741935483871,0.48180645161290325
48153,"Floyd County, Texas",5953,2911,3042,24347,3829,489,148,12,16,5908,766,635,1401,1076,468,608,2387,8,5.22,93.1,2.956492524777423,18.074920208298337,176,99.24407861582395,40.097429867293805,0.4889971442969931
48155,"Foard County, Texas",1414,749,665,26034,1040,133,41,0,0,1377,97,71,168,78,41,37,587,0,4.31,97.9,2.8995756718528995,5.516265912305516,41,97.38330975954739,41.51343705799151,0.5297029702970297
48157,"Fort Bend County, Texas",711421,349697,361724,38382,453117,129438,57879,9728,10090,706155,43137,41336,84473,56959,25612,31347,333432,3333,28.24,95,10.92138129180893,8.006370348921385,77697,99.25979131906423,46.86845060800848,0.4915471991970999
48159,"Franklin County, Texas",10639,5409,5230,23642,7185,1031,329,20,43,10535,1120,1030,2150,1582,858,724,4160,40,9.56,93.1,3.6845568192499294,14.86981859197293,392,99.02246451734186,39.10141930632578,0.5084124447786446
48161,"Freestone County, Texas",19646,10224,9422,24060,13711,1200,333,35,39,17995,1527,1606,3133,3122,1401,1721,7341,35,6.37,94.4,2.0716685330347144,15.891275577725745,407,91.59625369031863,37.36638501476128,0.5204112796498015
48163,"Frio County, Texas",19110,11363,7747,16833,11490,648,159,20,0,15933,1871,1922,3793,3227,1566,1661,6739,15,5.14,101.6,0.9366823652537938,16.886446886446887,179,83.37519623233909,35.264259549973836,0.5946101517530089
48165,"Gaines County, Texas",19889,10082,9807,22656,10902,798,380,32,8,19774,3169,3313,6482,2180,925,1255,8058,6,2.94,92.9,2.1117200462567247,10.96083262104681,420,99.42179093971542,40.51485745889688,0.5069133691990547
48167,"Galveston County, Texas",321184,158564,162620,33870,214058,41264,14273,4329,3225,316262,23611,22587,46198,43721,20132,23589,146282,1506,35.32,90.5,6.795793065657069,13.612446448141876,21827,98.46754508319219,45.54460994321012,0.493685862309455
48169,"Garza County, Texas",6739,4369,2370,20635,5062,412,83,16,5,4797,325,362,687,646,344,302,2380,63,3.47,96.8,1.543255675916308,9.585991986941682,104,71.18266805163971,35.31681258346936,0.6483157738536874
48171,"Gillespie County, Texas",25939,12655,13284,32557,19001,4621,1136,428,170,25538,2577,2058,4635,3175,1625,1550,11610,167,5.03,96,6.684914607348008,12.240255985196036,1734,98.45406530706659,44.7588573190948,0.4878753999768688
48173,"Glasscock County, Texas",1420,792,628,32885,936,187,47,0,3,1420,180,91,271,165,102,63,665,0,3.62,95.9,3.5211267605633805,11.619718309859154,50,100,46.83098591549296,0.5577464788732395
48175,"Goliad County, Texas",7510,3778,3732,30075,5213,603,265,18,34,7385,360,447,807,1215,537,678,2934,0,10.3,97.2,4.2210386151797605,16.178428761651134,317,98.33555259653795,39.06790945406125,0.5030625832223702
48177,"Gonzales County, Texas",20558,10400,10158,23635,13194,1278,350,47,68,20264,2077,2234,4311,3469,1467,2002,8855,105,14.98,98.8,2.2618931802704543,16.874209553458506,465,98.56989979569997,43.073256153322305,0.5058857865551124
48179,"Gray County, Texas",22962,12143,10819,23457,15296,1508,346,73,32,21392,2115,2074,4189,3169,1445,1724,9300,135,5.19,94.2,1.9641146241616585,13.801062625206864,451,93.16261649682083,40.501698458322444,0.5288302412681822
48181,"Grayson County, Texas",126146,61556,64590,26535,85080,11483,4191,801,742,124699,10627,10219,20846,17605,7682,9923,55939,482,9.24,93.5,4.545526612020992,13.956050925118513,5734,98.85291646187751,44.34464826470915,0.4879742520571401
48183,"Gregg County, Texas",123402,60366,63036,25144,79339,11233,3545,867,511,121202,12507,10975,23482,21028,9028,12000,54452,543,6.54,93.4,3.989400495940098,17.040242459603572,4923,98.21720879726422,44.12570298698562,0.48918169883794427
48185,"Grimes County, Texas",27358,15070,12288,23585,18776,1703,763,64,47,23840,1827,1999,3826,4444,1933,2511,10288,79,19.43,95.7,3.194677973536077,16.243877476423716,874,87.14087287082388,37.60508809123474,0.5508443599678339
48187,"Guadalupe County, Texas",150889,74611,76278,29300,98048,17245,7599,723,729,148797,9865,9531,19396,15774,6951,8823,70172,561,11.75,99.5,5.998449191127253,10.454042375521079,9051,98.61355035821035,46.505709495059286,0.4944760718143801
48189,"Hale County, Texas",34527,17906,16621,19205,20977,2324,820,48,190,32742,3084,3231,6315,6358,2713,3645,13775,51,5.24,92.5,3.0642685434587422,18.414574101427867,1058,94.8301329394387,39.89631303038202,0.5186086251339531
48191,"Hall County, Texas",3102,1552,1550,20022,2079,167,74,17,6,3039,366,428,794,673,318,355,1100,10,5.45,98.1,3.127014829142489,21.695680206318503,97,97.96905222437137,35.46099290780142,0.5003223726627982
48193,"Hamilton County, Texas",8220,4062,4158,26522,5868,982,305,20,29,7976,867,536,1403,1273,640,633,3530,0,6.73,97.5,4.306569343065694,15.48661800486618,354,97.0316301703163,42.94403892944039,0.49416058394160584
48195,"Hansford County, Texas",5532,2760,2772,21989,3408,426,98,4,15,5453,459,544,1003,1017,447,570,2332,41,3.93,94.7,2.1149674620390457,18.383947939262473,117,98.57194504699928,42.15473608098337,0.49891540130151846
48197,"Hardeman County, Texas",3990,1950,2040,21517,2797,301,77,16,10,3979,389,307,696,548,221,327,1647,34,4.26,98.2,2.581453634085213,13.734335839598998,103,99.72431077694236,41.278195488721806,0.48872180451127817
48199,"Hardin County, Texas",55993,27365,28628,29693,37590,4357,1558,172,213,55503,4271,4127,8398,6669,2681,3988,23904,213,39.94,92.8,3.4700766167199473,11.910417373600271,1943,99.12489061132642,42.69105066704767,0.48872180451127817
48201,"Harris County, Texas",4525519,2251060,2274459,30856,2864864,559393,218604,58022,38222,4504029,501654,450958,952612,751985,337232,414753,2140881,28522,35.88,94.5,6.957168890463171,16.616547184974806,314848,99.52513733783904,47.30686137877225,0.49741477165381476
48203,"Harrison County, Texas",66606,32517,34089,25123,43624,5859,1772,356,217,65852,5457,5073,10530,11605,5069,6536,27230,450,8.12,93.2,3.5207038404948503,17.423355253280484,2345,98.86796985256584,40.88220280455214,0.48819926132780833
48205,"Hartley County, Texas",5821,3524,2297,20676,4340,561,118,40,20,4283,271,309,580,347,146,201,2034,8,5.36,93.6,3.057893832674798,5.9611750558323315,178,73.57842295138292,34.94244975090191,0.6053942621542691
48207,"Haskell County, Texas",5806,3247,2559,21120,4333,377,118,24,13,4986,570,428,998,958,340,618,2124,15,4.12,97.8,2.669652084050982,16.500172235618326,155,85.87667929727867,36.58284533241474,0.5592490527040992
48209,"Hays County, Texas",194843,96973,97870,29253,115173,27823,10540,1643,2113,193130,14609,13022,27631,28737,12371,16366,97804,1160,9.75,99,7.337189429438061,14.74879774998332,14296,99.1208306174715,50.19631190240347,0.49769814671299456
48211,"Hemphill County, Texas",4152,1976,2176,29470,2488,482,65,6,12,4101,451,642,1093,363,151,212,1886,0,4.43,96.1,1.9990366088631986,8.742774566473988,83,98.77167630057804,45.42389210019268,0.47591522157996147
48213,"Henderson County, Texas",79687,38840,40847,24315,55862,6711,2919,342,142,78709,7972,7117,15089,14023,6339,7684,30629,163,5.34,94.5,4.270458167580659,17.597600612396,3403,98.77269818163565,38.43663332789539,0.4874069798085008
48215,"Hidalgo County, Texas",839539,410383,429156,15883,465095,59522,17546,3963,1962,831048,124795,137849,262644,263891,119497,144394,306998,12570,3.5,99.7,2.7957009739869143,31.432845883276418,23471,98.98861160708437,36.56744951693727,0.48881945925085074
48217,"Hill County, Texas",35098,17374,17724,23342,23911,2628,1013,193,87,34422,2921,3146,6067,5967,2745,3222,14233,207,6.58,94.9,3.683970596615192,17.000968716166163,1293,98.07396432845177,40.55216821471309,0.49501396090945354
48219,"Hockley County, Texas",23273,11505,11768,22673,14313,1313,489,82,68,23073,2128,2113,4241,3354,1467,1887,10121,66,4.21,93.5,2.7456709491685642,14.411549864650024,639,99.14063507068276,43.488162248098654,0.4943496755897392
48221,"Hood County, Texas",55418,27199,28219,32578,39783,7260,2514,486,201,54684,4312,4279,8591,6722,2462,4260,22581,182,6.21,95.2,5.776101627630012,12.129632971236783,3201,98.67552058897832,40.746688801472445,0.4907972139016204
48223,"Hopkins County, Texas",35929,17643,18286,24236,23983,2796,1082,185,96,35468,3528,3563,7091,6312,2657,3655,15122,90,10.12,93.5,3.793592919368755,17.56798129644577,1363,98.71691391355172,42.08856355590192,0.49105179659884773
48225,"Houston County, Texas",22849,12274,10575,17884,16647,1830,438,82,60,19679,1367,1450,2817,4833,1916,2917,7529,97,10.23,93.6,2.538404306534203,21.151910368068624,580,86.12630749704583,32.95111383430347,0.5371788699724277
48227,"Howard County, Texas",36491,20588,15903,22994,24729,2271,595,246,70,31487,2606,2537,5143,4344,1811,2533,14103,83,3.67,96.5,2.4965059877778084,11.90430517113809,911,86.28702967855088,38.647885780055354,0.5641939108273273
48229,"Hudspeth County, Texas",3702,1841,1861,12543,2455,169,18,0,0,3116,305,593,898,1109,411,698,1069,20,2.35,95.6,0.4862236628849271,29.956780118854674,18,84.17071853052404,28.876283090221502,0.49729875742841706
48231,"Hunt County, Texas",90322,44432,45890,23942,59772,7264,3187,271,682,89490,7941,7952,15893,16430,7566,8864,37578,259,9.61,93.8,4.583600894577179,18.190474081619097,4140,99.07885122118643,41.60448174309692,0.49192887668563584
48233,"Hutchinson County, Texas",21704,10838,10866,25154,14177,1412,330,136,68,21569,1749,1764,3513,3541,1293,2248,9018,31,4.96,95.9,2.4603759675635826,16.314964983413194,534,99.37799483966089,41.54994471065241,0.49935495761150017
48235,"Irion County, Texas",1592,853,739,32307,1051,95,37,8,16,1588,146,142,288,215,119,96,722,0,3.22,96,3.8316582914572863,13.50502512562814,61,99.74874371859296,45.35175879396985,0.5358040201005025
48237,"Jack County, Texas",8839,4973,3866,25553,6105,415,207,27,47,7666,612,918,1530,1395,587,808,3098,6,5.44,95.1,3.179092657540446,15.782328317682996,281,86.72926801674397,35.049213711958366,0.5626202059056454
48239,"Jackson County, Texas",14756,7214,7542,26809,9757,1301,384,68,30,14510,897,1231,2128,1962,737,1225,6676,17,15.27,94.7,3.2664678774735703,13.296286256438059,482,98.33288153971266,45.24261317430198,0.4888858769314177
48241,"Jasper County, Texas",35444,17420,18024,21402,23929,1653,892,124,114,34511,3127,3165,6292,5772,2320,3452,12365,668,28.43,93.1,3.188127750818192,16.28484369709965,1130,97.36767859158108,34.88601737952827,0.491479516984539
48243,"Jeff Davis County, Texas",2236,1070,1166,25167,1768,326,235,29,52,2173,142,287,429,145,81,64,911,0,4.21,92.4,14.132379248658319,6.48479427549195,316,97.1824686940966,40.742397137745975,0.4785330948121646
48245,"Jefferson County, Texas",254574,130404,124170,25370,168757,21920,7168,1580,1193,240730,25147,24935,50082,46222,19778,26444,103651,825,46.04,91.4,3.904954944338385,18.156606723388876,9941,94.56189555885518,40.71546976517634,0.512243984067501
48247,"Jim Hogg County, Texas",5262,2623,2639,17761,3190,279,55,26,0,5235,526,461,987,1353,626,727,1646,0,4.76,99.9,1.5393386545039909,25.712656784492587,81,99.48688711516533,31.280881793994677,0.4984796655264158
48249,"Jim Wells County, Texas",41318,20134,21184,20631,25713,2246,493,64,95,40901,3673,4125,7798,9382,4080,5302,16022,147,4.49,99,1.5780047436952418,22.706810591025704,652,98.99075463478387,38.777288348903625,0.4872936734595092
48251,"Johnson County, Texas",160173,79887,80286,26574,104312,13984,3966,796,585,157616,13751,13614,27365,17201,7695,9506,71798,479,6.71,94.4,3.3382655004276627,10.739013441716144,5347,98.40360110630381,44.825282663120504,0.4987544717274447
48253,"Jones County, Texas",19969,12658,7311,17960,14706,1315,256,32,0,12740,804,1175,1979,2021,789,1232,4976,42,4.87,97,1.4422354649707045,10.120687064950674,288,63.79888827682908,24.91862386699384,0.6338825179027493
48255,"Karnes County, Texas",15051,8960,6091,27011,10281,1031,252,79,47,12462,900,983,1883,2377,962,1415,5388,36,9.07,98,2.5114610324895357,15.79297056673975,378,82.79848515048835,35.79828582818418,0.5953092817752973
48257,"Kaufman County, Texas",114852,56347,58505,26631,73684,10175,4232,380,434,113768,9006,8400,17406,14073,5931,8142,52377,672,5.82,93.8,4.393480305088287,12.253160589280117,5046,99.05617664472538,45.60390763765542,0.49060530073485875
48259,"Kendall County, Texas",40306,19568,20738,39517,27557,7464,2225,700,360,39829,1759,1812,3571,2255,896,1359,18187,192,3.8,96.9,8.150151342231926,5.594700540862402,3285,98.8165533667444,45.12231429563837,0.4854860318562993
48261,"Kenedy County, Texas",564,280,284,13705,341,11,11,0,0,564,131,96,227,140,61,79,179,0,3.31,97,1.950354609929078,24.822695035460992,11,100,31.73758865248227,0.49645390070921985
48263,"Kent County, Texas",680,311,369,27515,496,86,25,7,0,633,30,15,45,113,33,80,300,5,3.53,98,4.705882352941177,16.61764705882353,32,93.08823529411765,44.11764705882353,0.4573529411764706
48265,"Kerr County, Texas",50761,24563,26198,28484,36657,6047,2314,697,441,49833,3909,4031,7940,6760,3007,3753,20950,84,3.74,95.9,6.800496444120486,13.31731053367743,3452,98.17182482614605,41.271842556293215,0.4838951163294655
48267,"Kimble County, Texas",4432,2140,2292,26982,3330,388,163,77,14,4373,474,476,950,965,504,461,1953,23,3.16,96.4,5.731046931407942,21.77346570397112,254,98.6687725631769,44.06588447653429,0.48285198555956677
48269,"King County, Texas",289,150,139,29918,207,30,7,0,4,289,63,15,78,10,5,5,173,2,3.83,98.2,3.8062283737024223,3.4602076124567476,11,100,59.86159169550173,0.5190311418685121
48271,"Kinney County, Texas",3631,2234,1397,21395,2662,237,59,9,0,3311,366,231,597,354,137,217,1367,77,3.56,97.4,1.872762324428532,9.749380335995593,68,91.18700082621868,37.64803084549711,0.615257504819609
48273,"Kleberg County, Texas",31540,16290,15250,19806,17405,2897,1027,26,246,30869,2874,2785,5659,7003,3266,3737,13794,144,3.6,96.1,4.11857958148383,22.203551046290425,1299,97.87254280279011,43.734939759036145,0.5164870006341155
48275,"Knox County, Texas",3753,1879,1874,21046,2452,383,109,7,3,3608,324,292,616,529,181,348,1472,2,4.41,97.8,3.170796695976552,14.09539035438316,119,96.13642419397816,39.22195576871836,0.500666133759659
48277,"Lamar County, Texas",49401,23876,25525,23625,33509,4006,1455,166,95,48753,4585,4236,8821,8644,3805,4839,20861,544,9.99,93,3.473613894455578,17.497621505637536,1716,98.68828566223355,42.2278901236817,0.48331005445233904
48279,"Lamb County, Texas",13368,6832,6536,21760,8451,945,323,86,35,13156,1346,1344,2690,2686,1220,1466,5558,176,5.09,92.3,3.3213644524236985,20.09275882704967,444,98.41412327947337,41.576900059844405,0.5110712148414124
48281,"Lampasas County, Texas",20473,10144,10329,26405,14175,1871,778,109,96,20019,1791,1488,3279,2429,1169,1260,8748,211,4.33,97.4,4.801445806672202,11.864406779661017,983,97.78244517168955,42.72944854198212,0.49548185414936746
48283,"La Salle County, Texas",7418,4347,3071,26268,5094,548,222,0,0,6511,1130,781,1911,535,291,244,2619,6,5.78,101,2.992720409813966,7.212186573200324,222,87.77298463197627,35.30601240226476,0.5860070099757347
48285,"Lavaca County, Texas",19859,9596,10263,29946,13710,1742,547,55,42,19394,1250,1187,2437,2030,831,1199,8781,52,17.36,98.1,3.2428621783574196,10.222065562213606,644,97.65849237121708,44.21672793192003,0.4832066065763634
48287,"Lee County, Texas",16850,8476,8374,26740,11512,1414,493,78,46,16362,1114,1463,2577,2251,987,1264,7812,53,21.29,98,3.6617210682492582,13.359050445103858,617,97.10385756676558,46.362017804154306,0.503026706231454
48289,"Leon County, Texas",16966,8485,8481,27096,11682,1381,424,36,14,16865,1563,1714,3277,2741,1239,1502,6432,290,7.15,93.8,2.7938229399976424,16.15584109395261,474,99.40469173641401,37.911116350347754,0.5001178828244724
48291,"Liberty County, Texas",79884,39491,40393,22153,52195,3474,1204,132,55,73111,7546,7574,15120,11781,5131,6650,28045,229,42.37,93.1,1.741274848530369,14.74763406940063,1391,91.52145611136147,35.10715537529418,0.49435431375494465
48293,"Limestone County, Texas",23480,12071,11409,21093,16048,1572,429,106,110,22556,2710,1984,4694,4671,2407,2264,8640,79,5.76,94.4,2.7470187393526406,19.89352640545145,645,96.06473594548552,36.797274275979554,0.5140971039182283
48295,"Lipscomb County, Texas",3495,1880,1615,29995,2266,314,89,16,7,3447,306,315,621,361,156,205,1612,4,3.61,95.8,3.2045779685264666,10.32904148783977,112,98.62660944206009,46.123032904148786,0.5379113018597997
48297,"Live Oak County, Texas",12043,6548,5495,22847,8735,722,177,45,40,10509,924,1063,1987,1703,670,1033,4290,103,4.06,98.2,2.1755376567300506,14.14099476874533,262,87.26231005563398,35.62235323424396,0.543718342605663
48299,"Llano County, Texas",20195,9848,10347,35680,16163,2981,872,249,195,19985,1716,1666,3382,2495,1150,1345,7425,72,7.22,98.1,6.516464471403813,12.354543203763308,1316,98.96013864818025,36.76652636791285,0.48764545679623666
48301,"Loving County, Texas",74,39,35,35530,64,3,0,0,0,74,7,11,18,12,5,7,39,0,4.71,98,0,16.216216216216218,0,100,52.7027027027027,0.527027027027027
48303,"Lubbock County, Texas",298042,147080,150962,26196,174904,31162,12856,2732,3387,293628,22112,21519,43631,53614,24689,28925,143390,847,4.53,93.4,6.366552365102905,17.988739842035685,18975,98.51900067775682,48.11066896611887,0.49348749505103306
48305,"Lynn County, Texas",5785,2957,2828,26758,3809,523,98,12,13,5754,621,569,1190,1032,477,555,2358,0,3.5,94.8,2.12618841832325,17.83923941227312,123,99.46413137424373,40.76058772687986,0.5111495246326707
48307,"McCulloch County, Texas",8145,4171,3974,23398,5832,671,213,24,24,8003,659,810,1469,1296,468,828,3450,0,3.42,95.9,3.2044198895027622,15.911602209944752,261,98.25659914057704,42.3572744014733,0.5120933087783917
48309,"McLennan County, Texas",245720,119894,125826,24273,148119,21969,8159,1520,2275,241367,18952,18841,37793,45691,20746,24945,110714,796,6.3,96.5,4.864886863096207,18.594741982744587,11954,98.22847143089696,45.0569754191763,0.4879293504802214
48311,"McMullen County, Texas",600,321,279,33472,401,49,25,9,0,600,30,35,65,42,39,3,179,13,4.28,100,5.666666666666667,7,34,100,29.833333333333332,0.535
48313,"Madison County, Texas",13979,8649,5330,17436,9671,921,240,63,38,9894,706,878,1584,1516,786,730,4188,9,12.14,94.7,2.4393733457328852,10.84483868660133,341,70.77759496387438,29.95922455111238,0.618713784963159
48315,"Marion County, Texas",10140,5025,5115,25933,7653,778,241,12,47,9997,949,670,1619,2225,947,1278,3603,53,6.39,92.9,2.9585798816568047,21.942800788954635,300,98.58974358974359,35.532544378698226,0.49556213017751477
48317,"Martin County, Texas",5547,2856,2691,28560,3257,448,198,18,7,5477,381,416,797,382,248,134,2521,19,3.6,96.1,4.020191094285199,6.8866053722733005,223,98.73805660717505,45.44798990445286,0.5148729042725798
48319,"Mason County, Texas",4122,2200,1922,24519,3071,424,150,33,15,4111,538,290,828,518,243,275,2089,0,3.54,96.8,4.8034934497816595,12.566715186802522,198,99.73313925278991,50.67928190198933,0.5337214944201844
48321,"Matagorda County, Texas",36744,18249,18495,23294,23972,2547,743,153,84,36298,3742,3805,7547,7464,3253,4211,15572,89,18.07,92.2,2.6671021119094274,20.31352057478772,980,98.78619638580449,42.37970825168735,0.49665251469627697
48323,"Maverick County, Texas",57471,28522,28949,16658,32205,2808,752,246,1,57072,8126,8535,16661,13973,6440,7533,20680,73,4.45,99.6,1.7382679960327818,24.313131840406466,999,99.3057368063893,35.98336552348141,0.4962850829113814
48325,"Medina County, Texas",48548,25073,23475,25572,32337,4251,1981,128,119,46087,3247,2627,5874,5850,2618,3232,20410,90,4.26,100.8,4.589272472604433,12.049929966219,2228,94.93079014583505,42.040866771030736,0.5164579385350581
48327,"Menard County, Texas",2123,1159,964,23613,1638,170,68,20,0,2070,428,201,629,201,53,148,993,0,4.96,96.3,4.1450777202072535,9.467734338200659,88,97.50353273669336,46.77343382006595,0.54592557701366
48329,"Midland County, Texas",159883,80338,79545,38545,99639,19394,5181,1621,537,158620,15659,14996,30655,13714,5584,8130,79698,1237,3.88,96.4,4.590231606862519,8.57752231319152,7339,99.21004734712258,49.847701131452375,0.5024799384549952
48331,"Milam County, Texas",24479,12194,12285,22911,16592,1860,457,97,79,23977,1418,1632,3050,3845,1678,2167,9389,28,12.11,97.7,2.585889946484742,15.707340986151396,633,97.9492626332775,38.35532497242534,0.49814126394052044
48333,"Mills County, Texas",4887,2275,2612,24858,3346,502,162,49,56,4716,362,429,791,703,310,393,2003,8,4.3,96.1,5.463474524248005,14.38510333537958,267,96.50092081031308,40.98629015756087,0.4655207693881727
48335,"Mitchell County, Texas",8774,5417,3357,19741,5961,545,129,0,31,6353,728,461,1189,496,231,265,2737,1,3.74,97,1.8235696375655346,5.653065876453157,160,72.4071119215865,31.194438112605425,0.6173922954182813
48337,"Montague County, Texas",19406,9512,9894,26278,13601,1461,555,121,71,19080,1689,1912,3601,2948,1269,1679,7801,25,5.76,94.9,3.8493249510460683,15.191177986189839,747,98.32010718334536,40.19890755436463,0.49015768319076575
48339,"Montgomery County, Texas",535187,265034,270153,38012,348041,77686,28457,6438,4782,532016,39280,37976,77256,54912,24017,30895,245493,1906,30.8,95,7.413670361948253,10.260338909577401,39677,99.40749681886892,45.870508812807486,0.49521755946986756
48341,"Moore County, Texas",22016,11466,10550,21372,12664,1327,316,46,3,21821,1601,1840,3441,3677,1781,1896,10514,89,4.85,94.9,1.6578851744186047,16.701489825581394,365,99.11428052325581,47.7561773255814,0.5208030523255814
48343,"Morris County, Texas",12530,6022,6508,22803,8873,893,439,90,0,12381,851,1023,1874,1945,842,1103,4912,89,7.53,92.2,4.221867517956904,15.522745411013567,529,98.81085395051875,39.20191540303272,0.48060654429369515
48345,"Motley County, Texas",1114,575,539,25908,742,92,18,0,6,1114,142,86,228,136,83,53,507,0,5.77,97,2.154398563734291,12.208258527827649,24,100,45.511669658886895,0.5161579892280072
48347,"Nacogdoches County, Texas",65411,31297,34114,22589,37299,5756,2452,528,669,64597,6301,6801,13102,14894,6637,8257,27528,131,11.27,92.9,5.5785724113681185,22.769870511076117,3649,98.75556099127058,42.08466465884943,0.47846692452339823
48349,"Navarro County, Texas",48239,23726,24513,22152,31447,3170,1346,275,119,47450,4125,4900,9025,8913,3999,4914,19745,66,6.02,94.9,3.6070399469309065,18.476751176434007,1740,98.36439395509858,40.93161135181077,0.4918426998901304
48351,"Newton County, Texas",14187,7436,6751,20800,9862,668,147,30,27,13986,1396,654,2050,2202,1161,1041,4889,148,25.41,92.4,1.4379361387185452,15.521251850285473,204,98.58320998096849,34.46112638330866,0.5241418199760344
48353,"Nolan County, Texas",14990,7629,7361,23686,9757,948,303,36,10,14797,1411,1060,2471,2445,1144,1301,6217,107,4.56,95.7,2.3282188125416945,16.31087391594396,349,98.71247498332221,41.4743162108072,0.508939292861908
48355,"Nueces County, Texas",358484,176836,181648,26780,231828,31165,11955,2797,2472,353545,32389,30280,62669,58409,25060,33349,163105,1598,4.35,95.9,4.8046774751453345,16.293335267403844,17224,98.62225371285747,45.49854386806663,0.4932884033875989
48357,"Ochiltree County, Texas",10484,5353,5131,24157,6192,849,223,31,28,10419,1288,1152,2440,1351,544,807,4565,72,4,95.6,2.689813048454788,12.886302937809996,282,99.38000763067531,43.542541014879816,0.5105875619992369
48359,"Oldham County, Texas",2083,1208,875,25461,1159,227,68,6,6,1526,87,63,150,170,50,120,769,4,7.72,93.9,3.8406144983197312,8.161305808929429,80,73.25972155544888,36.917906865098416,0.5799327892462794
48361,"Orange County, Texas",83909,41505,42404,27938,55998,6754,1561,315,159,83143,6453,6298,12751,11759,5020,6739,35958,401,41.1,91.8,2.4252463978834213,14.013991347769608,2035,99.08710626988761,42.85356755532779,0.4946430061137661
48363,"Palo Pinto County, Texas",28109,13904,14205,24840,19131,2239,741,103,87,27826,2858,2909,5767,5048,2348,2700,11441,245,6.28,96.2,3.312106442776335,17.958660927105196,931,98.99320502330214,40.70226617809242,0.49464584296844427
48365,"Panola County, Texas",23574,11635,11939,26205,15842,1599,497,72,157,23336,2093,1800,3893,3510,1339,2171,9735,77,10.32,93.3,3.079664036650547,14.889284805293968,726,98.99041316704844,41.295495036905066,0.4935522185458556
48367,"Parker County, Texas",125963,62545,63418,33367,84550,16056,5181,720,826,124149,8116,8761,16877,11339,4431,6908,57752,610,6.74,95,5.3404571183601535,9.001849749529624,6727,98.55989457221565,45.84838404928431,0.496534696696649
48369,"Parmer County, Texas",9871,5065,4806,21876,6073,747,174,21,35,9784,1011,925,1936,1676,697,979,4352,191,9.38,92.8,2.3300577449093303,16.979029480295814,230,99.11863033127342,44.088744808023506,0.5131192381724242
48371,"Pecos County, Texas",15804,9058,6746,19088,10631,696,311,12,6,13716,1401,1224,2625,1580,711,869,6009,61,2.38,95.6,2.081751455327765,9.99746899519109,329,86.78815489749431,38.02201974183751,0.5731460389774741
48373,"Polk County, Texas",46974,25288,21686,23023,33538,3086,798,154,73,43531,4335,4085,8420,8120,3574,4546,17736,594,25.6,93,2.1820581598330993,17.286158300336357,1025,92.67041342018989,37.75705709541448,0.5383403584961893
48375,"Potter County, Texas",121230,62467,58763,21941,76469,7824,2325,709,448,114375,12815,12189,25004,24720,10810,13910,52218,272,6.74,94.8,2.8722263466138744,20.390992328631526,3482,94.3454590447909,43.073496659242764,0.5152767466798647
48377,"Presidio County, Texas",7191,3558,3633,15329,4517,608,250,56,0,7191,1242,1370,2612,1893,859,1034,2382,12,2.93,96.4,4.25531914893617,26.324572382144346,306,100,33.12473925740509,0.4947851481017939
48379,"Rains County, Texas",11246,5722,5524,23976,8196,601,217,53,13,11180,1459,948,2407,1462,693,769,4492,77,10.41,93.4,2.516450293437667,13.000177841010137,283,99.4131246665481,39.94309087675618,0.5088031300017785
48381,"Randall County, Texas",130552,64149,66403,32922,85467,17818,6172,1393,1066,129640,7027,7192,14219,12247,5353,6894,67539,451,7.12,93,6.611158771983577,9.380936331883081,8631,99.30142778356517,51.73340890985967,0.4913674244745389
48383,"Reagan County, Texas",3735,1986,1749,25273,2352,179,63,12,5,3698,590,506,1096,667,379,288,1711,21,3.59,95.9,2.14190093708166,17.85809906291834,80,99.00937081659973,45.809906291834004,0.5317269076305221
48385,"Real County, Texas",3358,1553,1805,20873,2418,391,129,0,10,3262,369,539,908,657,282,375,1250,62,3.39,96.2,4.1393686718284695,19.565217391304348,139,97.141155449672425,37.22453841572364,0.46247766527695056
48387,"Red River County, Texas",12353,5803,6550,21177,8888,934,225,12,53,12139,1076,904,1980,1995,816,1179,4708,81,9.83,93,2.3476078685339594,16.149923095604308,290,98.26762729701287,38.11219946571683,0.46976442969319193
48389,"Reeves County, Texas",14791,8938,5853,18992,9773,683,147,72,31,12341,1257,1179,2436,1617,896,721,5023,66,2.78,98,1.6902170238658645,10.932323710364411,250,83.43587316611453,33.959840443512945,0.6042863903725239
48391,"Refugio County, Texas",7293,3617,3676,23959,4936,438,125,11,22,7116,523,650,1173,1181,625,556,2881,7,9.32,94.9,2.166460989990402,16.19361031125737,158,97.57301522007404,39.50363362128068,0.4959550253667901
48393,"Roberts County, Texas",889,404,485,34555,597,152,25,3,6,889,17,38,55,29,7,22,394,0,4.38,95.6,3.824521934758155,3.262092238470191,34,100,44.31946006749156,0.4544431946006749
48395,"Robertson County, Texas",16727,8291,8436,23337,11278,1170,378,71,77,16522,1337,1271,2608,2505,1229,1276,6988,63,7.92,95.7,3.1446164883123093,14.975787648711664,526,98.7744365397262,41.77676809947988,0.49566569020147067
48397,"Rockwall County, Texas",90414,44463,45951,38933,58304,15356,6012,1145,790,89661,4951,4668,9619,5222,2345,2877,43371,654,7.39,93.7,8.78956798725861,5.775654212843143,7947,99.16716437719822,47.96934103125622,0.49177118587829316
48399,"Runnels County, Texas",10266,5050,5216,22190,6993,1063,205,47,23,10041,1003,857,1860,1624,649,975,4123,7,3.69,97.1,2.6787453730761737,15.819209039548022,275,97.8082992402104,40.161698811611146,0.4919150594194428
48401,"Rusk County, Texas",53026,27810,25216,23521,36180,3855,1491,155,102,48169,5081,4739,9820,7576,3320,4256,20069,79,7.34,93.2,3.2964960585373215,14.287330743408894,1748,90.84034247350357,37.847471051936786,0.5244596990155773
48403,"Sabine County, Texas",10429,5232,5197,20876,8040,749,402,5,3,10336,1240,994,2234,2057,905,1152,3178,15,19.29,93,3.9313452871799788,19.72384696519321,410,99.10825582510307,30.472720299165786,0.501678013232333
48405,"San Augustine County, Texas",8403,4154,4249,21066,6140,531,170,31,12,8152,790,726,1516,1982,952,1030,2440,29,16.48,93.2,2.534808996786862,23.58681423301202,213,97.01297155777698,29.03724860168987,0.49434725693204806
48407,"San Jacinto County, Texas",27436,13563,13873,22308,19122,1428,320,116,61,27289,2471,2463,4934,4679,2026,2653,9938,292,31.6,93.6,1.8114885551829714,17.054235311269863,497,99.46420761043883,36.22248141128444,0.4943504884093891
48409,"San Patricio County, Texas",66867,33592,33275,24613,42404,4160,1376,316,211,66062,6589,6193,12782,10061,4475,5586,28545,261,4.61,95.2,2.8459479264809247,15.046285910837932,1903,98.79611766641243,42.68921889721387,0.5023703770170638
48411,"San Saba County, Texas",5851,2949,2902,22481,4159,449,113,24,40,5182,640,372,1012,897,413,484,2404,32,4.23,96.4,3.0251239104426593,15.330712698683985,177,88.5660570842591,41.086993676294654,0.5040164074517176
48413,"Schleicher County, Texas",3122,1572,1550,28112,1963,305,93,0,0,3122,340,370,710,320,134,186,1462,15,3.26,95.3,2.978859705317104,10.249839846252403,93,100,46.82895579756566,0.5035233824471492
48415,"Scurry County, Texas",17346,9446,7900,24140,11184,1258,525,49,27,15835,1241,1222,2463,1988,934,1054,6739,31,3.66,96.2,3.4647757408047966,11.46085552865214,601,91.28905799607979,38.850455436411856,0.5445635881471232
48417,"Shackelford County, Texas",3348,1677,1671,24296,2232,449,146,5,12,3322,232,275,507,586,302,284,1495,62,5.01,96.8,4.86857825567503,17.50298685782557,163,99.22341696535246,44.65352449223417,0.5008960573476703
48419,"Shelby County, Texas",25689,12740,12949,20686,16398,1754,558,133,56,25497,2874,3072,5946,5852,2825,3027,9348,86,13.36,92.7,2.907859395071821,22.780178286426096,747,99.25259838841528,36.3891159640313,0.49593211102028106
48421,"Sherman County, Texas",3067,1590,1477,25358,2077,340,87,0,18,3027,422,284,706,448,170,278,1595,20,4.05,94.4,3.4235409194652755,14.607107923051842,105,98.6957939354418,52.005216824258234,0.5184219106618846
48423,"Smith County, Texas",222277,107355,114922,26270,144635,25104,7819,2253,1225,219907,20369,18258,38627,35438,15685,19753,96657,1778,8.48,93.9,5.082397189092888,15.943170008592881,11297,98.93376282746303,43.48493096451725,0.48297844581310706
48425,"Somervell County, Texas",8650,4155,4495,27095,5975,822,221,91,63,8448,552,740,1292,1805,648,1157,3535,40,6.76,94.7,4.335260115606936,20.86705202312139,375,97.66473988439306,40.86705202312139,0.48034682080924856
48427,"Starr County, Texas",63420,30815,32605,13167,34979,2467,834,28,59,62893,10471,10716,21187,21968,9386,12582,20431,151,4.12,100.6,1.4522232734153264,34.638915168716494,921,99.16903185115106,32.2153894670451,0.4858877325764743
48429,"Stephens County, Texas",9365,4826,4539,23044,6435,712,264,50,57,8801,954,978,1932,1870,739,1131,3657,109,5.54,96.8,3.96155899626268,19.9679658302189,371,93.97757608115323,39.0496529631607,0.5153230112119594
48431,"Sterling County, Texas",1139,608,531,25675,779,103,52,12,0,1098,192,104,296,185,101,84,509,48,3.65,96,5.618964003511852,16.242317822651447,64,96.40035118525022,44.6883230904302,0.533801580333626
48433,"Stonewall County, Texas",1084,555,529,28063,793,71,21,0,7,1029,85,72,157,143,68,75,433,8,4.36,98.1,2.5830258302583027,13.191881918819188,28,94.92619926199262,39.944649446494466,0.5119926199261993
48435,"Sutton County, Texas",3894,2127,1767,31603,2673,460,47,21,0,3874,374,300,674,251,108,143,1818,7,3.53,95.1,1.746276322547509,6.445814072932717,68,99.48638931689779,46.687211093990754,0.5462249614791987
48437,"Swisher County, Texas",7541,3955,3586,18878,5034,507,132,9,5,6891,658,639,1297,1525,613,912,2542,10,6.97,92.3,1.9360827476462008,20.222782124386686,146,91.38045352075322,33.70905715422358,0.5244662511603235
48439,"Tarrant County, Texas",1983675,971142,1012533,30857,1263581,264881,98229,17307,12842,1967683,171975,161838,333813,264575,119414,145161,959562,7754,7.24,95.1,6.471725459059574,13.337618309450892,128378,99.19381955209397,48.37294415667889,0.48956709138341714
48441,"Taylor County, Texas",135371,66258,69113,25419,82140,13250,4665,1042,810,130082,9181,9791,18972,20783,8952,11831,65665,333,4.33,95.6,4.814177334879701,15.352623530889186,6517,96.09295934875269,48.50743512273677,0.4894549054081007
48443,"Terrell County, Texas",721,357,364,21204,561,54,39,0,4,721,53,38,91,123,47,76,260,0,4.49,95.1,5.9639389736477115,17.05963938973648,43,100,36.061026352288486,0.49514563106796117
48445,"Terry County, Texas",12755,6753,6002,21938,8153,696,280,57,12,11602,1519,1386,2905,1590,641,949,4494,86,3.02,93.9,2.7361818894551155,12.465699725597805,349,90.96040768326147,35.23324186593493,0.5294394355154841
48447,"Throckmorton County, Texas",1541,705,836,27732,1116,178,39,6,0,1530,135,145,280,259,86,173,641,2,5.36,96.6,2.9201817001946786,16.80726800778715,45,99.28617780661908,41.59636599610642,0.45749513303049966
48449,"Titus County, Texas",32664,16055,16609,21090,19787,2192,670,172,96,32409,3420,3310,6730,6193,2559,3634,14175,343,9.05,92.8,2.8716629928973796,18.959710996816067,938,99.21932402645113,43.39639970609846,0.4915197158951751
48451,"Tom Green County, Texas",116906,57848,59058,27513,74694,12276,3930,822,776,112051,9600,8666,18266,14339,6192,8147,55818,1068,3.25,96.8,4.728585359177459,12.265409816433715,5528,95.84709082510736,47.74605238396661,0.49482490205806373
48453,"Travis County, Texas",1176584,593319,583265,38820,795223,240380,96203,23765,17028,1169148,92936,78620,171556,159948,74385,85563,635422,5022,10.25,99.3,11.64353756297893,13.594269512419002,136996,99.36800092471086,54.005663854004474,0.5042725381273245
48455,"Trinity County, Texas",14481,6959,7522,20369,10599,878,293,46,26,14363,1338,1513,2851,2643,1282,1361,4795,47,15.07,93.3,2.5205441613148265,18.251501968096125,365,99.1851391478489,33.11235411919066,0.480560734755887
48457,"Tyler County, Texas",21456,11726,9730,21172,15046,1472,279,40,29,18722,1454,1432,2886,2947,1388,1559,6479,197,27.21,93.2,1.621923937360179,13.735085756897837,348,87.25764354958986,30.196681580909768,0.5465137956748695
48459,"Upshur County, Texas",40506,20035,20471,24088,27470,3255,1202,108,72,39952,3198,3140,6338,5513,2355,3158,16261,169,7.35,92.9,3.411840221201797,13.610329333925838,1382,98.63230138744878,40.14466992544315,0.4946180812719103
48461,"Upton County, Texas",3575,1747,1828,25290,2224,145,87,15,0,3515,257,326,583,630,285,345,1390,17,3.17,96.4,2.8531468531468533,17.622377622377623,102,98.32167832167832,38.88111888111888,0.4886713286713287
48463,"Uvalde County, Texas",27015,13188,13827,19146,16679,1823,557,57,84,26603,2598,2629,5227,4735,2071,2664,11346,111,4.35,99.3,2.583749768647048,17.52729964834351,698,98.4749213399963,41.99888950583009,0.48817323709050525
48465,"Val Verde County, Texas",48976,24836,24140,20160,29286,3772,1138,153,230,46436,4903,5525,10428,9849,4537,5312,19738,517,3.98,96.4,3.1056027442012413,20.10984972231297,1521,94.81378634433192,40.30137210062071,0.5071055210715453
48467,"Van Zandt County, Texas",53607,26307,27300,25394,37033,4419,1471,128,141,52941,4832,4632,9464,7489,3077,4412,22025,143,7.83,93.3,3.245844759079971,13.970190460201094,1740,98.75762493704181,41.08605219467607,0.49073814986848735
48469,"Victoria County, Texas",91518,44790,46728,28181,59263,7819,2799,637,324,90445,7644,7899,15543,13328,5586,7742,42452,220,13.98,96.2,4.108481391638803,14.563255315894141,3760,98.82755304967328,46.386503201555975,0.4894119189667606
48471,"Walker County, Texas",70818,41435,29383,17194,45996,6546,2031,316,423,55328,4083,3384,7467,12653,5440,7213,23825,321,21.75,94.4,3.9114349459177045,17.866926487616144,2770,78.12702985116778,33.64257674602502,0.58509136095343
48473,"Waller County, Texas",48443,24209,24234,23888,26108,3477,1189,168,187,48192,5081,4807,9888,7853,3834,4019,21309,250,27.42,96.4,3.187250996015936,16.210804450591418,1544,99.48186528497409,43.98777945213963,0.49974196478335364
48475,"Ward County, Texas",11498,5790,5708,26860,7213,669,257,18,31,11375,968,1238,2206,1313,533,780,4748,99,4.05,99.1,2.6613324056357626,11.41937728300574,306,98.93024873891112,41.29413811097582,0.5035658375369629
48477,"Washington County, Texas",34667,17199,17468,28517,23225,3876,1198,219,261,34000,2803,1954,4757,4298,1825,2473,14787,102,19.6,97.3,4.840338073672369,12.397957711945077,1678,98.07598003865347,42.65439755386967,0.4961202296131768
48479,"Webb County, Texas",269624,131657,137967,16316,147331,18078,5840,1058,691,267399,37988,40409,78397,83702,37634,46068,100860,1101,9.11,100.1,2.8146604159867072,31.04397234667537,7589,99.17477672610747,37.40764917069697,0.48829851941963626
48481,"Wharton County, Texas",41430,20355,21075,25867,26830,2560,1113,136,214,41070,4013,3422,7435,7122,3170,3952,18422,28,18.27,95.5,3.5312575428433504,17.19044170890659,1463,99.13106444605359,44.465363263335746,0.49131064446053585
48483,"Wheeler County, Texas",5599,2871,2728,25809,3748,429,97,14,8,5528,662,514,1176,1056,494,562,2520,37,5.44,96,2.1253795320592963,18.860510805500983,119,98.7319164136453,45.00803714949098,0.5127701375245579
48485,"Wichita County, Texas",131778,68339,63439,23263,83946,12916,4303,1058,509,116552,8365,9146,17511,22027,9226,12801,60513,819,4.87,97.1,4.4544612909590375,16.715233195222268,5870,88.44571931581903,45.92041160132951,0.518591874212691
48487,"Wilbarger County, Texas",12972,6415,6557,21938,8767,1011,271,41,10,12790,895,1132,2027,2091,1033,1058,6237,0,5.51,97.8,2.482269503546099,16.119333950046254,322,98.59697810669134,48.08048103607771,0.49452667283379587
48489,"Willacy County, Texas",21839,11821,10018,13369,13593,930,263,30,7,20143,3171,2837,6008,7157,3307,3850,6399,8,2.74,97.2,1.3736892714867897,32.77164705343651,300,92.23407665186134,29.300792160813224,0.541279362608178
48491,"Williamson County, Texas",508313,250106,258207,34575,332250,89380,34837,5640,3856,504499,26418,24141,50559,35067,15310,19757,251299,1692,9.56,98.5,8.72159476542996,6.8987021775953,44333,99.24967490502898,49.43784636631367,0.49203148453807005
48493,"Wilson County, Texas",47205,23703,23502,29862,31631,4199,1522,143,298,46503,3429,3193,6622,4705,2010,2695,20711,139,9.58,98.4,4.158457790488296,9.967164495286516,1963,98.51286939942803,43.87458955619108,0.5021290117572291
48495,"Winkler County, Texas",7777,3968,3809,23483,4590,380,79,28,2,7679,851,935,1786,1378,551,827,3160,22,4.91,96.7,1.4015687283014016,17.71891474861772,109,98.73987398739874,40.63263469204063,0.5102224508165102
48497,"Wise County, Texas",63247,31766,31481,27447,42293,5397,1464,159,236,62217,5261,5475,10736,8042,3422,4620,27230,198,5.99,94.6,2.939269846791152,12.71522759972805,1859,98.37146425917435,43.05342545891505,0.502253071291919
48499,"Wood County, Texas",43315,21523,21792,25955,31470,3719,987,225,97,42388,3188,3340,6528,5580,2683,2897,15607,117,10.2,93.3,3.0220477894493825,12.882373311785756,1309,97.85986378852591,36.03139789911116,0.4968948401246681
48501,"Yoakum County, Texas",8481,4286,4195,23681,4877,517,181,38,0,8481,1148,1063,2211,1043,398,645,3711,0,3.75,93.4,2.5822426600636716,12.29807805683292,219,100,43.75663247258578,0.5053649333804976
48503,"Young County, Texas",18166,8922,9244,25661,12231,1636,639,101,24,17861,1803,1826,3629,2939,1290,1649,8111,100,5.56,96.4,4.205658923263239,16.17857536056369,764,98.32103930419466,44.64934493008918,0.4911372894418144
48505,"Zapata County, Texas",14415,7190,7225,17817,8034,651,224,44,0,14378,2145,2280,4425,4873,2279,2594,4866,29,4.7,100.9,1.859174471037114,33.80506416926812,268,99.74332292750607,33.75650364203954,0.4987859868192855
48507,"Zavala County, Texas",12152,6163,5989,13105,6946,388,114,11,17,11926,1318,1113,2431,4318,1756,2562,4383,107,5.85,100.6,1.1685319289005924,35.53324555628703,142,98.14022383146808,36.06813693219223,0.5071593153390388
49001,"Beaver County, Utah",6414,3296,3118,21128,3800,486,170,23,23,6347,411,517,928,667,328,339,2615,27,2.06,90.6,3.3676333021515434,10.399126909884627,216,98.95541004053632,40.770190208917995,0.5138758964764577
49003,"Box Elder County, Utah",52182,26423,25759,22808,30559,4902,1634,226,168,51771,1977,2066,4043,5260,2438,2822,22071,149,3.44,92,3.8863976083707024,10.080104250507837,2028,99.21237208232724,42.296194089916064,0.5063623471695221
49005,"Cache County, Utah",120288,60247,60041,21752,60112,14861,4908,721,1677,119544,5238,4890,10128,17793,8652,9141,56199,407,9.05,84,6.073756318169726,14.791999201915402,7306,99.38148443735037,46.72037110933759,0.5008562782654962
49007,"Carbon County, Utah",20512,10088,10424,22536,13094,1440,445,72,95,20310,1256,1115,2371,3240,1425,1815,8660,1,3.74,84.5,2.983619344773791,15.795631825273011,612,99.01521060842434,42.219188767550705,0.4918096723868955
49009,"Daggett County, Utah",702,425,277,28533,494,35,11,0,0,581,9,14,23,23,6,17,283,0,2.17,81,1.566951566951567,3.2763532763532766,11,82.76353276353277,40.313390313390315,0.6054131054131054
49011,"Davis County, Utah",334977,168534,166443,28293,193263,47983,17323,3099,1612,331753,12384,11158,23542,20755,8970,11785,155740,1122,5.27,91.4,6.577765040584876,6.195947781489475,22034,99.03754586135764,46.49274427796535,0.503121109807539
49013,"Duchesne County, Utah",20259,10320,9939,23323,11586,1203,337,90,53,19892,1482,1485,2967,2517,1066,1451,7813,57,4.13,80.8,2.3693173404412855,12.42410780393899,480,98.18845945012093,38.56557579347451,0.5094032281948764
49015,"Emery County, Utah",10410,5306,5104,21465,6356,741,112,82,21,10355,572,468,1040,1339,559,780,3878,18,1.55,91.5,2.065321805955812,12.862632084534102,215,99.4716618635927,37.25264169068203,0.509702209414025
49017,"Garfield County, Utah",5020,2633,2387,23228,3375,534,142,20,16,4814,477,419,896,633,296,337,2176,30,2.68,86.7,3.545816733067729,12.609561752988048,178,95.89641434262948,43.34661354581673,0.5245019920318725
49019,"Grand County, Utah",9544,4823,4721,25662,6556,1136,498,146,42,9478,928,1016,1944,1190,589,601,4592,61,1.82,92.5,7.187761944677284,12.468566638725902,686,99.30846605196983,48.113998323554064,0.5053436714165969
49021,"Iron County, Utah",48504,24108,24396,19791,26912,5330,1685,261,453,48077,3629,3347,6976,10001,5159,4842,20690,149,2.48,89,4.945983836384628,20.618918027379184,2399,99.11966023420749,42.656275771070426,0.4970311726867887
49023,"Juab County, Utah",10694,5491,5203,20457,5986,718,224,44,19,10558,728,623,1351,1346,486,860,4451,5,2.54,93.2,2.683747896016458,12.586497101178232,287,98.72825883673087,41.62146998316813,0.5134654946699083
49025,"Kane County, Utah",7246,3656,3590,24836,5029,846,464,40,8,7169,685,456,1141,795,330,465,3142,104,3.01,91.6,7.065967430306376,10.971570521667127,512,98.93734474192658,43.36185481645045,0.5045542368203146
49027,"Millard County, Utah",12651,6462,6189,23283,7663,1241,329,44,28,12507,868,844,1712,1454,619,835,5354,25,2.27,93.8,3.169709904355387,11.493162595842225,401,98.86175005928385,42.32076515690459,0.5107896608963718
49029,"Morgan County, Utah",11014,5617,5397,30457,6208,1593,669,139,83,11014,305,372,677,267,108,159,4644,39,6.31,84.3,8.08970401307427,2.4241873978572728,891,100,42.16451788632649,0.50998728890503
49031,"Piute County, Utah",1860,966,894,17455,1359,252,48,8,0,1826,223,140,363,235,92,143,625,3,2.5,81.4,3.010752688172043,12.634408602150538,56,98.17204301075269,33.60215053763441,0.5193548387096775
49033,"Rich County, Utah",2307,1114,1193,19512,1392,251,40,3,23,2302,124,280,404,414,129,285,669,5,4.82,81.4,2.860858257477243,17.945383615084527,66,99.78326831382748,28.998699609882966,0.48287819679237104
49035,"Salt Lake County, Utah",1106700,555589,551111,30134,689802,147726,58121,15083,10969,1098968,71778,61158,132936,114135,52646,61489,556953,3614,3.96,89.9,7.605764886599801,10.313092979127134,84173,99.30134634498961,50.32556248305774,0.5020231318333785
49037,"San Juan County, Utah",15193,7654,7539,17385,8813,972,453,69,32,14938,1769,1577,3346,4189,2030,2159,5135,45,1.83,92.2,3.6464161126834727,27.571908115579543,554,98.32159547159877,33.798459817021,0.5037846376620813
49039,"Sanpete County, Utah",28892,15311,13581,17426,16713,2109,811,81,204,26303,1808,1629,3437,4365,1870,2495,10607,33,4.38,83.6,3.7934376297937145,15.107988370483179,1096,91.039041949328535,36.71258479856016,0.5299390834833172
49041,"Sevier County, Utah",20961,10756,10205,21196,12873,1429,627,71,37,20614,1350,1243,2593,2731,1162,1569,8505,46,2.35,82.4,3.5065120938886505,13.02895854205429,735,98.34454463050427,40.57535422928295,0.5131434568961405
49043,"Summit County, Utah",39731,20499,19232,52671,26377,8638,3440,1337,705,39599,2073,1666,3739,2966,1489,1477,21359,338,5.55,76.5,13.797790138682641,7.465203493493745,5482,99.66776572449724,53.75902947320732,0.5159447282978027
49045,"Tooele County, Utah",63357,31942,31415,24069,36102,5980,1679,275,219,62937,2576,2255,4831,4318,1871,2447,27764,129,1.84,94.6,3.429770980317881,6.815347948924349,2173,99.3370898243288,43.82151932698834,0.5041589721735562
49047,"Uintah County, Utah",36343,18454,17889,25001,20749,2165,545,150,106,35993,2798,2625,5423,4163,2150,2013,14879,81,1.82,88.4,2.204000770437223,11.454750570949013,801,99.03695347109485,40.94048372451366,0.5077731612690202
49049,"Utah County, Utah",576496,290874,285622,23207,280797,76063,24574,4763,5125,573027,27929,25230,53159,66394,30946,35448,253216,1829,4.77,88.3,5.977838527934279,11.516818850434348,34462,99.39826121950543,43.92328827953707,0.5045551053259693
49051,"Wasatch County, Utah",29306,14903,14403,30086,17356,4524,1514,476,199,29135,1547,1574,3121,2265,1167,1098,14118,50,7.18,79.9,7.469460178802976,7.728792738688323,2189,99.41650174025797,48.17443526922814,0.508530676312018
49053,"Washington County, Utah",155577,77178,78399,25415,98391,17275,6983,1760,1641,154159,11448,11074,22522,21878,10257,11621,61760,519,4,93.5,6.674508442764676,14.062489956741677,10384,99.08855422073957,39.697384574840754,0.4960758981083322
49055,"Wayne County, Utah",2700,1403,1297,22195,1795,330,91,0,46,2672,294,262,556,246,115,131,1198,7,1.62,90.5,5.074074074074074,9.11111111111111,137,98.96296296296296,44.370370370370374,0.5196296296296297
49057,"Weber County, Utah",244101,122542,121559,25275,149578,24534,8981,1215,1094,241225,13566,12091,25657,29277,13792,15485,114200,759,7.95,87.6,4.625134677858755,11.993805842663487,11290,98.82179917329302,46.78391321625065,0.502013510800857
50001,"Addison County, Vermont",36825,18214,18611,31051,25207,5487,2657,581,528,36578,1200,684,1884,2638,1220,1418,19301,115,6.73,77.2,10.226748133061779,7.163611676849966,3766,99.32926001357774,52.41276306856755,0.49460964019008824
50003,"Bennington County, Vermont",36054,17689,18365,31313,25675,5409,2372,632,389,35608,918,619,1537,4443,2036,2407,17050,241,7.61,75.5,9.410883674488268,12.323181893825927,3393,98.76296666111944,47.2901758473401,0.49062517335108446
50005,"Caledonia County, Vermont",30576,15366,15210,25896,21537,3602,1681,455,266,30184,1034,615,1649,3629,1530,2099,14170,124,6.84,74.7,7.8558346415489275,11.868785975928834,2402,98.71794871794872,46.343537414965986,0.5025510204081632
50007,"Chittenden County, Vermont",160985,78928,82057,36384,105259,30524,14735,4047,2940,159670,3682,2536,6218,17057,7685,9372,88312,526,7.72,77.1,13.493182594651676,10.595397086685095,21722,99.18315370997298,54.8572848402025,0.4902817032642793
50009,"Essex County, Vermont",6203,3135,3068,23022,4707,427,205,46,12,6203,273,154,427,960,418,542,2681,21,6.32,74.6,4.239883927132033,15.476382395615024,263,100,43.22102208608738,0.5054006126068031
50011,"Franklin County, Vermont",48816,24251,24565,30624,33856,5594,2047,388,341,48369,1083,812,1895,3879,1612,2267,25130,147,5.7,75.9,5.686660111438872,7.946165191740413,2776,99.08431661750245,51.47902327105867,0.49678384136348736
50013,"Grand Isle County, Vermont",6950,3432,3518,38635,5218,1202,526,175,97,6946,160,124,284,518,236,282,3689,11,5.17,78,11.482014388489208,7.453237410071942,798,99.94244604316546,53.07913669064748,0.49381294964028777
50015,"Lamoille County, Vermont",25191,12504,12687,31390,17428,4006,1908,431,203,25115,921,804,1725,3439,1501,1938,13130,132,8.37,73.5,10.090905482116629,13.651701004326942,2542,99.69830495018061,52.12178952800603,0.496367750387043
50017,"Orange County, Vermont",28901,14358,14543,29651,20990,3702,1850,411,336,28820,949,625,1574,3249,1434,1815,14957,151,6.7,76.4,8.98584824054531,11.241825542368776,2597,99.71973288121518,51.75253451437666,0.49679941870523514
50019,"Orleans County, Vermont",26951,13534,13417,25392,19590,2687,1192,286,146,26283,831,525,1356,3682,1708,1974,11994,124,6.8,74,6.025750435976402,13.661830729843048,1624,97.52142777633483,44.50298690215576,0.5021706059144373
50021,"Rutland County, Vermont",59676,29275,30401,28443,43156,8137,3564,782,450,59102,1974,1204,3178,6541,2962,3579,29497,127,6.28,75.9,8.03673168442925,10.960855285206783,4796,99.0381392854749,49.42858100408875,0.49056572156310746
50023,"Washington County, Vermont",58691,28997,29694,32137,41833,9466,5337,1319,814,58211,1451,809,2260,6658,3004,3654,31118,259,8.3,74.7,12.727675452795147,11.34415838885008,7470,99.18215740062361,53.02005418207221,0.49406212196077764
50025,"Windham County, Vermont",43332,21172,22160,29819,31839,6812,3660,752,548,42900,1409,963,2372,5876,2537,3339,21231,272,6.89,77.8,11.446506046339888,13.560417243607496,4960,99.00304624757685,48.99612295762947,0.488599649219976
50027,"Windsor County, Vermont",55485,27171,28314,34264,41605,8535,4512,952,979,54714,1848,1282,3130,5575,2570,3005,27252,71,6.6,77.4,11.612147427232586,10.047760656033162,6443,98.61043525277103,49.11597729115977,0.4896999188969992
51001,"Accomack County, Virginia",32840,16079,16761,24266,23558,2688,1390,252,279,32470,2899,2528,5427,6416,3082,3334,13839,79,10.28,88,5.8495736906211935,19.53714981729598,1921,98.87332521315469,42.14068209500609,0.4896163215590743
51003,"Albemarle County, Virginia",105105,50283,54822,39273,70813,18931,10353,3786,3961,103506,3721,4104,7825,9581,4522,5059,50042,473,8.76,89.4,17.220874363731507,9.115646258503402,18100,98.4786641929499,47.61143618286476,0.47840730697873557
51005,"Alleghany County, Virginia",15489,7586,7903,25952,11385,1192,434,67,106,15238,591,531,1122,2917,1383,1534,6156,72,7.59,83.5,3.918910194331461,18.832719994835045,607,98.37949512557299,39.74433468913423,0.48976693137065014
51007,"Amelia County, Virginia",12802,6644,6158,26118,8962,911,211,132,45,12706,793,838,1631,1645,892,753,6088,110,6.78,90.1,3.0307764411810654,12.849554757069209,388,99.25011716919231,47.55506952038744,0.5189814091548196
51009,"Amherst County, Virginia",31819,15331,16488,24296,22453,2879,1402,68,130,31639,1715,1478,3193,4172,2212,1960,14322,296,9.45,87.2,5.028442125773909,13.111662842955466,1600,99.43430026085043,45.0108425783337,0.4818190389389987
51011,"Appomattox County, Virginia",15462,7507,7955,26347,11014,1285,799,45,143,15386,595,712,1307,2210,900,1310,6792,151,7.62,89.2,6.383391540551028,14.29310567843746,987,99.50847238390894,43.92704695382228,0.4855128702625792
51013,"Arlington County, Virginia",229534,114403,115131,67061,171870,59644,45450,14413,7906,225319,9539,8126,17665,18502,7886,10616,145017,755,8.58,88.3,29.52460201974435,8.060679463608878,67769,98.16367074158948,63.17887546071606,0.49841417829166923
51015,"Augusta County, Virginia",74390,37695,36695,30088,53897,8020,3406,688,516,70859,3567,3260,6827,6260,2349,3911,34406,250,8.49,84.9,6.19706949858852,8.415109557736255,4610,95.25339427342385,46.25084016668907,0.5067213335125689
51017,"Bath County, Virginia",4458,2311,2147,28195,3259,374,109,20,15,4392,272,327,599,405,223,182,2022,0,7.78,83.7,3.2301480484522207,9.08479138627187,144,98.51951547779274,45.356662180349936,0.5183938986092418
51019,"Bedford County, Virginia",77319,38012,39307,30633,55513,9826,4283,664,914,76915,3015,2976,5991,6830,2914,3916,36056,442,8.94,88,7.580284276827171,8.833533801523558,5861,99.47748936225248,46.632781075802846,0.49162560302124964
51021,"Bland County, Virginia",6524,3617,2907,23505,5016,550,126,30,6,5729,209,282,491,478,264,214,2523,41,7.77,81.5,2.4831391784181482,7.326793378295524,162,87.81422440220723,38.67259350091968,0.5544144696505211
51023,"Botetourt County, Virginia",33149,16421,16728,34733,24133,4467,1824,270,270,32858,861,711,1572,2517,996,1521,15826,60,8.34,86.1,7.131436845757037,7.592989230444357,2364,99.12214546441824,47.74201333373556,0.4953693927418625
51025,"Brunswick County, Virginia",16435,8557,7878,20278,11899,935,503,66,49,14661,664,605,1269,2981,1294,1687,6091,177,5.88,90.8,3.7602677213264375,18.138119866139338,618,89.20596288408883,37.061149984788564,0.520657134164892
51027,"Buchanan County, Virginia",22611,11378,11233,19241,16961,1132,551,85,60,21666,1568,1371,2939,5726,2744,2982,6590,114,9.01,85.6,3.0781478041661137,25.32395736588386,696,95.82061828313653,29.145106364159037,0.503206403962673
51029,"Buckingham County, Virginia",17048,9465,7583,19702,12473,939,334,94,51,15071,1214,779,1993,2492,1050,1442,6424,31,6.54,90,2.809713749413421,14.617550445800093,479,88.40333176912247,37.68183951196621,0.5551970905678085
51031,"Campbell County, Virginia",55158,26745,28413,26417,39366,5324,2572,311,264,54688,2740,2421,5161,6366,2542,3824,26125,239,8.12,88.4,5.705428043076254,11.541390188186664,3147,99.14790238949925,47.36393632836579,0.48487979984771024
51033,"Caroline County, Virginia",29889,14807,15082,28039,20402,2748,905,35,219,27795,1174,1215,2389,3300,1221,2079,14541,195,8.32,89.8,3.877680752116163,11.040851149252234,1159,92.99407808892904,48.650005018568706,0.4953996453544782
51035,"Carroll County, Virginia",29767,14993,14774,23690,21908,2310,679,52,137,29618,1911,1921,3832,4296,2061,2235,12911,11,9.51,83.1,2.915980784089764,14.432089226324454,868,99.49944569489703,43.37353445090201,0.5036785702287768
51036,"Charles City County, Virginia",7022,3437,3585,32689,5418,432,180,44,35,7009,382,320,702,923,363,560,3282,34,7.87,90.9,3.6884078610082596,13.144403303902022,259,99.81486755909997,46.73882084876104,0.48946169182569066
51037,"Charlotte County, Virginia",12176,5991,6185,19830,8478,665,309,10,23,12039,870,756,1626,2709,1157,1552,4810,120,7.1,88.9,2.8088042049934296,22.24868593955322,342,98.87483574244415,39.50394218134034,0.4920335085413929
51041,"Chesterfield County, Virginia",335594,161644,173950,35370,223906,53337,24549,4428,3555,333209,13358,12486,25844,23707,10172,13535,169791,1788,7.05,90.6,9.693856266798573,7.064190658950994,32532,99.28931983289331,50.59417033677599,0.4816653456259647
51043,"Clarke County, Virginia",14331,7195,7136,38658,10243,1589,1172,236,229,14152,1011,1016,2027,1470,613,857,6820,23,8,86.5,11.422789756471984,10.257483776428721,1637,98.7509594585165,47.58914241853325,0.5020584746354058
51045,"Craig County, Virginia",5131,2525,2606,26753,3851,548,138,21,31,5114,248,167,415,478,176,302,2109,19,7.88,83.4,3.7029818748781915,9.315922822061976,190,99.66868056908984,41.10309881114792,0.4921068017930228
51047,"Culpeper County, Virginia",49795,25057,24738,29979,33245,4869,2189,493,243,48449,2715,2534,5249,4305,1720,2585,22698,275,7.57,89.4,5.874083743347725,8.645446329952806,2925,97.29691736118085,45.58288984837835,0.5032031328446631
51049,"Cumberland County, Virginia",9797,4830,4967,23488,6945,687,420,20,31,9785,792,526,1318,2107,1148,959,4603,121,6.59,90.5,4.807594161478003,21.50658364805553,471,99.87751352454833,46.98377054200265,0.49300806369296724
51051,"Dickenson County, Virginia",15181,7720,7461,21082,11058,626,342,34,31,14726,872,704,1576,3388,1562,1826,4511,32,8.4,84.8,2.6809828074566893,22.317370397207036,407,97.0028324879784,29.714775047757065,0.5085303998419076
51053,"Dinwiddie County, Virginia",28033,13849,14184,25981,19760,2071,1053,69,80,27716,1533,1425,2958,4062,1864,2198,13176,195,7.73,90.4,4.287803659972176,14.490065280205473,1202,98.86918988335177,47.001747939927945,0.4940248992259123
51057,"Essex County, Virginia",11083,4899,6184,25730,7760,1001,364,54,44,11006,428,681,1109,1355,476,879,5143,103,7.05,90.4,4.168546422448795,12.225931606965624,462,99.3052422629252,46.40440313994406,0.44202833167914823
51059,"Fairfax County, Virginia",1142004,565593,576411,52976,777179,240721,169953,35693,25060,1128951,55277,51152,106429,69528,31445,38083,608529,5618,7.95,88,20.201855685269052,6.088244874799037,230706,98.85700925741065,53.28606554793153,0.4952635892693896
51061,"Fauquier County, Virginia",68406,33858,34548,43067,46770,10212,4893,898,509,68002,3147,2527,5674,4190,1883,2307,34013,303,7.91,87.2,9.209718445750372,6.125193696459375,6300,99.40940853141537,49.722246586556736,0.4949565827558986
51063,"Floyd County, Virginia",15594,7842,7752,25446,11463,1388,642,92,104,15479,717,417,1134,1868,904,964,7169,102,8.64,81.8,5.373861741695524,11.978966269077851,838,99.26253687315634,45.97281005514942,0.5028857252789535
51065,"Fluvanna County, Virginia",26109,11928,14181,31952,18515,3411,1952,268,347,24860,1165,836,2001,1517,686,831,11907,66,7.2,90.3,9.831858746026274,5.810256999502087,2567,95.21620897008694,45.60496380558428,0.45685395840514764
51067,"Franklin County, Virginia",56277,27631,28646,27282,40619,5050,2696,389,253,55925,3256,3029,6285,8106,3649,4457,25167,353,9.16,88.1,5.931375162144393,14.403752865291327,3338,99.37452245144553,44.71986779679087,0.49098210636672174
51069,"Frederick County, Virginia",83784,41634,42150,32554,57528,9691,4688,857,723,82671,4433,4024,8457,4591,2039,2552,42000,253,7.68,86.4,7.481141984149718,5.479566504344505,6268,98.67158407333142,50.12890289315382,0.496920653107992
51071,"Giles County, Virginia",16867,8273,8594,25004,12168,1219,542,148,163,16756,988,795,1783,1873,1011,862,7492,81,7.58,82.9,5.057212308057153,11.104523626015297,853,99.34191023892808,44.41809450406119,0.49048437777909526
51073,"Gloucester County, Virginia",37035,18278,18757,32271,26799,3842,1685,335,252,36422,1922,1535,3457,3193,1157,2036,17805,287,7.34,90.3,6.13473741055758,8.621574186580261,2272,98.34480896449304,48.07614418793034,0.49353314432293777
51075,"Goochland County, Virginia",22148,10897,11251,47610,16566,4080,1370,671,317,20993,543,462,1005,1120,447,673,10423,76,6.32,90.4,10.646559508759255,5.056890012642225,2358,94.7850821744627,47.06068268015171,0.4920083077478779
51077,"Grayson County, Virginia",15708,7875,7833,20525,11847,1139,279,40,59,15069,834,1006,1840,3044,1294,1750,6347,36,9.98,80.2,2.406417112299465,19.378660555131145,378,95.93200916730329,40.406162464986,0.5013368983957219
51079,"Greene County, Virginia",19213,9387,9826,30215,13254,2023,1190,135,188,19011,1469,1363,2832,1787,734,1053,9084,173,8.65,87.9,7.874876385780461,9.300994118565555,1513,98.94862853276427,47.280487170145214,0.488575443709988
51081,"Greensville County, Virginia",11606,7238,4368,16835,8706,389,189,51,22,8497,623,484,1107,1447,579,868,3998,232,5.78,91.1,2.257453041530243,12.467689126313976,262,73.21213165603999,34.447699465793555,0.623642943305187
51083,"Halifax County, Virginia",35030,16505,18525,21155,25050,2529,1176,189,101,34329,2263,2125,4388,6423,2583,3840,14101,700,7.21,89.6,4.184984299172138,18.33571224664573,1466,97.99885812161006,40.254067941764205,0.4711675706537254
51085,"Hanover County, Virginia",103218,50653,52565,37924,70574,17767,6608,1244,1147,102592,3071,2688,5759,5832,2535,3297,53617,752,6.55,90,8.71844058206902,5.650177294657908,8999,99.3935166346955,51.94539712065725,0.49073804956499834
51087,"Henrico County, Virginia",324073,153299,170774,36497,222616,57871,25743,6448,3557,321871,14933,13086,28019,33510,14198,19312,165482,824,6.92,90.7,11.030847987953331,10.34026284201399,35748,99.32052346230633,51.06318638084629,0.4730384820703977
51089,"Henry County, Virginia",51956,25038,26918,21473,38003,3045,1297,168,342,51381,3071,2880,5951,9843,4177,5666,20275,170,9.64,88.7,3.477942874740165,18.944876433905613,1807,98.89329432596813,39.02340441912387,0.48190776811147895
51091,"Highland County, Virginia",2213,1020,1193,32648,1870,275,167,11,15,2213,110,99,209,231,66,165,883,0,6.31,80.4,8.721192950745595,10.43831902394939,193,100,39.90058743786715,0.4609127880704925
51093,"Isle of Wight County, Virginia",36090,17651,18439,33172,25773,4162,2029,488,256,35592,1281,1166,2447,3692,1617,2075,17332,32,7.83,89.6,7.683568855638681,10.229980604045442,2773,98.62011637572735,48.02438348573012,0.48908284843446936
51095,"James City County, Virginia",73028,35265,37763,42047,52771,13799,8486,1495,1514,71521,3036,2417,5453,5397,2672,2725,33001,196,7.95,90.7,15.740537875883224,7.390316043161527,11495,97.93640795311387,45.18951634989319,0.4828969710248124
51097,"King and Queen County, Virginia",7052,3524,3528,25831,5179,583,349,16,29,7052,456,369,825,1100,531,569,3109,121,6.52,90.3,5.587067498581963,15.598411798071469,394,100,44.086783891094726,0.49971639251276234
51099,"King George County, Virginia",25564,12839,12725,35676,16792,3632,1944,37,128,25132,1055,835,1890,1449,540,909,12599,82,8.43,90,8.249882647473008,5.668127053669222,2109,98.31012361132844,49.284149585354406,0.5022296980128306
51101,"King William County, Virginia",16329,8108,8221,31192,11308,1554,472,77,41,16276,510,593,1103,1775,852,923,8205,123,6.72,90.3,3.6132035029701757,10.870230877579766,590,99.67542409210607,50.248024986220834,0.49653989834037604
51103,"Lancaster County, Virginia",10848,5013,5835,33997,8582,1325,799,404,208,10757,638,588,1226,1178,419,759,4342,70,6.34,89.9,13.007005899705014,10.859144542772862,1411,99.16113569321534,40.02581120943953,0.46211283185840707
51105,"Lee County, Virginia",24428,12792,11636,18514,18167,1311,476,98,132,22891,1710,1379,3089,5994,2655,3339,7288,61,7.86,84.2,2.8901260848206975,24.5374160799083,706,93.70803995415098,29.834616014409693,0.5236613721958409
51107,"Loudoun County, Virginia",374558,185575,188983,50456,239466,84709,47889,5549,5059,372353,13197,11983,25180,13727,5612,8115,199480,1400,9.09,86.7,15.61760795390834,3.6648529733712802,58497,99.41130612615403,53.25743943528105,0.495450637818442
51109,"Louisa County, Virginia",34813,17007,17806,30237,25136,3537,1646,319,341,34716,2230,2075,4305,4057,1640,2417,16053,177,6.41,89.9,6.623962312929078,11.653692586102892,2306,99.72136845431304,46.11208456611036,0.4885244018039238
51111,"Lunenburg County, Virginia",12369,6367,6002,18555,9058,704,215,10,27,11423,866,772,1638,2118,978,1140,4572,221,6.53,89.1,2.037351443123939,17.12345379577977,252,92.35184736033632,36.963376182391464,0.5147546285067508
51113,"Madison County, Virginia",13108,6369,6739,29705,9346,1549,734,115,116,12931,1041,845,1886,1264,463,801,5995,44,7.74,87.7,7.361916386939273,9.642966127555692,965,98.64967958498627,45.735428745804086,0.4858864815379921
51115,"Mathews County, Virginia",8830,4229,4601,35252,6957,1199,460,127,87,8753,424,331,755,932,539,393,4058,60,8.04,89.9,7.633069082672707,10.554926387315968,674,99.12797281993205,45.95696489241223,0.47893544733861837
51117,"Mecklenburg County, Virginia",30959,14944,16015,22970,22775,2727,1186,127,115,30051,1875,1734,3609,5043,2215,2828,12506,360,6.76,90.2,4.612552085015666,16.28928582964566,1428,97.06708873025615,40.39536160728706,0.4827029296811913
51119,"Middlesex County, Virginia",10710,5279,5431,29871,8270,1117,494,142,75,10368,670,388,1058,1059,456,603,4307,68,6.25,90,6.638655462184874,9.88795518207283,711,96.80672268907563,40.21475256769374,0.49290382819794587
51121,"Montgomery County, Virginia",97692,50448,47244,28277,54875,12139,7691,1448,4114,97058,3573,2822,6395,21058,10927,10131,45764,412,6.95,84.6,13.566105720018015,21.555500962207756,13253,99.35102157802072,46.84518691397453,0.5163984768455964
51125,"Nelson County, Virginia",14863,7224,7639,33597,11068,1752,1149,301,204,14812,913,811,1724,2195,999,1196,7014,190,8.56,87.5,11.128305187378054,14.76821637623629,1654,99.65686604319451,47.19101123595506,0.4860391576397766
51127,"New Kent County, Virginia",20523,10309,10214,36768,14758,2467,1177,74,245,19979,527,565,1092,1017,357,660,10149,96,6.61,90.7,7.289382643862983,4.955415874872095,1496,97.34931540223164,49.45183452711592,0.5023144764410661
51131,"Northampton County, Virginia",11998,5737,6261,24835,8742,1252,576,94,109,11703,832,810,1642,2367,988,1379,4856,19,10.15,88.9,6.492748791465244,19.728288048008,779,97.54125687614602,40.473412235372564,0.4781630271711952
51133,"Northumberland County, Virginia",12254,6051,6203,33364,9774,1537,777,133,129,12254,803,520,1323,1654,774,880,4606,97,6.31,89.8,8.478864044393667,13.49763342582014,1039,100,37.58772645666721,0.4937979435286437
51135,"Nottoway County, Virginia",15537,8415,7122,19452,10985,965,439,87,10,14131,870,589,1459,3039,1443,1596,5492,92,6.47,89.7,3.4498294394027162,19.559760571538906,536,90.95063397052198,35.34787925596962,0.5416103494883182
51137,"Orange County, Virginia",35265,17341,17924,30660,24766,3861,1991,346,139,34728,2715,1453,4168,3054,1133,1921,15657,83,7.03,89.8,7.021125762087055,8.660144619310932,2476,98.47724372607401,44.39812845597618,0.49173401389479654
51139,"Page County, Virginia",23694,11638,12056,24057,17201,1498,630,78,60,23490,1464,1453,2917,3988,1836,2152,10343,22,6.95,85.2,3.241326918207141,16.831265299231873,768,99.13902253735122,43.65240145184435,0.4911792014856082
51141,"Patrick County, Virginia",17958,8867,9091,21785,13528,1223,565,77,67,17670,1195,1071,2266,3561,1695,1866,7228,45,10.48,86.2,3.9481011248468647,19.829602405613098,709,98.39625793518209,40.24947098786056,0.49376322530348593
51143,"Pittsylvania County, Virginia",61970,30372,31598,23597,45237,4273,1766,256,98,60872,3298,2696,5994,8949,3630,5319,27510,305,8.13,88.2,3.4210101662094563,14.440858479909634,2120,98.22817492335001,44.39244795868969,0.4901081168307245
51145,"Powhatan County, Virginia",28364,15185,13179,33807,20692,4242,1369,193,78,25757,948,1076,2024,1423,638,785,12728,198,6.55,90.4,5.7819771541390494,5.0169228599633335,1640,90.80877168241433,44.87378366944014,0.5353617261317163
51147,"Prince Edward County, Virginia",22903,11379,11524,19751,12726,1529,1036,278,329,21937,1099,1059,2158,3933,1409,2524,8653,394,6.79,89.6,7.173732698773087,17.172422826703926,1643,95.78221193730079,37.78107671484085,0.49683447583286033
51149,"Prince George County, Virginia",37704,20643,17061,27970,26218,3995,1620,272,155,32782,1838,1008,2846,4134,1883,2251,16047,341,9.13,91,5.429132187566306,10.96435391470401,2047,86.94568215573945,42.5604710375557,0.5475015913430936
51153,"Prince William County, Virginia",450763,224843,225920,38225,286605,68227,38409,4177,3311,442944,27865,24983,52848,30938,13658,17280,232524,2678,7.6,88.5,10.182069069555398,6.863473710131488,45897,98.26538557956177,51.58453555416039,0.4988053589136642
51155,"Pulaski County, Virginia",34330,17152,17178,26328,25536,3088,1261,180,191,33251,1462,1481,2943,4623,2248,2375,15270,169,8.24,84.6,4.7538595980192255,13.466355956889018,1632,96.85697640547626,44.480046606466644,0.4996213224584911
51157,"Rappahannock County, Virginia",7359,3646,3713,38185,5530,1084,521,126,129,7347,566,486,1052,653,251,402,3508,25,7.58,86.2,10.544910993341487,8.873488245685555,776,99.83693436608235,47.66952031526023,0.4954477510531322
51159,"Richmond County, Virginia",8873,4978,3895,19728,6773,640,239,4,26,7153,359,426,785,1246,578,668,3227,104,6.5,90.5,3.0316691085315,14.042601149554828,269,80.6153499380142,36.36875915699313,0.5610278372591007
51161,"Roanoke County, Virginia",93419,44811,48608,33717,66837,15458,4701,2024,1016,91796,3113,2360,5473,7270,3114,4156,44567,201,8.01,86.7,8.286322910756912,7.782142818912641,7741,98.26266605294427,47.70656932743874,0.47967758164827284
51163,"Rockbridge County, Virginia",22440,11143,11297,31534,16876,2535,977,556,284,22242,1459,983,2442,3465,1675,1790,9976,109,8.92,85.7,8.097147950089127,15.441176470588236,1817,99.11764705882354,44.45632798573975,0.4965686274509804
51165,"Rockingham County, Virginia",78653,38485,40168,28884,53694,7865,3894,653,901,78289,4640,4752,9392,7844,3417,4427,37966,435,7.87,85.1,6.926627083518747,9.97291902406774,5448,99.53720773524213,48.270250340101455,0.48930110739577637
51167,"Russell County, Virginia",27725,13563,14162,21673,20274,1899,759,44,50,27496,1717,1267,2984,4829,1874,2955,9997,39,8.32,83.8,3.0766456266907123,17.417493237150588,853,99.17403065825067,36.05770964833183,0.4891974752028855
51169,"Scott County, Virginia",22290,11191,11099,20969,16561,1513,509,142,33,21586,1322,1071,2393,3797,1685,2112,8243,51,7.47,85.1,3.0686406460296096,17.034544638851504,684,96.84163301929117,36.98070883804397,0.5020637056976223
51171,"Shenandoah County, Virginia",42854,20850,22004,27016,30585,3940,1448,263,216,42467,2303,2113,4416,4359,1664,2695,19855,108,5.8,86.1,4.496663088626499,10.171745928034722,1927,99.09693377514351,46.3317309936062,0.48653567928314745
51173,"Smyth County, Virginia",31298,15386,15912,22319,22737,2027,1015,75,177,30741,1783,1550,3333,5316,2560,2756,12615,82,8.11,82.2,4.048181992459582,16.985110869704133,1267,98.22033356764011,40.306089845996546,0.49159690715061666
51175,"Southampton County, Virginia",18089,9414,8675,25784,13198,1648,668,119,79,16591,885,663,1548,1948,749,1199,7725,172,7.61,89.9,4.787439880590414,10.768975620542871,866,91.71872408646138,42.70551163690641,0.5204267787052905
51177,"Spotsylvania County, Virginia",130159,63945,66214,33859,85662,16280,8174,949,681,129423,6223,5525,11748,10296,4805,5491,63812,506,8.08,89.5,7.5323258476171455,7.910325063960233,9804,99.43453775766562,49.02619104326247,0.4912837375824953
51179,"Stafford County, Virginia",141159,70984,70175,39158,89555,20410,12219,1108,894,135615,5893,4487,10380,6517,2640,3877,70925,522,8.08,89.5,10.074455047145417,4.616779659816236,14221,96.07251397360423,50.2447594556493,0.502865562946748
51181,"Surry County, Virginia",6670,3213,3457,27162,4986,643,220,67,23,6670,500,350,850,909,414,495,3027,57,9.5,90.6,4.6476761619190405,13.628185907046477,310,100,45.382308845577214,0.4817091454272864
51183,"Sussex County, Virginia",11595,7552,4043,15882,8948,660,330,35,24,7015,109,240,349,1244,448,796,2627,74,8.9,90.6,3.354894351013368,10.728762397585166,389,60.5002156101768,22.65631737818025,0.6513152220784821
51185,"Tazewell County, Virginia",42689,21055,21634,24325,30927,2940,1192,373,209,41458,2471,2448,4919,6430,2614,3816,15699,104,8.33,81,4.1556372836093605,15.062428260207547,1774,97.11635315889339,36.775281688491184,0.49321839349715385
51187,"Warren County, Virginia",38991,19445,19546,30009,26801,3745,1479,258,110,38640,2038,2224,4262,3749,1431,2318,18306,89,7.15,86.1,4.736990587571491,9.615039368059296,1847,99.09979225975225,46.94929599138263,0.4987048293195866
51191,"Washington County, Virginia",54457,26857,27600,25640,39882,5780,2518,562,487,53690,2787,2678,5465,7671,3735,3936,23600,258,8.13,84.7,6.5501221146959985,14.086343353471547,3567,98.59154929577464,43.33694474539545,0.49317810382503624
51193,"Westmoreland County, Virginia",17596,8646,8950,32265,13023,1776,760,126,92,17418,1266,922,2188,1667,880,787,7611,90,6.81,90,5.558081382132303,9.473744032734713,978,98.98840645601273,43.254148670152304,0.49136167310752443
51195,"Wise County, Virginia",39539,20612,18927,21694,27735,2394,986,267,218,37390,2269,2067,4336,7269,3211,4058,12823,15,8.15,82.2,3.72037734894661,18.384379979260984,1471,94.56486001163408,32.43127039125926,0.5213080755709553
51197,"Wythe County, Virginia",29048,14200,14848,24879,21161,2377,1047,249,189,28845,1480,1966,3446,4373,1923,2450,12852,91,8.37,83.4,5.112228036353621,15.054392729275682,1485,99.30115670614155,44.24400991462407,0.488846047920683
51199,"York County, Virginia",67196,33024,34172,38193,44827,10415,6970,976,1202,63621,2023,1598,3621,3446,1487,1959,32923,321,7.87,90.5,13.61390558961843,5.128281445324126,9148,94.67974284183582,48.995475921185786,0.491457824870528
51650,"Hampton city, Virginia",136255,65820,70435,27053,90596,14215,7224,941,819,130988,7739,6663,14402,19633,9014,10619,65174,587,7.83,89.9,6.593519503871417,14.409012513302264,8984,96.1344537815126,47.83237312392206,0.4830648416571869
51700,"Newport News city, Virginia",180775,87598,93177,26028,115972,17727,8437,1427,1180,171249,10479,9956,20435,28194,12326,15868,87442,771,8.06,90.1,6.1092518323883285,15.596183100539344,11044,94.73046604895589,48.370626469368,0.4845692158760891
51710,"Norfolk city, Virginia",245752,128254,117498,26670,151651,25001,11603,2813,1972,218544,16256,13835,30091,46251,21383,24868,126639,1321,7.85,89.6,6.668511344770337,18.820192714606595,16388,88.92867606367395,51.53121846414271,0.5218838503857548
51800,"Suffolk city, Virginia",88057,42594,45463,31239,58966,9585,5024,988,470,85835,3860,3101,6961,9757,3932,5825,41736,250,6.3,88.9,7.361141079073782,11.080322972620008,6482,97.47663445268405,47.39657267451764,0.483709415492238
51810,"Virginia Beach city, Virginia",450057,221350,228707,34607,303492,68828,27602,6154,3114,425182,20596,17253,37849,35276,15264,20012,237514,2478,7.77,88.2,8.192295642551944,7.83811828279529,36870,94.47292231872852,52.774204156362416,0.4918265908540474
53001,"Adams County, Washington",19261,9750,9511,18415,10569,946,340,91,59,19040,2099,1613,3712,4393,2042,2351,7554,133,2.53,90.4,2.5440008306941486,22.807746222937542,490,98.85260370697264,39.21914750012979,0.5062042469238357
53003,"Asotin County, Washington",22259,10594,11665,26878,15893,2429,727,166,80,22065,933,832,1765,2956,1289,1667,9619,66,3.56,89.7,4.371265555505638,13.280021564311065,973,99.12844242778202,43.21398086167393,0.4759423154679006
53005,"Benton County, Washington",190529,95438,95091,30511,122845,22888,9653,1941,2352,189040,10085,7877,17962,25345,11217,14128,83926,400,1.96,92.6,7.319620635178897,13.30243689936965,13946,99.2184916731836,44.04893743209695,0.5009106225299036
53007,"Chelan County, Washington",75138,37352,37786,27605,50640,7907,3886,960,543,74493,4266,3830,8096,9516,4202,5314,33273,539,7.6,80.2,7.17213660198568,12.66469695759802,5389,99.14157949373153,44.28252016290026,0.4971119806223216
53009,"Clallam County, Washington",73439,36389,37050,28857,55540,8252,4001,1032,625,72516,3994,2747,6741,12353,5805,6548,27619,230,22.94,72.7,7.704353272784216,16.820762809951116,5658,98.74317460749738,37.608082898732285,0.49549966638979287
53011,"Clark County, Washington",457474,226178,231296,32162,305853,58319,22829,4913,2770,454847,19255,15594,34849,46542,21002,25540,209504,1428,13.95,85.2,6.669668658765307,10.173692931182975,30512,99.42575971530623,45.7958266480718,0.49440623948027645
53013,"Columbia County, Washington",3999,1956,2043,28950,3043,545,187,36,37,3941,113,145,258,571,258,313,1616,18,6.19,86.8,6.501625406351588,14.278569642410602,260,98.54963740935234,40.41010252563141,0.4891222805701425
53015,"Cowlitz County, Washington",103590,51079,52511,25878,71602,6908,3531,643,425,102583,4278,3313,7591,17197,7839,9358,41469,239,16.39,81.6,4.439617723718506,16.6010232647939,4599,99.02789844579593,40.031856356791195,0.49308813592045564
53017,"Douglas County, Washington",40585,20382,20203,25060,26449,3293,1070,262,209,40443,2827,2335,5162,5533,2589,2944,18016,849,2.58,88.8,3.7969693236417394,13.633115683134163,1541,99.65011703831465,44.39078477269927,0.5022052482444253
53019,"Ferry County, Washington",7568,3911,3657,21951,5560,620,294,34,24,7495,400,363,763,1582,869,713,2340,25,4.4,84.2,4.651162790697675,20.903805496828753,352,99.03541226215644,30.91966173361522,0.5167811839323467
53021,"Franklin County, Washington",89124,46383,42741,22125,51123,5431,2226,290,382,87039,7578,6240,13818,13818,5977,7841,38135,155,2.05,92,3.251649387370405,15.504241281809614,2898,97.66056281136395,42.78869889143216,0.5204322068129796
53023,"Garfield County, Washington",2226,1118,1108,24781,1638,270,95,4,8,2203,77,117,194,257,98,159,901,6,4.63,88.4,4.806828391734052,11.545372866127583,107,98.96675651392633,40.476190476190474,0.5022461814914645
53025,"Grant County, Washington",93420,47166,46254,22508,56185,6140,2492,445,292,92914,7762,6419,14181,14672,6953,7719,38842,832,1.81,91.3,3.4564333119246413,15.705416399058018,3229,99.45836009419824,41.57782059516163,0.5048811817597945
53027,"Grays Harbor County, Washington",71454,36786,34668,24081,51198,5191,1891,316,361,68514,4482,3172,7654,10956,5346,5610,26590,169,23.34,77,3.5939205642791165,15.332941472835671,2568,95.88546477454027,37.21275226019537,0.5148207238223192
53029,"Island County, Washington",80323,40020,40303,33837,58111,11987,5083,1130,640,74912,2857,1990,4847,7414,3099,4315,36124,427,5.56,75.2,8.531802846009239,9.230232934526848,6853,93.26344882536758,44.9734198174869,0.4982383626109583
53031,"Jefferson County, Washington",30524,14981,15543,32317,25034,5795,3022,666,517,29748,1273,988,2261,3799,1756,2043,10991,216,29.22,73.4,13.776045079281877,12.44594417507535,4205,97.45773817324073,36.00773162101952,0.49079412920980214
53033,"King County, Washington",2118119,1058695,1059424,46316,1500090,460158,207754,49895,37018,2104848,82919,64245,147164,212509,99143,113366,1117565,7874,14.16,78.4,13.911730171911966,10.03291127646747,294667,99.3734535217332,52.76214414770841,0.4998279133514217
53035,"Kitsap County, Washington",258903,132104,126799,34412,178186,36819,14388,3430,2015,244971,8810,6288,15098,24850,11095,13755,121696,1407,11.8,80.6,7.660397909641835,9.598189283245077,19833,94.61883408071749,47.004476580031906,0.5102451497278904
53037,"Kittitas County, Washington",43726,22039,21687,26698,26293,6134,2249,272,552,43293,2412,1891,4303,8073,3530,4543,20427,253,6.06,83.5,7.027855280611078,18.462699538032293,3073,99.00974248730732,46.71591272926863,0.5040250651786122
53039,"Klickitat County, Washington",21172,10572,10600,25069,15380,2725,981,133,133,21130,931,932,1863,3138,1316,1822,7997,49,4.68,88.4,5.889854524844134,14.821462308709616,1247,99.80162478745513,37.77158511241262,0.4993387492915171
53041,"Lewis County, Washington",76012,37884,38128,23853,53373,5159,2406,418,221,75155,4314,3326,7640,11987,5639,6348,29022,134,14.41,80.3,4.00594642951113,15.769878440246277,3045,98.87254644003579,38.180813555754355,0.498394990264695
53043,"Lincoln County, Washington",10344,5264,5080,26918,7515,1168,381,126,46,10233,375,295,670,1395,675,720,4051,88,2.8,88.8,5.346094354215004,13.486078886310905,553,98.92691415313224,39.16279969064192,0.5088940448569219
53045,"Mason County, Washington",61569,31695,29874,26312,45104,5599,1880,362,204,60400,3933,2596,6529,9769,4999,4770,22611,148,23.86,79.5,3.972778508665075,15.866751124754341,2446,98.10131722132891,36.72465039224285,0.5147882863129172
53047,"Okanogan County, Washington",41377,20868,20509,22755,28734,3338,1387,364,176,40865,3510,2787,6297,8869,4358,4511,16361,161,3.96,81.4,4.657176692365324,21.43461343258332,1927,98.76259757836479,39.54129105541726,0.5043381588805375
53049,"Pacific County, Washington",20940,10462,10478,23050,16091,1746,744,178,75,20699,1145,727,1872,3847,1742,2105,6808,148,19.83,75.6,4.761222540592168,18.371537726838586,997,98.84909264565425,32.51193887297039,0.49961795606494747
53051,"Pend Oreille County, Washington",13066,6636,6430,26128,9768,1346,492,71,53,12954,607,565,1172,2145,983,1162,4231,119,7.48,82.9,4.714526251339354,16.416653910913823,616,99.14281340884739,32.38175417113118,0.5078830552579213
53053,"Pierce County, Washington",845193,420170,425023,31157,563258,96186,35732,8858,5393,822539,37195,29771,66966,101328,45402,55926,391493,2693,12.69,78.7,5.9137972037156015,11.988741033113147,49983,97.31966544919327,46.31995295749018,0.4971290580967897
53055,"San Juan County, Washington",16221,7817,8404,40784,13148,3683,1728,485,452,16171,707,639,1346,1706,739,967,7392,82,5.42,75.7,16.429320017261574,10.517230750262007,2665,99.6917575981752,45.570556685777696,0.4819061710128845
53057,"Skagit County, Washington",121725,60223,61502,30069,84567,13821,5657,1484,708,120489,6534,4950,11484,17169,7604,9565,53426,514,16.85,76,6.448141302115424,14.104744300677757,7849,98.98459642637091,43.89073731772438,0.4947463544875744
53059,"Skamania County, Washington",11498,5834,5664,28644,8429,1151,632,80,96,11459,380,374,754,1508,745,763,4641,19,20.29,79.2,7.027309097234301,13.115324404244216,808,99.66081057575231,40.363541485475736,0.5073925900156548
53061,"Snohomish County, Washington",771904,387078,384826,35737,530117,114528,38202,8265,5146,762452,32835,26496,59331,67118,30186,36932,385322,2714,17.9,76.2,6.686453237708316,8.695122709559739,51613,98.77549539839151,49.91838363319791,0.5014587306193516
53063,"Spokane County, Washington",490764,243266,247498,28325,331607,61222,25307,6793,4026,481783,20954,15591,36545,72371,35857,36514,219415,1750,4.76,88.3,7.361175636354745,14.746599180053957,36126,98.16999616923816,44.70886210072459,0.49568835529908467
53065,"Stevens County, Washington",43858,21834,22024,24707,31129,3539,1709,427,130,43591,1969,1580,3549,6782,3012,3770,16025,213,4.74,87.1,5.1666742669524375,15.463541429157736,2266,99.39121710976333,36.538373842856494,0.4978339185553377
53067,"Thurston County, Washington",269885,132099,137786,32410,187617,40434,17361,4530,2296,263479,10358,7690,18048,30765,13875,16890,124578,1200,11.54,82.2,8.96196528150879,11.399299701724809,24187,97.62639642810827,46.159660596179855,0.4894640309761565
53069,"Wahkiakum County, Washington",4105,1985,2120,26964,3119,283,226,17,8,4060,188,179,367,558,244,314,1197,19,17.72,77.2,6.1144945188794155,13.5931790499391,251,98.90377588306943,29.159561510353228,0.4835566382460414
53071,"Walla Walla County, Washington",59862,30692,29170,26651,39135,7069,3077,745,508,56631,2977,2188,5165,7861,3602,4259,26127,148,3,92.7,7.233303264174268,13.131869967592129,4330,94.60258594767966,43.64538438408339,0.5127125722495072
53073,"Whatcom County, Washington",212738,105396,107342,29186,139327,31019,11076,2593,2462,211156,9414,7491,16905,31630,14328,17302,100839,854,14.31,76,7.582566349218287,14.868053662251219,16131,99.25636228600438,47.400558433378144,0.4954262990156907
53075,"Whitman County, Washington",47794,24423,23371,22154,23365,5727,3223,617,1744,47532,1738,1066,2804,11240,5726,5514,21347,69,4.19,90.6,11.683474913169016,23.517596351006404,5584,99.45181403523455,44.66460225132862,0.5110055655521614
53077,"Yakima County, Washington",248279,124369,123910,21510,149420,14665,6491,1766,874,245349,22345,16599,38944,46428,21117,25311,101747,762,5.64,85.6,3.6777174066272216,18.69993032032512,9131,98.81987602656689,40.98091260235461,0.5009243633170748
54001,"Barbour County, West Virginia",16790,8165,8625,20762,11319,1102,524,36,73,16627,763,578,1341,3623,1746,1877,6218,63,9.19,82,3.770101250744491,21.578320428826682,633,99.02918403811793,37.03394877903514,0.4863013698630137
54003,"Berkeley County, West Virginia",111610,54961,56649,27658,76160,10250,4394,608,503,111091,4420,4131,8551,14353,5953,8400,51443,64,7.13,87.3,4.932353731744468,12.859958785055102,5505,99.53498790430965,46.09174805124989,0.49243795358838816
54005,"Boone County, West Virginia",23236,11530,11706,20992,16442,739,489,35,31,23118,982,666,1648,5619,2590,3029,6759,81,7.14,84.7,2.388535031847134,24.182303322430712,555,99.49216732656222,29.088483387846445,0.49621277328283697
54007,"Braxton County, West Virginia",14345,7172,7173,20633,10376,1117,405,80,31,14003,555,565,1120,3085,1536,1549,5264,288,5.59,84.6,3.597072150575113,21.505751132798885,516,97.6158940397351,36.69571279191356,0.4999651446497037
54009,"Brooke County, West Virginia",23067,11287,11780,25630,16609,2070,990,136,112,22835,871,622,1493,2857,1217,1640,10182,42,5.85,83,5.366974465686912,12.385659166775046,1238,98.99423418736724,44.14098062166732,0.48931373824077684
54011,"Cabell County, West Virginia",96100,47121,48979,24646,63885,8961,5201,1329,940,94638,4968,3432,8400,21376,9803,11573,38660,514,5.84,86.6,7.77315296566077,22.243496357960456,7470,98.4786680541103,40.22892819979188,0.49033298647242457
54013,"Calhoun County, West Virginia",7450,3689,3761,19696,5555,430,115,23,23,7427,287,434,721,1256,628,628,2208,26,5.08,84.1,2.161073825503356,16.859060402684563,161,99.69127516778524,29.63758389261745,0.49516778523489935
54015,"Clay County, West Virginia",8901,4443,4458,16229,6236,316,228,5,11,8853,318,223,541,2218,1059,1159,2463,15,5.55,84.5,2.741265026401528,24.918548477699137,244,99.46073474890461,27.671048196831816,0.49915739804516346
54017,"Doddridge County, West Virginia",8570,4641,3929,21164,6240,602,267,52,9,7934,330,208,538,1175,555,620,2816,109,7.46,84.2,3.8273045507584595,13.710618436406067,328,92.57876312718787,32.858809801633605,0.5415402567094516
54019,"Fayette County, West Virginia",44602,22404,22198,20758,32026,3281,1105,165,153,43454,2450,1665,4115,8560,3848,4712,15806,622,6.78,81.7,3.190439890587866,19.191964485897493,1423,97.42612438904085,35.437872741132686,0.5023093134837003
54021,"Gilmer County, West Virginia",8305,4912,3393,18207,5695,517,265,61,70,6951,361,401,762,1656,827,829,2511,59,5.69,85,4.768211920529802,19.939795304033716,396,83.69656833232992,30.234798314268513,0.5914509331727875
54023,"Grant County, West Virginia",11673,5844,5829,21705,8507,720,397,64,51,11567,462,378,840,1464,655,809,4765,7,6.18,83.5,4.386190353807933,12.541763042919557,512,99.09192152831321,40.82069733573203,0.5006425083526086
54025,"Greenbrier County, West Virginia",35523,17349,18174,23777,26071,3298,1276,583,125,34922,1798,1212,3010,6197,2805,3392,13749,56,7.58,80.4,5.585113869887115,17.445035610731075,1984,98.30813838921263,38.704501309011064,0.48838780508403007
54027,"Hampshire County, West Virginia",23412,12081,11331,21771,16994,1322,742,43,36,22924,1375,861,2236,3853,1921,1932,9146,35,7.46,85.8,3.5067486758927044,16.4573722877157,821,97.91559883820263,39.065436528276095,0.5160174269605331
54029,"Hancock County, West Virginia",29921,14495,15426,25157,22063,2602,944,336,70,29678,1123,1054,2177,3977,1680,2297,13079,178,5.42,82.7,4.5118812873901275,13.29166805922262,1350,99.18786136826978,43.71177433909295,0.48444236489422143
54031,"Hardy County, West Virginia",13812,6846,6966,23446,10109,934,406,68,51,13754,599,610,1209,2024,858,1166,6410,0,6.29,84.8,3.8010425716768026,14.653924123950189,525,99.58007529684332,46.40891977990154,0.4956559513466551
54033,"Harrison County, West Virginia",68438,33365,35073,27162,48497,6986,3053,503,425,67830,3017,2026,5043,10094,4558,5536,29794,434,9,84,5.816943803150297,14.749115988193694,3981,99.11160466407551,43.53429381337853,0.4875215523539554
54035,"Jackson County, West Virginia",29123,14440,14683,23246,20516,2089,905,130,208,28947,1183,962,2145,4247,1991,2256,10993,79,5.54,85.5,4.268104247501975,14.582975654980599,1243,99.39566665522096,37.74679806338633,0.49582803969371286
54037,"Jefferson County, West Virginia",55673,27488,28185,33241,38100,7161,3438,527,509,55320,2299,1493,3792,5363,2227,3136,26667,85,7.45,86.9,8.03621144899682,9.63303576239829,4474,99.36594040199019,47.89934079356241,0.49374023314712695
54039,"Kanawha County, West Virginia",187827,90415,97412,28201,134994,19988,9665,3167,1342,186020,8168,5855,14023,30401,13381,17020,80472,489,6.5,85.3,7.54630590916109,16.185638912403434,14174,99.03794449147354,42.843680620996984,0.48137381739579505
54041,"Lewis County, West Virginia",16371,8198,8173,21513,11745,1061,427,64,23,16216,851,702,1553,3196,1478,1718,6121,198,7.38,84.5,3.1396982469000063,19.52232606438214,514,99.05320383605155,37.38928593244151,0.5007635452935069
54043,"Lincoln County, West Virginia",21241,10644,10597,19321,14952,940,318,52,25,21181,1012,769,1781,5270,2504,2766,6924,66,6.46,86.8,1.8596111294195188,24.81050797985029,395,99.71752742337931,32.597335342027215,0.5011063509250977
54045,"Logan County, West Virginia",34428,16994,17434,21074,24813,1304,618,200,29,33884,1797,1296,3093,7593,3276,4317,10203,14,8.56,85.6,2.460206808411758,22.054722899965146,847,98.41989078656907,29.635761589403973,0.49360985244568373
54047,"McDowell County, West Virginia",19707,10178,9529,13985,14437,437,214,52,4,18103,1102,1009,2111,6307,2899,3408,4024,21,8.5,84.6,1.3700715481808494,32.003856497691174,270,91.8607601359923,20.419140406961994,0.5164662302735069
54049,"Marion County, West Virginia",56575,27818,28757,25205,38786,5352,2363,483,341,56202,2188,1830,4018,8865,4002,4863,24825,93,8.38,82.6,5.63323022536456,15.669465311533363,3187,99.3406981882457,43.87980556783032,0.4917012814847547
54051,"Marshall County, West Virginia",32006,15780,16226,24043,23157,2546,1216,133,59,31626,1423,1023,2446,4770,1976,2794,12619,71,7.46,82.7,4.399175154658502,14.903455602074612,1408,98.81272261450978,39.42698244079235,0.49303255639567584
54053,"Mason County, West Virginia",27000,13010,13990,21094,19448,1534,531,79,0,26359,811,866,1677,5071,2202,2869,9000,36,6.21,85.8,2.259259259259259,18.78148148148148,610,97.62592592592593,33.333333333333336,0.48185185185185186
54055,"Mercer County, West Virginia",60963,29134,31829,21698,43084,5646,2033,563,299,60532,2386,1962,4348,12805,5465,7340,22371,204,6.99,81.2,4.748782048127553,21.00454373964536,2895,99.29301379525286,36.69602873874317,0.47789642898151335
54057,"Mineral County, West Virginia",27421,13673,13748,21888,19276,1436,775,137,98,27194,1008,1398,2406,3930,1731,2199,11066,58,6.7,86,3.68330841325991,14.332081251595492,1010,99.1721673170198,40.355931585281354,0.49863243499507676
54059,"Mingo County, West Virginia",25150,12190,12960,19272,17789,927,623,39,55,25066,893,798,1691,7220,3237,3983,6813,0,8.53,86.8,2.8508946322067596,28.707753479125248,717,99.66600397614314,27.089463220675945,0.48469184890656064
54061,"Monongalia County, West Virginia",103715,53632,50083,29285,63582,13055,7102,2376,2773,102154,4360,2813,7173,20763,10331,10432,48649,291,9.28,81.6,11.812177602082631,20.019283613749216,12251,98.49491394687364,46.906426264281926,0.5171093862989924
54063,"Monroe County, West Virginia",13517,6678,6839,22830,9979,923,426,32,62,13401,663,630,1293,2302,886,1416,5095,26,7.9,83,3.8470074720722054,17.030406155211956,520,99.1418214100762,37.69327513501516,0.4940445365095805
54065,"Morgan County, West Virginia",17510,8623,8887,24026,12966,1306,877,49,99,17344,684,712,1396,1920,600,1320,7005,116,8.1,86.8,5.853797829811536,10.96516276413478,1025,99.05197030268418,40.00571102227299,0.49246145059965735
54067,"Nicholas County, West Virginia",25496,12515,12981,22101,18576,1632,844,195,58,25357,1029,918,1947,4692,2139,2553,9609,173,6.87,81.5,4.30263570756197,18.402886727329776,1097,99.45481644179479,37.688264825855036,0.4908613115782868
54069,"Ohio County, West Virginia",42906,20667,22239,29769,30178,5687,2575,717,324,42314,1495,1402,2897,5549,2512,3037,19527,61,6.58,82.6,8.427725726005686,12.932923134293572,3616,98.62023959353004,45.511117326248076,0.4816808837924766
54071,"Pendleton County, West Virginia",7138,3583,3555,23697,5351,354,294,64,32,6966,255,201,456,1312,619,693,2738,4,6.28,81.8,5.463715326421967,18.380498739142617,390,97.59036144578313,38.35808349677781,0.5019613337069208
54073,"Pleasants County, West Virginia",7527,4058,3469,24605,5439,416,306,17,9,6965,297,172,469,1152,591,561,2933,7,9.06,84.2,4.4107878304769494,15.304902351534476,332,92.53354590142155,38.96638767105088,0.5391258137372127
54075,"Pocahontas County, West Virginia",8574,4467,4107,23219,6546,699,342,39,83,8293,526,321,847,1452,628,824,3465,0,7.51,77.3,5.411709820387217,16.934919524142757,464,96.72264987170516,40.412876137158854,0.5209937018894332
54077,"Preston County, West Virginia",33760,17379,16381,22540,24792,2096,1325,114,181,31138,1625,1220,2845,4716,2095,2621,13224,33,10.06,79.6,4.798578199052133,13.969194312796208,1620,92.23341232227489,39.170616113744074,0.5147808056872037
54079,"Putnam County, West Virginia",56644,27904,28740,30690,39835,5997,3165,547,221,56260,1947,1624,3571,5209,2089,3120,25513,90,5.54,86.8,6.943365581526728,9.196031353717958,3933,99.32208177388603,45.04095755949439,0.49262057764282186
54081,"Raleigh County, West Virginia",77097,38718,38379,23435,55132,6721,2850,402,267,74497,3829,3132,6961,12996,5620,7376,28369,283,7.5,81.4,4.564379936962528,16.85668703062376,3519,96.62762494001063,36.79650310647626,0.5021985291256469
54083,"Randolph County, West Virginia",29152,14921,14231,23642,21070,1998,1190,304,233,27365,1416,1437,2853,4911,2207,2704,11304,63,7.96,77.8,5.924121844127333,16.8461855104281,1727,93.87006037321625,38.776070252469815,0.5118345225027442
54085,"Ritchie County, West Virginia",10005,5005,5000,21533,7291,363,245,49,21,9947,677,483,1160,1830,881,949,3671,23,7.68,84.4,3.1484257871064467,18.290854572713645,315,99.42028985507247,36.691654172913545,0.5002498750624688
54087,"Roane County, West Virginia",14348,7100,7248,20723,10272,719,356,21,76,14254,453,427,880,2705,1210,1495,4649,65,4.77,84.2,3.1572344577641482,18.852801784220798,453,99.34485642598271,32.401728463897406,0.4948424867577363
54089,"Summers County, West Virginia",13210,5969,7241,20142,10183,847,551,70,9,12223,410,304,714,2317,1077,1240,4275,12,7.19,83.2,4.769114307342922,17.53974261922786,630,92.52838758516276,32.36184708554126,0.4518546555639667
54091,"Taylor County, West Virginia",16977,8645,8332,23683,12289,1632,516,84,49,16544,747,442,1189,2586,1170,1416,6810,169,9.48,82.2,3.822819108205219,15.232373210814632,649,97.44949048712965,40.113094186251985,0.5092183542439771
54093,"Tucker County, West Virginia",7035,3534,3501,22385,5257,446,270,38,24,6858,216,221,437,1043,462,581,2859,6,10.36,78.6,4.719260838663824,14.82587064676617,332,97.48400852878464,40.639658848614076,0.5023454157782516
54095,"Tyler County, West Virginia",8949,4454,4495,24599,6516,613,222,41,7,8873,552,534,1086,1448,583,865,3152,19,8.61,83.7,3.0170968823332216,16.180578835624093,270,99.15074309978769,35.22181249301598,0.49770924125600624
54097,"Upshur County, West Virginia",24604,12252,12352,21279,16733,1805,952,123,143,24425,1328,965,2293,4897,2294,2603,9556,206,8.07,81.8,4.950414566737116,19.90326776133962,1218,99.27247602015932,38.839213136075436,0.4979678101121769
54099,"Wayne County, West Virginia",41063,19968,21095,20582,29210,2216,1296,226,61,40917,1841,1947,3788,8484,3934,4550,14182,195,7.61,86.6,3.8550519932786207,20.660935635486936,1583,99.64444877383532,34.537174585393174,0.48627718383946616
54101,"Webster County, West Virginia",8637,4286,4351,20314,6268,351,238,36,33,8581,273,249,522,2290,995,1295,2859,87,6.76,79.1,3.554474933425958,26.513835822623594,307,99.35162672224152,33.10177144841959,0.4962371193701517
54103,"Wetzel County, West Virginia",15793,7700,8093,22088,11338,791,413,70,66,15693,470,770,1240,3629,1618,2011,5311,63,7.37,83.1,3.4762236433863105,22.97853479389603,549,99.36680807952891,33.628822896219845,0.487557778762743
54105,"Wirt County, West Virginia",5800,2944,2856,19747,4064,153,113,1,36,5800,160,395,555,1208,521,687,1963,0,5.62,84.3,2.586206896551724,20.82758620689655,150,100,33.8448275862069,0.5075862068965518
54107,"Wood County, West Virginia",86016,41458,44558,26717,61058,8074,3665,846,532,85505,3687,2631,6318,14387,5989,8398,36157,260,7.58,84.8,5.862862723214286,16.725957961309526,5043,99.40592447916667,42.03520275297619,0.48198009672619047
54109,"Wyoming County, West Virginia",22130,10894,11236,20474,15859,861,537,82,0,22053,1084,966,2050,4866,2444,2422,6161,185,8.58,83.7,2.797107998192499,21.988251242657025,619,99.65205603253501,27.840036150022595,0.4922729326705829
55001,"Adams County, Wisconsin",20111,10770,9341,24874,15993,1293,519,142,50,18996,717,497,1214,2457,1237,1220,7395,100,6.42,81.3,3.5353786485008203,12.217194570135746,711,94.45577047387002,36.770921386306,0.5355278205956939
55003,"Ashland County, Wisconsin",15779,7954,7825,22983,10671,1430,625,196,66,15560,520,495,1015,2215,967,1248,7219,43,6.77,77.7,5.621395525698714,14.037644971164205,887,98.61207934596615,45.750681285252554,0.5040877115153052
55005,"Barron County, Wisconsin",45358,22759,22599,26935,32218,4091,1479,513,184,44788,1962,1287,3249,5138,2306,2832,21771,239,6.66,79.8,4.797389655628555,11.327659949733233,2176,98.74333083469288,47.99814806649323,0.5017637461969222
55007,"Bayfield County, Wisconsin",15004,7642,7362,28272,11439,2248,969,210,123,14903,617,531,1148,1629,748,881,6818,50,6.06,77.5,8.677685950413224,10.857104772060783,1302,99.3268461743535,45.441215675819784,0.5093308451079712
55009,"Brown County, Wisconsin",258004,128020,129984,29874,171208,35638,10972,2831,1146,255051,9268,7258,16526,28320,12268,16052,132024,1417,5.77,80,5.79409621556255,10.97657400660455,14949,98.85544410164184,51.17129966977256,0.4961938574595743
55011,"Buffalo County, Wisconsin",13243,6740,6503,28286,9528,1159,428,65,58,13163,470,319,789,1406,660,746,6668,66,6.17,82.9,4.160688665710187,10.616929698708752,551,99.39590727176622,50.351128898285886,0.508948123536963
55013,"Burnett County, Wisconsin",15239,7798,7441,26308,11634,1447,558,80,72,15098,678,463,1141,2192,1065,1127,6363,35,5.77,80.2,4.659098366034517,14.384145941334733,710,99.0747424371678,41.75470831419384,0.5117133670188333
55015,"Calumet County, Wisconsin",49737,24812,24925,32713,33454,7158,1957,294,145,49565,1065,780,1845,2917,1207,1710,27282,97,7.43,80.8,4.817339204214167,5.8648491062991335,2396,99.65418099201801,54.8525242777007,0.49886402477029174
55017,"Chippewa County, Wisconsin",63445,33015,30430,27020,44465,6361,1902,358,365,61142,2206,1584,3790,6525,3013,3512,30986,185,5.07,80.6,4.1374418787926555,10.284498384427456,2625,96.3700843250059,48.839152021435886,0.5203719757270077
55019,"Clark County, Wisconsin",34513,17507,17006,23437,21724,1799,515,114,49,34030,4174,3491,7665,4485,2115,2370,15460,216,5.44,80.4,1.9644771535363486,12.995103294410802,678,98.600527337525,44.79471503491438,0.5072581346159418
55021,"Columbia County, Wisconsin",56790,29007,27783,31290,39986,6391,1931,463,254,55411,1776,1309,3085,4585,2065,2520,29678,217,6.27,81,4.66279274520162,8.073604507835887,2648,97.57175559077302,52.25920056347949,0.5107765451664026
55023,"Crawford County, Wisconsin",16313,8469,7844,24391,11637,1321,497,79,58,15616,596,465,1061,2031,977,1054,7401,61,6.77,82.1,3.8864709127689574,12.450193097529578,634,95.72733402807577,45.36872433028873,0.5191565009501624
55025,"Dane County, Wisconsin",522837,259686,263151,37193,341196,102061,44215,11863,12435,518927,14376,11397,25773,63003,29454,33549,292066,1298,8.08,81.4,13.104084064440734,12.050218328083131,68513,99.25215698200395,55.861769538116086,0.4966863477527413
55027,"Dodge County, Wisconsin",87833,46032,41801,27000,63011,7115,2301,480,256,83556,2126,1706,3832,7293,3063,4230,43330,243,6.37,79.9,3.457698131681714,8.303257317864585,3037,95.13053180467477,49.332255530381516,0.5240854804003051
55029,"Door County, Wisconsin",27443,13602,13841,34253,21378,4399,1828,476,298,27124,676,492,1168,2282,1120,1162,13224,122,7.94,77,9.481470684691907,8.315417410632948,2602,98.83759064242247,48.18715155048646,0.4956455198046861
55031,"Douglas County, Wisconsin",43503,21734,21769,27844,30724,5065,1733,364,179,42909,1433,1413,2846,5983,2799,3184,21301,239,6.1,77.8,5.231823092660276,13.753074500609154,2276,98.63457692572926,48.96443923407581,0.4995977288922603
55033,"Dunn County, Wisconsin",44260,22296,21964,26354,26879,4754,1890,338,454,43932,1782,1304,3086,5209,2378,2831,22376,99,6.04,81.6,6.0596475372797105,11.769091730682332,2682,99.25892453682783,50.555806597379124,0.5037505648441031
55035,"Eau Claire County, Wisconsin",102388,50371,52017,27780,64097,12686,4831,1109,810,101687,4554,3546,8100,14197,6547,7650,54766,298,5.5,81.5,6.592569441731453,13.865882720631324,6750,99.31534945501426,53.48869008086885,0.4919619486658593
55037,"Florence County, Wisconsin",4354,2260,2094,28211,3410,420,101,23,5,4297,168,131,299,362,163,199,1891,25,7.07,78.9,2.962792834175471,8.314193844740469,129,98.69085898024805,43.4313275149288,0.5190629306384933
55039,"Fond du Lac County, Wisconsin",102082,49962,52120,29431,70774,11234,3780,645,563,100380,2479,2242,4721,8387,3690,4697,52411,274,6.14,80.2,4.886267902274642,8.215944044983445,4988,98.33271291706667,51.34205834525186,0.48943006602535216
55041,"Forest County, Wisconsin",9035,4574,4461,23936,6433,563,285,71,17,8834,588,574,1162,1541,722,819,3606,23,7.61,77.4,4.128389596015495,17.05589374654123,373,97.77531820697288,39.9114554510238,0.5062534587714443
55043,"Grant County, Wisconsin",51742,26915,24827,23753,31727,4327,1882,311,307,50611,2033,1648,3681,7323,3456,3867,25922,206,8.69,82.1,4.831664798422945,14.15291252754049,2500,97.81415484519346,50.09856596188783,0.5201770321982142
55045,"Green County, Wisconsin",36869,18265,18604,30208,25804,4091,1401,268,216,36515,985,846,1831,3232,1527,1705,19745,74,8.36,82,5.112696303127288,8.766172122921695,1885,99.0398437711899,53.55447666060918,0.4954026417857821
55047,"Green Lake County, Wisconsin",18745,9405,9340,26372,13275,1729,499,150,82,18554,798,914,1712,2113,1030,1083,8840,103,6.24,80.4,3.8997065884235798,11.272339290477461,731,98.98106161643105,47.15924246465724,0.5017337956788477
55049,"Iowa County, Wisconsin",23576,11870,11706,31717,16481,2704,1009,183,134,23400,841,430,1271,2100,989,1111,12152,147,8.39,81.5,5.624363759755684,8.907363420427554,1326,99.25347811333559,51.54394299287411,0.5034781133355956
55051,"Iron County, Wisconsin",5748,2923,2825,26689,4624,611,217,37,26,5642,289,186,475,851,378,473,2497,27,6.03,77.1,4.8712595685455815,14.805149617258177,280,98.15588030619345,43.44119693806542,0.5085247042449548
55053,"Jackson County, Wisconsin",20531,10952,9579,24740,14491,1288,562,108,47,19443,1094,836,1930,2502,1044,1458,9394,95,5.94,81.7,3.4922799668793534,12.186449758901174,717,94.70069650772004,45.75519945448347,0.5334372412449466
55055,"Jefferson County, Wisconsin",84586,42282,42304,28819,57551,9538,3164,585,439,84133,2616,2130,4746,7977,3616,4361,43977,112,7.04,81.4,4.951173953136453,9.43063863996406,4188,99.46445038185988,51.99087319414561,0.4998699548388622
55057,"Juneau County, Wisconsin",26427,14008,12419,24376,19276,1821,547,99,95,24801,1040,621,1661,3545,1633,1912,11827,51,5.81,81.5,2.803950505165172,13.414311121201802,741,93.847201725508,44.75347182805464,0.5300639497483635
55059,"Kenosha County, Wisconsin",167886,83033,84853,28996,111210,18591,7346,1078,910,165980,7237,5525,12762,23594,10534,13060,81133,674,8.57,80.8,5.559725051523057,14.053583979605209,9334,98.86470581227738,48.32624519018858,0.49457965524224773
55061,"Kewaunee County, Wisconsin",20378,10331,10047,28767,14427,2024,456,89,62,20248,509,333,842,1851,806,1045,10411,63,6.6,78.5,2.9787025223280006,9.083325154578468,607,99.36205712042398,51.089410148199036,0.506968299146138
55063,"La Crosse County, Wisconsin",117582,57373,60209,29495,74487,15650,6111,1633,1206,116244,3606,2742,6348,16246,6849,9397,61786,359,8.43,82.8,7.6117092752292015,13.816740657583644,8950,98.86207072511098,52.54715857869402,0.4879403310030447
55065,"Lafayette County, Wisconsin",16755,8485,8270,27023,11354,1375,544,83,32,16667,839,709,1548,1730,769,961,8523,66,8.68,81.8,3.9331542823037897,10.32527603700388,659,99.47478364667263,50.868397493285585,0.5064159952253059
55067,"Langlade County, Wisconsin",19190,9709,9481,25142,14098,1516,608,195,24,18974,817,563,1380,2779,1454,1325,8719,50,6.8,78.3,4.3095362167795725,14.481500781657113,827,98.87441375716519,45.435122459614384,0.505940594059406
55069,"Lincoln County, Wisconsin",27994,14053,13941,28603,20564,2532,767,172,89,27430,847,657,1504,2510,1162,1348,14111,105,7.18,79,3.672215474744588,8.96620704436665,1028,97.98528256054868,50.40723012074016,0.502000428663285
55071,"Manitowoc County, Wisconsin",79680,39612,40068,27777,56905,7963,2604,462,159,79237,2057,1537,3594,8036,3321,4715,40639,279,7.46,79.5,4.047439759036145,10.085341365461847,3225,99.44402610441767,51.00276104417671,0.4971385542168675
55073,"Marathon County, Wisconsin",135293,68001,67292,30151,92910,15345,5331,1568,531,134234,4997,3705,8702,13754,6108,7646,70084,372,6.68,80.1,5.491784497350196,10.166083980693754,7430,99.21725440340595,51.80164531793958,0.5026202390367572
55075,"Marinette County, Wisconsin",40712,20459,20253,25778,29941,3149,905,272,100,40217,1340,1032,2372,5224,2194,3030,18441,143,6.6,79.3,3.1366673216741994,12.831597563371979,1277,98.78414226763607,45.296227156612304,0.5025299665946158
55077,"Marquette County, Wisconsin",15164,7699,7465,26050,11302,1114,327,60,39,14997,736,453,1189,1752,838,914,6848,118,6.47,81,2.8092851490371933,11.553679767871275,426,98.8987074650488,45.15958849907676,0.507715642310736
55078,"Menominee County, Wisconsin",4506,2258,2248,17197,2562,257,125,11,14,4462,625,485,1110,1590,789,801,1531,0,6.82,79.6,3.3288948069241013,35.28628495339547,150,99.02352418996892,33.976919662671996,0.501109631602308
55079,"Milwaukee County, Wisconsin",956586,462784,493802,26933,627652,121110,49039,11406,7552,947277,48408,34792,83200,191973,86889,105084,447321,2377,5.59,80.1,7.108299724227618,20.0685563033538,67997,99.02685174150572,46.762235700710654,0.48378713466431666
55081,"Monroe County, Wisconsin",45303,22893,22410,26724,30483,4181,1258,348,148,44469,2269,1699,3968,5606,2451,3155,21449,197,7.59,81.1,3.8717082753901506,12.374456437763504,1754,98.15906231375405,47.34565039842836,0.5053307727965035
55083,"Oconto County, Wisconsin",37465,19145,18320,28437,27408,3268,1101,168,76,37205,1198,702,1900,3356,1605,1751,18884,87,6.79,79.2,3.5900173495262244,8.957693847591084,1345,99.30601895102096,50.40437741892433,0.5110102762578407
55085,"Oneida County, Wisconsin",35352,17790,17562,30550,27032,4830,1924,481,203,34844,1129,809,1938,3113,1353,1760,16585,114,7.8,77.4,7.377234668477031,8.805725277212039,2608,98.56302330844082,46.91389454627744,0.5032247114731839
55087,"Outagamie County, Wisconsin",183288,91418,91870,30858,122988,24780,7689,1517,849,181919,5528,3939,9467,15502,7019,8483,97480,515,5.84,81.2,5.485901968486753,8.457727729038453,10055,99.25308803631444,53.18406005848719,0.4987669678320457
55089,"Ozaukee County, Wisconsin",87817,43131,44686,45820,60769,18163,7231,2652,954,87307,1735,1388,3123,5087,2069,3018,45633,85,5.75,79.7,12.340435223248345,5.792728059487343,10837,99.41924684286641,51.96374278328798,0.4911463611829145
55091,"Pepin County, Wisconsin",7282,3701,3581,27901,5195,669,242,63,18,7185,310,290,600,938,431,507,3632,34,5.77,82.6,4.435594616863499,12.881076627300192,323,98.66794836583357,49.87640758033507,0.5082394946443285
55093,"Pierce County, Wisconsin",41226,20501,20725,31109,25871,4856,1783,241,290,40959,1209,1083,2292,4132,1892,2240,22902,74,6.53,80.8,5.612962693445883,10.022801144908552,2314,99.35235045844856,55.55232135060399,0.49728326784068305
55095,"Polk County, Wisconsin",43328,21809,21519,27993,30872,4256,1429,347,96,42885,1638,1478,3116,4215,1949,2266,20878,174,5.61,80.5,4.320531757754801,9.728120384047267,1872,98.97756646971935,48.1859305760709,0.5033465657311669
55097,"Portage County, Wisconsin",70371,35333,35038,28363,44737,9640,2986,657,797,70079,2144,1460,3604,8757,4246,4511,36466,164,6.49,81.2,6.309417231530034,12.44404655326768,4440,99.58505634423271,51.81964161373293,0.5020960338775916
55099,"Price County, Wisconsin",13566,6898,6668,27161,10409,1305,362,67,33,13376,357,375,732,1582,796,786,6436,31,7.1,77.4,3.4055727554179565,11.661506707946337,462,98.59943977591037,47.4421347486363,0.5084770750405425
55101,"Racine County, Wisconsin",195101,96480,98621,29582,132530,21610,8497,1277,1004,190815,6739,5499,12238,22623,9595,13028,91844,673,7.82,80.7,5.5243181736638975,11.595532570309738,10778,97.80318911743149,47.07510468936602,0.4945130983439347
55103,"Richland County, Wisconsin",17626,8897,8729,24941,12310,1460,636,130,85,17490,816,587,1403,2349,1152,1197,8261,46,7.87,82,4.828094859866107,13.326903438102804,851,99.22841257233632,46.868262793600366,0.5047656870532169
55105,"Rock County, Wisconsin",161226,79293,81933,26954,108792,15410,6125,1007,768,159873,6854,4904,11758,22550,9920,12630,76363,502,8.76,82.7,4.899954101695756,13.986577847245481,7900,99.16080532916527,47.36394874275861,0.49181273491868555
55107,"Rusk County, Wisconsin",14211,7160,7051,23574,10268,1022,343,110,42,14077,825,593,1418,2118,1021,1097,6367,41,6.52,79.2,3.4832172260924636,14.903947646189572,495,99.0570684680881,44.803321370769126,0.5038350573499402
55109,"St. Croix County, Wisconsin",87142,43468,43674,36561,58155,13963,4239,903,692,86320,2351,1756,4107,4103,1729,2374,46610,317,6.86,81,6.6948199490486795,4.70840696793739,5834,99.05671203323311,53.48741135158706,0.4988180211608639
55111,"Sauk County, Wisconsin",63340,31555,31785,28331,44014,6924,2527,504,366,62624,2648,2223,4871,7062,2996,4066,33223,220,7.58,81.6,5.363119671613514,11.14935269971582,3397,98.86959267445532,52.45184717398168,0.49818440164193245
55113,"Sawyer County, Wisconsin",16384,8315,8069,29712,12087,1713,678,183,91,16101,848,608,1456,2825,1196,1629,7079,42,6.64,77.8,5.810546875,17.242431640625,952,98.272705078125,43.206787109375,0.50750732421875
55115,"Shawano County, Wisconsin",41136,20632,20504,26627,29299,2945,1292,245,147,40565,1602,1531,3133,4618,2065,2553,19878,100,6.97,80.6,4.093737845196421,11.226176584986387,1684,98.61192143134967,48.32263710618437,0.5015558148580319
55117,"Sheboygan County, Wisconsin",115094,57875,57219,28849,79451,13283,4585,561,507,112857,3432,2552,5984,9153,4079,5074,58652,368,5.45,79.8,4.911637444176065,7.952630024154169,5653,98.05637131388256,50.96008480025023,0.502849844474951
55119,"Taylor County, Wisconsin",20344,10402,9942,26290,14058,1403,519,71,37,20130,1102,753,1855,2190,1012,1178,10030,146,6.42,78.7,3.081989775855289,10.76484467164766,627,98.94809280377507,49.30200550530869,0.511305544632324
55121,"Trempealeau County, Wisconsin",29510,14902,14608,26654,20076,2776,949,129,93,29112,1414,948,2362,2605,1069,1536,15017,151,6.24,82.6,3.96814639105388,8.827516096238563,1171,98.65130464249407,50.88783463232802,0.5049813622500847
55123,"Vernon County, Wisconsin",30378,15240,15138,25314,20379,2881,1137,211,181,30075,2602,2391,4993,4966,2135,2831,13293,167,8.44,81.5,5.0332477450786755,16.347356639673446,1529,99.00256764763974,43.75864112186451,0.5016788465336757
55125,"Vilas County, Wisconsin",21465,10734,10731,29058,16692,2969,1143,251,161,21288,1064,665,1729,3240,1449,1791,8869,73,7.3,76.6,7.244351269508503,15.09433962264151,1555,99.17540181691125,41.318425343582575,0.5000698812019567
55127,"Walworth County, Wisconsin",102917,51330,51587,29192,67369,12204,5452,878,676,102212,4851,3523,8374,12405,5654,6751,52125,281,8.15,81.5,6.807427344364877,12.053402256187024,7006,99.31498197576688,50.64760923851259,0.498751421048029
55129,"Washburn County, Wisconsin",15638,7716,7922,28232,11719,1755,633,127,66,15457,603,425,1028,2000,864,1136,6894,50,6.5,78.7,5.282005371530886,12.78935925310142,826,98.84256298759432,44.08492134544059,0.4934134799846528
55131,"Washington County, Wisconsin",133967,66558,67409,36177,93734,20316,5898,1210,418,133151,3179,2392,5571,7320,2885,4435,72616,531,6.47,80.3,5.617801398851956,5.464032187031134,7526,99.39089477259326,54.204393619324165,0.49682384467816704
55133,"Waukesha County, Wisconsin",396731,194879,201852,42094,277757,78511,29424,7498,3771,394253,7592,5734,13326,19634,8275,11359,209631,1015,6.59,80.8,10.257075953227753,4.948945255097282,40693,99.37539541906229,52.839581479642376,0.491211929493788
55135,"Waupaca County, Wisconsin",51651,26305,25346,29423,37085,5022,1440,288,116,50177,2020,1372,3392,5506,2412,3094,25574,181,5.42,81.4,3.570114809006602,10.660006582641188,1844,97.14623143791988,49.51307815918375,0.5092834601459797
55137,"Waushara County, Wisconsin",24170,12679,11491,25838,18133,1756,803,116,73,22996,1060,819,1879,2538,1138,1400,10245,127,6.23,81.2,4.10426148117501,10.500620604054614,992,95.14273893256103,42.38725693007861,0.524575920562681
55139,"Winnebago County, Wisconsin",169540,85384,84156,29763,113634,22213,6434,1515,889,164505,4978,3818,8796,19750,8248,11502,86593,286,6.63,81.2,5.212929102276749,11.649168337855373,8838,97.03019936298219,51.07526247493217,0.5036215642326295
55141,"Wood County, Wisconsin",73427,36265,37162,29039,52010,6961,2600,973,439,72797,2193,1543,3736,8037,3565,4472,35868,183,5.75,81.4,5.463930161929535,10.945564982908195,4012,99.14200498454247,48.848516213382,0.49389189262805233
56001,"Albany County, Wyoming",37944,19883,18061,26034,20905,5919,2762,498,1225,37737,1712,1352,3064,8205,4317,3888,20719,48,2.37,80.9,11.820050600885516,21.623972169512967,4485,99.45445920303605,54.60415348935273,0.5240090659919882
56003,"Big Horn County, Wyoming",11920,6015,5905,23724,8030,1122,342,38,41,11686,1024,875,1899,1518,654,864,5209,63,2.83,86.9,3.5318791946308723,12.734899328859061,421,98.03691275167785,43.6996644295302,0.5046140939597316
56005,"Campbell County, Wyoming",48116,25001,23115,33200,30465,4266,1020,247,107,47651,2273,2302,4575,4450,2229,2221,25203,354,3.55,91.7,2.8555989691578687,9.248482833153213,1374,99.03358550170421,52.379665807631554,0.5195984703632888
56007,"Carbon County, Wyoming",15689,8456,7233,27797,10644,1607,458,110,48,14874,973,830,1803,1985,858,1127,7373,65,2.18,82.6,3.9263178022818535,12.652176684301102,616,94.80527758301994,46.994709669194975,0.5389763528586908
56009,"Converse County, Wyoming",14166,7279,6887,31948,9527,1173,422,67,68,14112,568,645,1213,1120,404,716,6720,27,2.8,88.3,3.9319497388112383,7.906254411972328,557,99.61880559085134,47.43752647183397,0.5138359452209516
56011,"Crook County, Wyoming",7347,3760,3587,34186,5109,724,262,49,25,7281,372,395,767,370,164,206,3523,92,2.95,91.1,4.573295222539812,5.036069143868246,336,99.10167415271539,47.951544848237376,0.5117735129985028
56013,"Fremont County, Wyoming",40354,20206,20148,27220,26781,4158,1392,401,280,39700,3775,3721,7496,5380,2384,2996,17489,195,3.03,83,5.13703722059771,13.332011696486099,2073,98.37934281607771,43.33895028993408,0.5007186400356842
56015,"Goshen County, Wyoming",13479,6967,6512,27253,9449,1442,590,127,142,13104,1009,799,1808,1701,752,949,6070,95,3.1,91.6,6.372876326136954,12.61963053638994,859,97.21789450255953,45.03301431856963,0.5168781066844721
56017,"Hot Springs County, Wyoming",4741,2404,2337,30939,3604,478,223,26,50,4663,249,284,533,579,222,357,2216,8,3.88,86,6.306686353090066,12.21261337270618,299,98.35477747310694,46.74119384096182,0.5070660198270407
56019,"Johnson County, Wyoming",8562,4548,4014,32732,6063,1098,389,82,55,8499,557,407,964,838,574,264,4130,117,4.79,86.7,6.143424433543564,9.78743284279374,526,99.26419060967064,48.236393366035976,0.5311843027330063
56021,"Laramie County, Wyoming",97031,49218,47813,31554,65206,11648,5025,1201,821,93741,4516,4467,8983,9828,4273,5555,48515,545,3.58,87.8,7.262627407735672,10.128721748719482,7047,96.60933103853408,49.999484700765734,0.507239954241428
56023,"Lincoln County, Wyoming",18791,9630,9161,29516,12453,1836,517,111,90,18684,1231,983,2214,1728,718,1010,8874,85,4.66,81,3.8209781278271513,9.195891650258103,718,99.43057846841573,47.2247352455963,0.5124793784258421
56025,"Natrona County, Wyoming",81023,41061,39962,31900,54380,8086,3098,667,551,79886,6336,4824,11160,7849,3600,4249,40965,189,2.78,87.3,5.326882490157116,9.687372721326044,4316,98.59669476568382,50.55971761104871,0.5067820248571393
56027,"Niobrara County, Wyoming",2479,1098,1381,23370,1766,251,50,15,8,2171,190,155,345,321,125,196,1047,20,2.58,90.9,2.9447357805566763,12.948769665187575,73,87.57563533682936,42.23477208551835,0.4429205324727713
56029,"Park County, Wyoming",29276,14360,14916,32557,20668,3959,2055,305,342,29039,1603,1403,3006,2000,627,1373,14823,51,4.07,79.2,9.229402923896707,6.831534362617844,2702,99.19046317802979,50.631916928542154,0.4905041672359612
56031,"Platte County, Wyoming",8703,4535,4168,31242,6286,920,496,5,2,8596,531,365,896,902,358,544,4246,11,2.85,89.9,5.779616224290475,10.364242215328048,503,98.77053889463403,48.78777433069057,0.5210846834424911
56033,"Sheridan County, Wyoming",29964,14816,15148,31643,21072,3861,1937,536,260,29498,1588,1171,2759,1986,824,1162,14430,13,4.38,86.6,9.120945134160992,6.627953544253104,2733,98.44480042717929,48.15778934721666,0.49446001868909356
56035,"Sublette County, Wyoming",10037,5447,4590,32175,7051,1354,386,53,0,10016,919,432,1351,743,450,293,5181,15,4.1,78,4.373816877553054,7.402610341735579,439,99.79077413569792,51.619009664242306,0.5426920394540201
56037,"Sweetwater County, Wyoming",44527,22981,21546,31700,28393,4348,1368,259,331,44244,2797,2674,5471,5274,2216,3058,22324,172,1.74,85.6,4.39733195589193,11.844498843398387,1958,99.36443057021583,50.13587261661464,0.516113818581984
56039,"Teton County, Wyoming",22923,12169,10754,49200,17008,6407,2179,454,165,22865,2061,613,2674,1561,861,700,14152,207,9.1,75.7,12.206081228460498,6.809754395148977,2798,99.74697901670811,61.73711992322122,0.5308641975308642
56041,"Uinta County, Wyoming",20758,10593,10165,27115,12978,1548,618,60,33,20575,1483,1296,2779,3048,1550,1498,9381,79,2.16,81.4,3.4251854706619134,14.683495519799596,711,99.11841217843723,45.19221504961942,0.5103092783505154
56043,"Washakie County, Wyoming",8253,4118,4135,27345,5705,876,227,69,26,8090,629,727,1356,1039,410,629,3687,26,4.31,89.8,3.9016115351993212,12.589361444323277,322,98.02496062038047,44.67466375863322,0.49897007148915545
56045,"Weston County, Wyoming",7117,3756,3361,30955,5074,717,237,30,23,6758,399,467,866,973,478,495,3350,33,2.44,90.4,4.074750597161725,13.671490796683996,290,94.95573977799634,47.070394829282,0.5277504566530842
