GEOID,COUNTY,POP_TOT,MALE_POP,FEMALE_POP,GDP,DEGREE_TOT,BACHELOR,MASTER,PROFFE,DOCTOR,TOT_NO_INS,MALE_INS,FEMALE_INS,BOTH_INS,TOT_POV,MALE_POV,FEMALE_POV,TOT_COMM,OTHER_COMM
29229,"Wright County, Missouri",18378,9003,9375,19805,12416,811,400,90,89,18184,1799,1556,3355,4560,2121,2439,6494,105
29047,"Clay County, Missouri",233135,114237,118898,31953,155930,33780,12357,2535,1033,231632,11299,9828,21127,20867,9412,11455,118872,792
29065,"Dent County, Missouri",15578,7764,7814,20908,10914,872,431,48,21,15400,1589,1239,2828,3426,1543,1883,5768,151
29195,"Saline County, Missouri",23214,11587,11627,21729,15127,1761,865,143,82,22756,1048,1059,2107,3748,1759,1989,10520,136
29227,"Worth County, Missouri",2061,984,1077,22961,1500,161,64,26,9,2001,122,111,233,262,103,159,970,1
29079,"Grundy County, Missouri",10231,4950,5281,22014,6870,763,392,89,39,10050,911,743,1654,1975,911,1064,4354,60
29141,"Morgan County, Missouri",20182,10136,10046,20055,14402,1158,404,104,25,19847,2420,2373,4793,4798,2421,2377,6961,258
29179,"Reynolds County, Missouri",6530,3374,3156,21593,4745,305,117,8,3,6385,400,431,831,1245,625,620,2392,47
29189,"St. Louis County, Missouri",1000560,474388,526172,38081,687472,169996,85313,22202,13854,988628,42118,38709,80827,100613,42309,58304,486100,3221
29209,"Stone County, Missouri",31197,15297,15900,26052,23805,2757,943,185,128,30890,2063,2154,4217,4139,1808,2331,12015,30
29009,"Barry County, Missouri",35716,17958,17758,20840,24688,2111,866,137,49,35416,3525,2883,6408,7876,3596,4280,13885,149
29019,"Boone County, Missouri",172773,83740,89033,28495,101676,26549,12780,3824,4381,171399,7545,6232,13777,31461,14160,17301,89093,607
29051,"Cole County, Missouri",76603,38731,37872,27559,51995,10752,4317,1011,423,72589,3447,3203,6650,9067,4299,4768,36044,352
29055,"Crawford County, Missouri",24545,12098,12447,20799,16873,1347,567,74,123,24253,1930,1899,3829,5166,2374,2792,9187,40
29093,"Iron County, Missouri",10220,5071,5149,19414,7259,504,255,18,49,9883,852,722,1574,2124,1098,1026,3714,59
29117,"Livingston County, Missouri",15057,6773,8284,22248,10682,1450,555,98,9,13872,987,897,1884,2463,1059,1404,6571,68
29135,"Moniteau County, Missouri",15840,8295,7545,21305,10584,1476,370,51,38,14490,1087,1089,2176,1779,851,928,6718,115
29155,"Pemiscot County, Missouri",17599,8318,9281,18883,11387,869,391,28,40,17421,1333,1462,2795,5036,2063,2973,6358,46
29159,"Pettis County, Missouri",42193,20704,21489,22304,27875,3165,1116,326,196,41436,3223,2780,6003,7000,3034,3966,18521,56
29203,"Shannon County, Missouri",8256,4056,4200,17903,5766,585,224,39,19,8191,747,646,1393,1831,781,1050,3110,65
29175,"Randolph County, Missouri",25081,13155,11926,19984,17167,1599,640,115,117,23025,1311,1270,2581,4025,1841,2184,9559,44
29069,"Dunklin County, Missouri",31271,15043,16228,18878,20521,1407,600,280,62,30587,2578,2551,5129,8355,3744,4611,11341,92
29071,"Franklin County, Missouri",102063,50830,51233,27209,69763,8867,3917,614,363,101300,5008,4590,9598,12057,5583,6474,48448,229
29089,"Howard County, Missouri",10148,5075,5073,23430,6566,1049,489,34,90,10022,485,376,861,1719,906,813,4731,89
29095,"Jackson County, Missouri",683643,330662,352981,28965,459102,85778,35470,8893,4957,676819,47766,42165,89931,115709,51744,63965,326636,3229
29131,"Miller County, Missouri",25011,12354,12657,23346,17171,1793,799,60,38,24716,1694,1360,3054,4763,2072,2691,10697,202
29171,"Putnam County, Missouri",4877,2448,2429,20729,3432,424,172,22,15,4821,336,368,704,900,413,487,2137,7
29213,"Taney County, Missouri",53853,26219,27634,21381,37036,4644,1555,423,210,53400,5092,5268,10360,9264,4164,5100,23259,133
29021,"Buchanan County, Missouri",89415,44984,44431,24271,59825,8257,2763,716,517,86414,5686,5129,10815,15652,7136,8516,41283,265
29025,"Caldwell County, Missouri",9057,4610,4447,24200,6223,826,208,55,22,8861,421,338,759,1153,502,651,3742,28
29037,"Cass County, Missouri",101324,49752,51572,30618,67897,11052,4858,809,448,100456,4491,3917,8408,9330,3770,5560,48407,239
29049,"Clinton County, Missouri",20494,10286,10208,27655,14059,1869,541,139,65,20025,1191,1176,2367,1887,771,1116,9699,55
29059,"Dallas County, Missouri",16508,8209,8299,19647,11363,975,425,61,34,16306,1723,1677,3400,2970,1401,1569,5710,109
29085,"Hickory County, Missouri",9267,4523,4744,19711,7174,468,173,37,26,9183,753,700,1453,2295,1007,1288,2936,77
29113,"Lincoln County, Missouri",54286,27178,27108,24023,35324,3625,1405,134,210,53787,2452,2726,5178,7358,3193,4165,23753,221
29137,"Monroe County, Missouri",8642,4333,4309,22255,6118,575,229,38,16,8533,629,630,1259,1333,620,713,3822,75
29145,"Newton County, Missouri",58741,29291,29450,25837,39172,4685,1816,482,239,58116,4579,4261,8840,8294,3777,4517,25885,336
29163,"Pike County, Missouri",18475,10249,8226,20947,12757,1220,375,90,13,16204,1239,990,2229,2447,1022,1425,7426,94
29183,"St. Charles County, Missouri",379856,186762,193094,35628,254000,60331,26554,2715,2211,377983,11924,11271,23195,22765,9862,12903,200349,1260
29031,"Cape Girardeau County, Missouri",78089,37830,40259,25965,50061,9417,4008,845,676,76947,3362,3454,6816,13236,5944,7292,36486,237
29205,"Shelby County, Missouri",6148,3065,3083,22349,4241,402,147,19,25,5936,469,414,883,928,407,521,2900,13
29225,"Webster County, Missouri",37075,18883,18192,20468,24057,2421,1126,224,125,36166,3166,2899,6065,6737,3124,3613,14463,166
29005,"Atchison County, Missouri",5380,2656,2724,28209,3945,666,153,46,16,5285,363,246,609,635,285,350,2597,8
29013,"Bates County, Missouri",16513,8097,8416,25873,11323,942,537,18,63,16211,1179,1055,2234,2623,1208,1415,7123,49
29015,"Benton County, Missouri",18825,9336,9489,20163,14451,1035,377,81,38,18622,1254,1149,2403,3581,1575,2006,5971,46
29035,"Carter County, Missouri",6249,2998,3251,21569,4247,354,106,35,21,6216,578,504,1082,1275,590,685,2410,75
29057,"Dade County, Missouri",7590,3871,3719,20468,5459,514,227,51,23,7453,707,546,1253,1520,792,728,3117,45
29115,"Linn County, Missouri",12319,5900,6419,22361,8459,794,302,119,18,12246,814,866,1680,2241,926,1315,5302,70
29091,"Howell County, Missouri",40265,19617,20648,20274,27214,2144,1260,333,175,39841,2452,2692,5144,8980,3991,4989,16125,164
29101,"Johnson County, Missouri",54229,27952,26277,23304,31046,5175,2523,395,535,50409,2750,2324,5074,8426,4431,3995,26552,112
29105,"Laclede County, Missouri",35505,17608,17897,20534,24121,2316,715,170,97,35149,2652,2704,5356,6698,3170,3528,14720,159
29125,"Maries County, Missouri",8987,4453,4534,22087,6367,612,200,64,13,8879,530,636,1166,1675,830,845,3587,38
29161,"Phelps County, Missouri",44833,23404,21429,23691,27780,4210,2221,479,827,43958,2477,2058,4535,8620,4557,4063,18702,193
29165,"Platte County, Missouri",94970,46798,48172,37443,64196,16503,7302,1475,866,94004,3443,3609,7052,6689,2732,3957,50502,209
29187,"St. Francois County, Missouri",66230,35676,30554,20944,46050,3947,1884,315,192,59694,4187,3476,7663,9955,4650,5305,25795,207
29510,"St. Louis city, Missouri",316030,152766,163264,26739,218566,40651,20825,5979,4688,311212,24291,21385,45676,81916,36978,44938,146727,1234
29003,"Andrew County, Missouri",17347,8574,8773,28003,12005,1865,872,102,40,17139,692,554,1246,1568,836,732,8397,28
29023,"Butler County, Missouri",42887,20730,22157,20855,29211,2805,1256,329,168,42251,3126,2091,5217,9053,3644,5409,16879,288
29033,"Carroll County, Missouri",9009,4366,4643,24642,6248,655,370,43,14,8915,553,564,1117,1632,731,901,3763,48
51810,"Virginia Beach city, Virginia",449733,221023,228710,34607,301104,67672,26544,5820,3069,424254,21377,18309,39686,35924,15175,20749,235755,2254
51005,"Alleghany County, Virginia",15919,7788,8131,25952,11720,1234,475,99,101,15672,647,657,1304,2847,1283,1564,6356,52
51640,"Galax city, Virginia",6858,3290,3568,22572,4941,262,128,49,37,6569,474,335,809,1642,851,791,2849,37
51193,"Westmoreland County, Virginia",17528,8640,8888,32265,12916,1723,782,140,92,17381,1193,968,2161,1940,920,1020,7450,107
51133,"Northumberland County, Virginia",12272,5966,6306,33364,9634,1572,751,156,128,12272,615,441,1056,1343,600,743,4778,83
51155,"Pulaski County, Virginia",34417,17147,17270,26328,25510,3026,1211,170,240,33383,1634,1568,3202,4491,2104,2387,15330,261
51187,"Warren County, Virginia",38807,19357,19450,30009,26608,3559,1453,178,144,38438,2186,2162,4348,3937,1600,2337,18100,116
51590,"Danville city, Virginia",42360,19379,22981,21882,29166,3343,1260,464,244,41241,2530,2320,4850,9135,3878,5257,16390,154
51630,"Fredericksburg city, Virginia",27853,13066,14787,32359,16441,4134,2059,368,393,27636,1658,1726,3384,4194,1826,2368,13739,53
51009,"Amherst County, Virginia",31999,15346,16653,24296,22495,2742,1257,103,145,31822,2031,1804,3835,4405,2271,2134,14478,215
51017,"Bath County, Virginia",4558,2465,2093,28195,3453,367,146,20,0,4497,199,285,484,373,238,135,2170,0
51670,"Hopewell city, Virginia",22332,10383,11949,22668,14820,1412,598,25,97,21976,1289,1102,2391,4509,1951,2558,9310,177
51700,"Newport News city, Virginia",181606,88071,93535,26028,115809,17537,8794,1246,1054,172213,11105,10313,21418,27776,12117,15659,88159,583
51069,"Frederick County, Virginia",82321,40925,41396,32554,56274,9899,4809,777,736,81286,4706,4212,8918,4800,2060,2740,41296,201
51680,"Lynchburg city, Virginia",78755,36987,41768,22439,44000,8621,4017,1156,853,77278,4539,4327,8866,16598,7093,9505,34428,355
51199,"York County, Virginia",66919,32825,34094,38193,44447,10167,6823,1003,1219,63499,2084,1701,3785,4052,1807,2245,32672,232
51690,"Martinsville city, Virginia",13551,6225,7326,22544,9458,1068,404,178,79,13190,1024,1181,2205,3159,1316,1843,5286,152
51125,"Nelson County, Virginia",14831,7171,7660,33597,10854,1594,1203,291,174,14777,960,825,1785,2125,1075,1050,6613,282
51143,"Pittsylvania County, Virginia",62392,30667,31725,23597,45313,4326,1865,302,133,61461,3411,3130,6541,9254,3761,5493,27181,244
51530,"Buena Vista city, Virginia",6610,2916,3694,17969,4129,426,153,41,47,6532,592,621,1213,1694,597,1097,2799,71
51610,"Falls Church city, Virginia",13597,6577,7020,65510,9328,3489,2623,847,523,13520,136,318,454,365,153,212,7487,48
51730,"Petersburg city, Virginia",31997,14709,17288,21992,22112,2147,1157,196,168,31125,2506,2000,4506,9191,3791,5400,12960,283
51735,"Poquoson city, Virginia",12068,5912,6156,39305,8493,2038,1070,138,133,11864,239,224,463,563,212,351,6204,18
51600,"Fairfax city, Virginia",23620,11626,11994,46489,16617,5082,2945,558,509,23084,1458,1156,2614,1415,698,717,12239,13
51820,"Waynesboro city, Virginia",21366,10205,11161,23640,14662,1956,1080,159,123,21208,1824,1476,3300,3351,1368,1983,9779,194
51770,"Roanoke city, Virginia",99329,47524,51805,24697,69292,10039,3727,1522,583,98013,7992,6749,14741,21610,9381,12229,46264,506
51800,"Suffolk city, Virginia",87061,42144,44917,31239,57919,9391,4587,986,437,84759,4278,3419,7697,9914,4035,5879,40928,279
51710,"Norfolk city, Virginia",245724,128011,117713,26670,150374,24064,11425,2684,1844,218963,17487,14496,31983,46307,21493,24814,124486,1159
51041,"Chesterfield County, Virginia",331839,159789,172050,35370,220124,51287,23690,4408,3579,329363,13960,13839,27799,24148,10353,13795,166686,1641
51059,"Fairfax County, Virginia",1132887,560803,572084,52976,768784,238610,164811,35616,24233,1119536,60428,54440,114868,67306,29776,37530,605414,5656
53047,"Okanogan County, Washington",41299,20785,20514,22755,28657,3290,1418,394,177,40781,3823,3084,6907,8637,4313,4324,16484,255
53037,"Kittitas County, Washington",42785,21381,21404,26698,25606,6059,2030,266,519,42452,2649,2178,4827,8402,3731,4671,19510,165
53005,"Benton County, Washington",187519,93970,93549,30511,120427,22103,9350,1657,2311,185968,10804,8563,19367,25797,11494,14303,82498,308
53011,"Clark County, Washington",450893,222759,228134,32162,299896,54925,21248,4535,2911,448292,22957,18600,41557,45773,20420,25353,203037,1488
53003,"Asotin County, Washington",22113,10635,11478,26878,15737,2336,748,127,96,21921,1090,1089,2179,3154,1363,1791,9400,82
53001,"Adams County, Washington",19100,9716,9384,18415,10473,980,359,85,20,18882,2122,1686,3808,4322,2061,2261,7711,100
53023,"Garfield County, Washington",2231,1102,1129,24781,1649,300,88,3,8,2206,91,112,203,250,103,147,864,5
53045,"Mason County, Washington",61060,31442,29618,26312,44688,5580,2053,409,255,59883,5023,3210,8233,10136,5414,4722,22178,64
53057,"Skagit County, Washington",120475,59573,60902,30069,83393,13133,5353,1389,736,119303,7319,6008,13327,17805,8047,9758,51906,530
53065,"Stevens County, Washington",43744,21911,21833,24707,30980,3564,1568,323,135,43496,2468,2022,4490,7133,3265,3868,15664,181
53063,"Spokane County, Washington",485859,240656,245203,28325,326281,59298,24013,6625,3845,476871,24183,18931,43114,73462,35626,37836,213480,1531
53043,"Lincoln County, Washington",10326,5249,5077,26918,7481,1168,351,80,45,10213,481,405,886,1506,738,768,4129,140
53007,"Chelan County, Washington",74761,37199,37562,27605,50144,7559,3725,910,498,74136,5429,4781,10210,9318,4216,5102,32418,490
53031,"Jefferson County, Washington",30333,14876,15457,32317,24605,5626,2719,568,629,29603,1196,1224,2420,3541,1513,2028,11344,224
53035,"Kitsap County, Washington",257488,131150,126338,34412,176275,35746,13776,3296,2093,243892,10864,7951,18815,26110,11721,14389,118652,970
53033,"King County, Washington",2079550,1037792,1041758,46316,1464776,441453,193995,47865,35241,2066068,95653,75956,171609,219317,102151,117166,1086503,8031
53049,"Pacific County, Washington",20743,10368,10375,23050,15801,1784,646,158,104,20500,1378,955,2333,3829,1765,2064,6945,171
53051,"Pend Oreille County, Washington",13001,6677,6324,26128,9574,1258,452,47,33,12889,754,644,1398,2543,1153,1390,4096,117
53055,"San Juan County, Washington",16056,7739,8317,40784,12947,3450,1708,463,466,16002,943,812,1755,1749,711,1038,7333,113
53059,"Skamania County, Washington",11316,5713,5603,28644,8164,1119,584,67,85,11279,541,541,1082,1597,742,855,4554,31
53075,"Whitman County, Washington",47494,24138,23356,22154,22920,5860,3182,668,1704,47247,1995,1480,3475,12246,6287,5959,21017,87
53077,"Yakima County, Washington",247681,123899,123782,21510,148605,14009,5910,1940,838,244752,25279,19620,44899,50081,22744,27337,100448,733
53009,"Clallam County, Washington",72969,36072,36897,28857,54880,8087,3717,1007,501,72010,4637,3255,7892,11273,5114,6159,27438,244
53015,"Cowlitz County, Washington",102854,50660,52194,25878,70866,6964,3397,614,263,101858,5186,4072,9258,17070,7777,9293,40257,302
53019,"Ferry County, Washington",7639,3874,3765,21951,5580,666,285,23,34,7566,463,438,901,1771,920,851,2339,39
53041,"Lewis County, Washington",75724,37742,37982,23853,53024,5137,2370,519,198,74875,4695,3329,8024,12131,5543,6588,28668,146
53017,"Douglas County, Washington",40101,20132,19969,25060,26145,3381,864,218,164,39969,3028,2627,5655,5330,2424,2906,17870,717
53029,"Island County, Washington",80113,39928,40185,33837,57535,11517,4918,1120,679,74976,3158,2410,5568,7362,2939,4423,35691,464
13101,"Echols County, Georgia",4025,1911,2114,20589,2555,141,39,10,11,4025,645,674,1319,1214,439,775,1721,30
13127,"Glynn County, Georgia",82623,38982,43641,29209,56717,9697,4449,1313,515,81610,6553,6743,13296,15177,6288,8889,35704,459
13089,"DeKalb County, Georgia",723902,344188,379714,32110,485606,117894,56677,15973,12170,717481,64035,59000,123035,134830,60830,74000,345582,2778
13143,"Haralson County, Georgia",28667,13977,14690,23141,19290,1468,721,308,158,28327,2326,2106,4432,5721,2556,3165,11116,91
13157,"Jackson County, Georgia",62131,30638,31493,25598,41310,5270,1723,664,220,61604,4284,4400,8684,8330,3734,4596,26596,159
13163,"Jefferson County, Georgia",16201,7835,8366,17485,10734,766,310,38,4,15707,1713,1531,3244,4535,1959,2576,5289,18
13169,"Jones County, Georgia",28701,13910,14791,26098,19454,2308,1203,311,114,28373,2147,1704,3851,3888,1685,2203,12277,21
13181,"Lincoln County, Georgia",7712,3606,4106,24529,5626,477,201,40,22,7620,557,580,1137,1939,775,1164,3046,31
13213,"Murray County, Georgia",39358,19520,19838,19084,25808,1701,679,274,150,39150,4065,3609,7674,7315,3479,3836,16202,99
13215,"Muscogee County, Georgia",200303,98284,102019,24604,128278,19564,8557,2461,1490,187954,14610,12816,27426,40006,17264,22742,86877,1093
13235,"Pulaski County, Georgia",11460,4756,6704,18623,8381,451,416,53,70,9874,787,835,1622,2342,901,1441,3743,0
13241,"Rabun County, Georgia",16312,8066,8246,26942,12185,1896,764,254,295,16109,2011,1592,3603,3491,1648,1843,6108,23
13259,"Stewart County, Georgia",5791,3528,2263,14954,4204,359,50,27,2,4039,525,371,896,1666,664,1002,1319,0
13281,"Towns County, Georgia",10976,5211,5765,22301,8085,1244,527,152,109,10807,726,706,1432,1528,642,886,3885,90
13283,"Treutlen County, Georgia",6711,3296,3415,20775,4602,526,149,46,38,6341,543,531,1074,1184,482,702,2716,37
13287,"Turner County, Georgia",8151,4040,4111,20302,5498,437,113,111,14,7802,1013,693,1706,2157,985,1172,2951,32
13003,"Atkinson County, Georgia",8268,4244,4024,19904,5211,206,112,23,7,8239,1134,987,2121,2270,1012,1258,3350,29
13001,"Appling County, Georgia",18410,8971,9439,19936,12326,794,382,218,75,17935,1703,1616,3319,3694,1503,2191,6862,68
13025,"Brantley County, Georgia",18403,9119,9284,18220,12177,656,321,128,53,18344,2250,2219,4469,3846,1562,2284,6451,36
13017,"Ben Hill County, Georgia",17405,8396,9009,16635,11400,779,317,87,20,17082,1700,1627,3327,5948,2539,3409,5601,59
13047,"Catoosa County, Georgia",65645,31839,33806,25643,44671,5890,2093,616,179,65161,4875,4273,9148,7700,3235,4465,30445,105
13055,"Chattooga County, Georgia",25046,13032,12014,17716,17270,991,405,111,23,23285,1927,2005,3932,5182,2186,2996,8910,32
13073,"Columbia County, Georgia",139904,68243,71661,31720,91502,19636,8159,2527,1795,136346,5980,6004,11984,13225,5897,7328,63008,398
13115,"Floyd County, Georgia",96199,46869,49330,23929,63533,7424,3185,1413,558,94051,7770,6992,14762,18192,8626,9566,39726,349
13117,"Forsyth County, Georgia",203841,101074,102767,39896,131143,42712,16471,2536,1584,203195,10248,9856,20104,13024,5697,7327,96413,758
13147,"Hart County, Georgia",25518,12561,12957,21668,17939,1539,555,227,128,24666,2496,1864,4360,5228,2348,2880,9751,45
13185,"Lowndes County, Georgia",113898,55878,58020,21199,65985,9519,4296,1070,856,108760,9960,9010,18970,27436,12180,15256,48555,317
13199,"Meriwether County, Georgia",21195,10224,10971,19679,14705,937,407,109,39,21069,1748,1781,3529,4943,2116,2827,7657,62
13237,"Putnam County, Georgia",21259,10526,10733,27498,15427,1898,681,158,85,21092,2132,1290,3422,3727,1984,1743,9063,203
13261,"Sumter County, Georgia",31070,14699,16371,18785,19329,1860,1178,479,339,30177,2385,2096,4481,9749,4144,5605,11224,21
13301,"Warren County, Georgia",5504,2563,2941,20712,3896,304,126,36,5,5428,406,524,930,1432,627,805,2028,21
13007,"Baker County, Georgia",3250,1577,1673,22270,2391,139,109,12,3,3250,368,247,615,509,240,269,1308,16
13035,"Butts County, Georgia",23479,12469,11010,21236,16306,1169,262,219,14,20915,1696,1604,3300,4255,1848,2407,8562,91
13043,"Candler County, Georgia",10962,5410,5552,18233,7238,671,168,109,82,10682,1202,1077,2279,3155,1414,1741,4215,79
13045,"Carroll County, Georgia",113756,55651,58105,23139,70887,7749,3232,1051,859,112668,9232,8219,17451,21157,8637,12520,47754,470
13099,"Early County, Georgia",10480,4822,5658,17972,6993,551,352,67,14,10329,994,904,1898,3216,1224,1992,3742,92
13081,"Crisp County, Georgia",23061,10784,12277,21225,15182,1537,499,149,104,22633,1998,2101,4099,7439,3097,4342,8385,83
13077,"Coweta County, Georgia",135625,66160,69465,31548,89400,16644,6450,1328,686,135011,7490,6937,14427,16138,6377,9761,63327,870
13067,"Cobb County, Georgia",728388,352083,376305,36587,481463,142039,55252,11995,7304,723395,57857,53580,111437,83479,37326,46153,368545,4951
13083,"Dade County, Georgia",16356,7990,8366,23184,11161,1039,358,85,58,16156,1322,1258,2580,2502,1033,1469,7423,36
13317,"Wilkes County, Georgia",9924,4723,5201,21957,6884,511,228,109,101,9821,916,666,1582,2620,1106,1514,3629,14
13027,"Brooks County, Georgia",15645,7540,8105,20964,10790,1011,259,60,12,15595,1632,1367,2999,3819,1431,2388,5533,59
13129,"Gordon County, Georgia",56079,27736,28343,21208,37178,2857,1326,352,267,55548,5159,4883,10042,11388,5249,6139,23718,496
13105,"Elbert County, Georgia",19394,9234,10160,21138,13464,824,489,227,34,19165,1361,1400,2761,3768,1600,2168,7246,0
13113,"Fayette County, Georgia",109495,52974,56521,39936,73601,21500,8742,2366,1084,108737,4284,4135,8419,7774,3125,4649,50098,706
13165,"Jenkins County, Georgia",9055,4456,4599,15149,6157,455,297,50,0,8976,813,593,1406,2539,1159,1380,3115,0
13217,"Newton County, Georgia",103901,49424,54477,23611,65767,8429,3453,646,503,102985,6612,7279,13891,17415,7451,9964,43464,465
13133,"Greene County, Georgia",16535,8036,8499,32890,12252,1599,963,371,99,16363,1516,1279,2795,3983,1889,2094,6106,225
13071,"Colquitt County, Georgia",46002,22919,23083,18121,29348,2277,1104,297,115,45356,6809,5307,12116,11305,5275,6030,18083,249
13085,"Dawson County, Georgia",22939,11329,11610,31954,16263,3129,1313,313,98,22691,1557,1486,3043,3028,1389,1639,10239,90
13063,"Clayton County, Georgia",270269,127718,142551,19498,165413,21427,7488,1368,1193,266769,30274,30154,60428,64326,27861,36465,113377,1545
13139,"Hall County, Georgia",190482,94865,95617,26283,122335,17222,6819,2354,1098,189282,19343,17305,36648,33350,15809,17541,84673,1210
15003,"Honolulu County, Hawaii",986999,497019,489980,33776,673882,147839,50147,16647,10111,939337,22637,19337,41974,90359,40012,50347,490828,9274
15009,"Maui County, Hawaii",162456,81068,81388,32379,114016,19943,6014,2303,1040,160977,6192,5128,11320,15767,7176,8591,80653,1134
15005,"Kalawao County, Hawaii",91,44,47,46024,84,9,14,0,2,82,3,3,6,11,4,7,72,0
16071,"Oneida County, Idaho",4269,2153,2116,21360,2667,327,94,5,10,4238,297,255,552,582,299,283,1623,0
16045,"Gem County, Idaho",16853,8260,8593,20041,11858,1279,422,93,17,16713,1483,1596,3079,3705,1828,1877,5875,121
16085,"Valley County, Idaho",9897,5121,4776,28515,7445,1580,618,45,63,9816,988,660,1648,1369,728,641,4382,37
16003,"Adams County, Idaho",3865,2034,1831,24315,2945,417,202,41,8,3835,321,381,702,561,302,259,1499,33
28011,"Bolivar County, Mississippi",33615,15773,17842,16984,21344,2878,1209,279,220,32858,3272,2582,5854,12097,5135,6962,11582,57
29061,"Daviess County, Missouri",8257,4172,4085,22642,5451,670,146,45,56,8049,798,724,1522,1301,560,741,3357,100
29087,"Holt County, Missouri",4537,2274,2263,25306,3345,462,177,20,13,4420,242,228,470,614,315,299,2125,23
29127,"Marion County, Missouri",28858,13914,14944,22662,19339,2717,906,214,122,28184,1705,1841,3546,4734,2130,2604,13072,86
29151,"Osage County, Missouri",13704,7153,6551,24995,9255,1281,398,74,13,13566,556,304,860,923,483,440,6682,59
29181,"Ripley County, Missouri",13936,6897,7039,18434,9650,672,298,68,53,13865,1225,963,2188,3312,1453,1859,5161,86
29219,"Warren County, Missouri",33290,16777,16513,26845,22813,2800,1080,189,85,33114,1941,1871,3812,4506,2193,2313,14406,85
29221,"Washington County, Missouri",25002,12835,12167,18314,17250,886,381,90,15,23888,1876,1751,3627,4678,2099,2579,8797,70
29043,"Christian County, Missouri",82053,39892,42161,26628,54396,9810,3361,689,539,81589,4697,4111,8808,8935,3731,5204,37721,503
29063,"DeKalb County, Missouri",12706,8016,4690,18994,9477,967,276,25,19,9206,440,368,808,1296,557,739,4119,66
29081,"Harrison County, Missouri",8649,4305,4344,20947,5929,602,174,40,9,8439,682,569,1251,1564,720,844,3731,83
29107,"Lafayette County, Missouri",32789,16121,16668,27260,22568,2861,969,103,202,32286,1817,1379,3196,3912,1486,2426,14926,245
29001,"Adair County, Missouri",25547,12038,13509,21778,13621,2114,1263,228,548,25242,1091,1118,2209,5929,2759,3170,10849,25
29199,"Scotland County, Missouri",4893,2388,2505,23785,3121,294,117,4,22,4796,803,599,1402,781,292,489,2169,40
29211,"Sullivan County, Missouri",6416,3255,3161,21168,4444,321,165,16,13,6325,432,420,852,1037,411,626,2724,22
29045,"Clark County, Missouri",6860,3468,3392,26253,4784,416,151,22,0,6768,457,487,944,928,461,467,3149,59
29097,"Jasper County, Missouri",117376,57174,60202,23390,76064,11382,4188,597,610,116332,8440,8043,16483,20393,9190,11203,55280,342
29111,"Lewis County, Missouri",10146,5094,5052,22083,6608,542,241,53,85,9950,517,534,1051,1299,578,721,4745,53
29119,"McDonald County, Missouri",22720,11570,11150,19577,14827,1241,438,166,127,22563,2471,2447,4918,4636,2142,2494,9082,85
29157,"Perry County, Missouri",19152,9481,9671,24846,12956,1383,508,169,27,18837,746,651,1397,1487,642,845,9205,23
29167,"Polk County, Missouri",31113,15225,15888,21357,19738,2317,1233,165,156,30708,1881,1995,3876,5228,2353,2875,13151,37
29177,"Ray County, Missouri",22921,11340,11581,26781,15717,1511,572,76,21,22654,1109,942,2051,3619,1760,1859,9856,28
30041,"Hill County, Montana",16529,8355,8174,21780,10303,1773,476,66,105,16397,1108,1312,2420,3532,1501,2031,6993,60
30015,"Chouteau County, Montana",5837,2898,2939,22014,3891,733,201,16,13,5793,545,561,1106,1257,563,694,2468,15
30053,"Lincoln County, Montana",19268,9639,9629,22483,14616,1998,607,139,27,19098,1665,1439,3104,3410,1510,1900,6626,142
30067,"Park County, Montana",15843,7917,7926,29181,11836,2773,1013,260,121,15757,1281,862,2143,1905,856,1049,7758,70
30103,"Treasure County, Montana",846,433,413,22880,600,94,18,2,5,846,29,31,60,162,91,71,392,6
30005,"Blaine County, Montana",6609,3283,3326,17059,4019,598,154,12,23,6513,958,917,1875,1856,840,1016,2508,33
30097,"Sweet Grass County, Montana",3634,1770,1864,28065,2607,502,108,23,11,3607,217,166,383,427,200,227,1536,29
30099,"Teton County, Montana",6067,2979,3088,26884,4190,660,197,56,20,6002,409,474,883,631,275,356,2744,64
30079,"Prairie County, Montana",1414,747,667,28366,1012,138,32,19,5,1395,101,43,144,255,130,125,568,7
30035,"Glacier County, Montana",13695,6722,6973,16737,7991,1056,249,127,27,13564,2899,2733,5632,4502,2102,2400,4485,11
30025,"Fallon County, Montana",2913,1525,1388,32371,1978,203,36,3,50,2861,180,149,329,197,62,135,1509,8
30037,"Golden Valley County, Montana",730,344,386,25110,573,105,30,0,0,730,33,78,111,119,43,76,334,1
30093,"Silver Bow County, Montana",34560,17188,17372,26248,23436,4188,1286,436,168,33985,2291,2144,4435,6555,3066,3489,15917,308
30095,"Stillwater County, Montana",9342,4748,4594,31583,6744,1133,389,121,73,9290,481,502,983,675,282,393,4373,97
30043,"Jefferson County, Montana",11601,5958,5643,32387,8437,1944,605,126,115,11425,548,540,1088,973,505,468,5260,70
30039,"Granite County, Montana",3212,1648,1564,29144,2443,369,198,24,20,3185,211,184,395,456,230,226,1142,11
30107,"Wheatland County, Montana",2109,1094,1015,20165,1426,215,43,2,12,2075,148,97,245,365,176,189,948,0
30057,"Madison County, Montana",7810,4046,3764,31620,6176,1147,333,72,88,7750,623,529,1152,874,426,448,3765,64
30091,"Sheridan County, Montana",3645,1866,1779,32833,2642,416,85,17,12,3594,161,115,276,395,204,191,1830,15
30011,"Carter County, Montana",1295,625,670,30659,951,138,18,2,5,1273,91,114,205,160,50,110,620,14
30003,"Big Horn County, Montana",13214,6522,6692,17905,7537,763,295,38,90,13075,2632,2496,5128,3615,1696,1919,4748,61
30047,"Lake County, Montana",29311,14418,14893,24348,19912,3084,1273,389,221,29144,3426,3128,6554,6206,3099,3107,11608,70
30049,"Lewis and Clark County, Montana",65989,32839,33150,31252,46073,11169,4436,1173,494,65349,3144,2650,5794,7786,3780,4006,33306,204
41015,"Curry County, Oregon",22364,10915,11449,26925,17756,2596,1075,323,192,22224,1217,1006,2223,3382,1424,1958,7472,97
41021,"Gilliam County, Oregon",1913,969,944,24178,1337,168,57,3,0,1905,169,114,283,213,124,89,701,11
41027,"Hood River County, Oregon",22842,11495,11347,29595,15336,2945,1123,326,222,22758,1648,1325,2973,3006,1369,1637,10788,179
41037,"Lake County, Oregon",7799,4196,3603,21005,5837,721,205,70,15,7286,407,386,793,1280,616,664,2862,28
41051,"Multnomah County, Oregon",778193,385176,393017,34848,557727,144518,63821,19111,10591,772975,45535,34681,80216,130564,61392,69172,396494,3127
42103,"Pike County, Pennsylvania",56210,28092,28118,31156,40619,6187,3197,588,303,55807,2577,2116,4693,5672,2481,3191,23851,133
42109,"Snyder County, Pennsylvania",40246,19942,20304,24961,26610,2824,1043,322,249,39933,2838,2686,5524,4230,1797,2433,19076,149
42115,"Susquehanna County, Pennsylvania",41832,21060,20772,27823,30528,3175,1513,186,239,41534,2425,1809,4234,5320,2411,2909,18324,67
42039,"Crawford County, Pennsylvania",87027,42542,44485,24716,59938,7481,3552,619,715,85546,5038,4860,9898,12077,5557,6520,37077,324
42049,"Erie County, Pennsylvania",279133,137741,141392,26361,187749,33251,12946,2586,1839,273663,10796,8106,18902,44452,19940,24512,126154,633
42057,"Fulton County, Pennsylvania",14653,7386,7267,25273,10406,838,485,33,36,14610,669,524,1193,1624,704,920,6606,31
42067,"Juniata County, Pennsylvania",24811,12361,12450,24068,17397,1447,772,37,60,24560,1722,1593,3315,2926,1310,1616,11059,50
42107,"Schuylkill County, Pennsylvania",145503,74295,71208,25224,106162,10232,4663,894,471,138710,5984,4986,10970,18029,7999,10030,61998,316
42131,"Wyoming County, Pennsylvania",27975,14051,13924,28046,19704,2361,1044,164,96,27729,1079,990,2069,2817,1099,1718,12807,52
42001,"Adams County, Pennsylvania",101759,50232,51527,29685,70701,9033,4932,776,719,100483,3994,3453,7447,9117,4024,5093,49601,172
53053,"Pierce County, Washington",832896,413477,419419,31157,552099,92646,34167,8414,5008,810962,42908,36300,79208,103562,46121,57441,381957,2798
53021,"Franklin County, Washington",87810,45747,42063,22125,49890,5095,2118,289,388,85683,7957,6854,14811,14019,6475,7544,36851,191
53071,"Walla Walla County, Washington",59809,30670,29139,26651,39044,6902,3086,664,506,56472,3552,2587,6139,8971,4136,4835,25926,141
53073,"Whatcom County, Washington",209729,103878,105851,29186,136697,29211,10408,2517,2469,208060,11267,9326,20593,32649,14841,17808,98326,872
54023,"Grant County, West Virginia",11770,5908,5862,21705,8544,666,398,84,49,11662,432,324,756,1525,652,873,4745,8
54027,"Hampshire County, West Virginia",23455,12082,11373,21771,16920,1202,639,60,20,22957,1831,1129,2960,3864,1923,1941,8864,0
54009,"Brooke County, West Virginia",23473,11407,12066,25630,16845,2147,952,144,99,23274,1029,804,1833,2851,1293,1558,10226,39
54017,"Doddridge County, West Virginia",8363,4483,3880,21164,5945,580,216,69,16,7749,621,389,1010,1186,491,695,2682,56
54031,"Hardy County, West Virginia",13942,6935,7007,23446,10171,1028,315,68,80,13884,811,693,1504,1897,783,1114,6051,0
54049,"Marion County, West Virginia",56716,27861,28855,25205,38917,5584,2306,313,288,56351,2515,2489,5004,9222,4324,4898,24944,77
54059,"Mingo County, West Virginia",25549,12539,13010,19272,17988,1022,645,59,58,25466,1360,1133,2493,6594,2856,3738,6952,0
54029,"Hancock County, West Virginia",30024,14559,15465,25157,22077,2764,989,204,53,29788,1469,1496,2965,4286,1853,2433,13176,190
54051,"Marshall County, West Virginia",32296,15904,16392,24043,23340,2482,1035,199,49,31904,1608,1338,2946,4600,1839,2761,13184,48
54067,"Nicholas County, West Virginia",25743,12552,13191,22101,18606,1631,843,186,184,25599,967,1166,2133,4486,1896,2590,9582,146
54093,"Tucker County, West Virginia",6922,3444,3478,22385,5188,401,289,27,20,6748,281,296,577,899,394,505,2967,11
54095,"Tyler County, West Virginia",9000,4481,4519,24599,6541,614,226,33,26,8924,599,682,1281,1663,636,1027,3249,5
54087,"Roane County, West Virginia",14513,7145,7368,20723,10339,784,290,40,94,14418,692,576,1268,2870,1267,1603,4493,54
54091,"Taylor County, West Virginia",16949,8602,8347,23683,12271,1507,639,71,56,16508,880,556,1436,2729,1349,1380,6859,216
54107,"Wood County, West Virginia",86262,41616,44646,26717,61176,7871,3361,791,372,85759,4638,3481,8119,14747,6155,8592,36143,242
54021,"Gilmer County, West Virginia",8497,5080,3417,18207,6020,562,261,37,102,7029,420,417,837,1741,891,850,2653,65
54053,"Mason County, West Virginia",27060,13057,14003,21094,19476,1595,538,79,2,26431,938,1066,2004,4970,2326,2644,8889,44
54063,"Monroe County, West Virginia",13496,6682,6814,22830,9909,867,373,42,42,13368,753,683,1436,2283,864,1419,4863,7
54073,"Pleasants County, West Virginia",7612,4013,3599,24605,5528,429,303,5,7,7030,260,227,487,1187,598,589,2923,9
54011,"Cabell County, West Virginia",96623,47314,49309,24646,64310,9054,5231,1459,1066,95192,5410,4148,9558,20249,9324,10925,39146,730
54037,"Jefferson County, West Virginia",55531,27512,28019,33241,37690,7014,3306,460,484,55221,2524,1865,4389,5884,2422,3462,26419,115
54045,"Logan County, West Virginia",35166,17402,17764,21074,25308,1470,560,191,29,34604,2107,1721,3828,6986,2957,4029,10676,41
54071,"Pendleton County, West Virginia",7291,3674,3617,23697,5462,425,292,51,29,7125,342,318,660,1307,612,695,2744,0
54033,"Harrison County, West Virginia",68775,33599,35176,27162,48789,6879,2689,619,335,68180,3379,2681,6060,10743,5028,5715,29359,547
54069,"Ohio County, West Virginia",43257,20831,22426,29769,30333,5751,2477,655,253,42697,1888,1774,3662,6626,2927,3699,19573,64
54013,"Calhoun County, West Virginia",7482,3685,3797,19696,5441,477,150,21,0,7459,451,585,1036,1176,523,653,2449,24
54065,"Morgan County, West Virginia",17514,8678,8836,24026,12925,1401,731,50,101,17350,1044,995,2039,1962,772,1190,7236,115
54081,"Raleigh County, West Virginia",78051,39244,38807,23435,55687,6793,2618,492,204,75249,4398,3835,8233,13173,5926,7247,28276,334
54079,"Putnam County, West Virginia",56743,27863,28880,30690,39868,5854,3255,593,273,56376,2410,1826,4236,5546,2156,3390,25267,47
54001,"Barbour County, West Virginia",16892,8175,8717,20762,11405,942,431,41,49,16732,987,741,1728,3657,1814,1843,6349,30
54047,"McDowell County, West Virginia",20273,10323,9950,13985,15029,444,231,79,20,18827,1382,1376,2758,7076,3262,3814,4242,14
54099,"Wayne County, West Virginia",41237,20050,21187,20582,29149,2237,1202,255,60,41093,2296,2184,4480,8566,3959,4607,14130,146
54035,"Jackson County, West Virginia",29199,14443,14756,23246,20621,2220,1070,185,171,29020,1184,1095,2279,4315,1905,2410,10798,86
28133,"Sunflower County, Mississippi",27424,14350,13074,14427,17856,1710,647,83,85,23725,2387,2200,4587,8109,3408,4701,8293,107
28001,"Adams County, Mississippi",31747,15901,15846,17721,22155,2502,1115,254,134,29327,2690,2108,4798,8905,3755,5150,10531,70
28033,"DeSoto County, Mississippi",170890,82763,88127,28316,110504,17748,6170,1052,654,170001,9896,9188,19084,16948,7039,9909,83011,421
42045,"Delaware County, Pennsylvania",562316,270171,292145,36747,377935,80492,40374,10388,7764,554885,21247,17765,39012,58737,25197,33540,264512,1601
42111,"Somerset County, Pennsylvania",76201,39529,36672,23877,56543,5746,2189,534,276,71439,3106,2767,5873,8993,3596,5397,32136,267
29123,"Madison County, Missouri",12403,6087,6316,20081,8576,754,222,29,47,12223,783,765,1548,1978,762,1216,5025,95
29217,"Vernon County, Missouri",20836,10209,10627,22369,13921,1387,642,183,48,20363,1795,1681,3476,3499,1544,1955,9065,99
29147,"Nodaway County, Missouri",23026,11399,11627,21056,12566,1747,862,251,278,22183,1231,1201,2432,5046,2251,2795,11123,83
29041,"Chariton County, Missouri",7615,3769,3846,23463,5378,557,251,17,23,7396,274,276,550,1130,545,585,3272,33
29223,"Wayne County, Missouri",13341,6640,6701,18897,9626,843,188,40,70,13195,978,902,1880,3003,1313,1690,4542,31
29201,"Scott County, Missouri",38994,18943,20051,22939,26422,2255,1069,253,95,38509,2379,2543,4922,7467,3230,4237,17060,86
29011,"Barton County, Missouri",12075,5991,6084,24628,8154,913,243,76,6,11955,720,640,1360,2722,1201,1521,4962,17
29039,"Cedar County, Missouri",13932,6940,6992,20228,9669,950,330,112,44,13788,1178,1043,2221,3171,1678,1493,5050,35
29073,"Gasconade County, Missouri",14875,7389,7486,25963,10646,1169,486,51,40,14608,642,554,1196,2074,979,1095,6493,12
29121,"Macon County, Missouri",15399,7595,7804,20890,10626,1203,395,56,27,15130,939,850,1789,2845,1285,1560,6369,81
29149,"Oregon County, Missouri",10922,5384,5538,18309,7707,615,290,18,45,10787,848,916,1764,2809,1232,1577,3941,91
29186,"Ste. Genevieve County, Missouri",17937,9037,8900,26418,12420,1143,470,62,57,17729,415,720,1135,2561,985,1576,8267,54
29067,"Douglas County, Missouri",13467,6749,6718,18095,9663,590,276,34,11,13346,1158,1112,2270,2704,1380,1324,4887,31
29083,"Henry County, Missouri",21930,10847,11083,24371,15554,1674,609,86,37,21692,1598,1259,2857,4575,2190,2385,9027,87
29109,"Lawrence County, Missouri",38204,19079,19125,21022,25512,2871,1088,134,42,37621,3055,2780,5835,6803,3123,3680,15751,251
29169,"Pulaski County, Missouri",53302,30338,22964,21716,28651,4528,2031,130,152,39900,2542,2302,4844,6372,2817,3555,28210,97
29215,"Texas County, Missouri",25690,13201,12489,17918,17760,1642,615,91,48,24195,2178,1926,4104,6301,3149,3152,8746,34
29027,"Callaway County, Missouri",44693,22841,21852,24208,30003,4175,1523,206,235,42137,2002,2298,4300,5354,2242,3112,19465,396
29053,"Cooper County, Missouri",17613,9266,8347,22371,12030,1681,624,120,40,16048,866,741,1607,2137,959,1178,7740,52
29075,"Gentry County, Missouri",6745,3242,3503,20903,4590,643,202,22,25,6583,374,358,732,1039,481,558,2975,27
29133,"Mississippi County, Missouri",14112,7568,6544,17918,9865,812,230,84,0,12385,1113,1072,2185,3752,1471,2281,4912,24
29153,"Ozark County, Missouri",9450,4739,4711,17857,7070,479,236,66,30,9393,776,710,1486,2546,1176,1370,3047,20
29017,"Bollinger County, Missouri",12282,6181,6101,20687,8594,562,212,8,30,12194,728,638,1366,2881,1291,1590,4658,13
29103,"Knox County, Missouri",3997,2025,1972,22171,2714,287,98,14,22,3920,386,401,787,786,377,409,1646,7
29139,"Montgomery County, Missouri",11820,5885,5935,21757,8298,716,352,21,32,11486,651,571,1222,1999,858,1141,4966,26
29207,"Stoddard County, Missouri",29788,14509,15279,21684,20830,1833,800,121,73,29383,2098,1804,3902,4848,1936,2912,11985,167
29007,"Audrain County, Missouri",25868,11710,14158,21226,17659,1419,599,144,62,24034,1786,1307,3093,4193,1954,2239,10584,244
29077,"Greene County, Missouri",285449,139153,146296,25529,185485,35508,14165,3247,2507,281556,19829,16700,36529,51145,22063,29082,134341,1041
29185,"St. Clair County, Missouri",9444,4750,4694,20827,7014,455,243,67,38,9199,841,718,1559,2052,952,1100,3251,91
29197,"Schuyler County, Missouri",4396,2155,2241,19882,2901,206,125,26,7,4345,454,328,782,951,452,499,1872,27
29029,"Camden County, Missouri",44152,21895,22257,25492,32899,4458,1867,417,272,43703,3512,3661,7173,7943,3572,4371,16772,179
29099,"Jefferson County, Missouri",222453,110600,111853,27443,151205,18769,7426,837,837,220838,11218,9936,21154,24089,11000,13089,106506,285
29143,"New Madrid County, Missouri",18229,8758,9471,20261,12554,839,525,23,7,17864,1602,1767,3369,4370,1930,2440,6861,34
29173,"Ralls County, Missouri",10225,5191,5034,24687,7264,616,246,52,9,10165,565,523,1088,1268,572,696,4791,17
30017,"Custer County, Montana",11980,5999,5981,28501,8317,1254,297,56,44,11741,595,527,1122,1289,561,728,6251,32
30075,"Powder River County, Montana",1648,811,837,31211,1266,281,28,0,12,1616,84,135,219,124,59,65,946,5
30085,"Roosevelt County, Montana",11230,5525,5705,18030,6407,684,191,24,8,11003,1586,1310,2896,2953,1381,1572,3644,16
30051,"Liberty County, Montana",2292,1137,1155,36525,1641,259,30,6,7,2270,148,132,280,349,146,203,971,6
30083,"Richland County, Montana",11392,5864,5528,33709,7576,990,327,58,20,11392,912,797,1709,981,474,507,5956,37
30101,"Toole County, Montana",5114,2919,2195,26354,3648,414,62,59,1,4481,415,341,756,747,363,384,2294,10
30019,"Daniels County, Montana",1787,878,909,36108,1315,245,56,7,4,1756,35,57,92,84,34,50,957,0
28113,"Pike County, Mississippi",39939,18925,21014,17470,25466,2523,1178,127,169,39330,2999,3093,6092,12290,5136,7154,13794,511
30045,"Judith Basin County, Montana",1981,1034,947,28709,1554,420,59,4,4,1981,86,124,210,249,131,118,963,0
30023,"Deer Lodge County, Montana",9176,4883,4293,25107,6843,717,288,64,19,8628,709,474,1183,1785,856,929,3749,31
30055,"McCone County, Montana",1678,914,764,28230,1242,182,11,8,3,1656,63,30,93,175,102,73,834,2
30087,"Rosebud County, Montana",9348,4629,4719,23832,5794,871,201,26,50,9269,839,1029,1868,1813,864,949,4057,42
30021,"Dawson County, Montana",9431,4975,4456,29130,6517,935,234,60,3,9107,470,417,887,1365,810,555,4667,24
30007,"Broadwater County, Montana",5692,2928,2764,32268,4161,801,299,12,24,5646,398,289,687,471,194,277,2473,65
42023,"Cameron County, Pennsylvania",4807,2432,2375,24933,3632,425,85,38,18,4764,170,127,297,602,206,396,2109,10
42017,"Bucks County, Pennsylvania",626220,307068,319152,41924,442193,102554,49864,9683,7478,620342,18228,14639,32867,36635,14836,21799,316987,1512
42077,"Lehigh County, Pennsylvania",358792,174829,183963,30988,243937,43341,20083,3911,3182,353896,17634,14032,31666,45552,19855,25697,169221,1058
42031,"Clarion County, Pennsylvania",38939,18983,19956,23595,26119,3349,1551,254,298,38523,1971,1512,3483,6941,3100,3841,16593,160
42059,"Greene County, Pennsylvania",37669,19556,18113,25574,26768,2968,1352,113,206,34686,1248,1172,2420,5141,2222,2919,14262,161
42079,"Luzerne County, Pennsylvania",318917,157130,161787,26809,226781,30966,14166,2932,1947,311082,13154,10401,23555,48174,21222,26952,144267,676
16069,"Nez Perce County, Idaho",39995,19821,20174,26799,27701,4399,1237,347,166,39335,2568,2288,4856,5266,2569,2697,18105,83
16053,"Jerome County, Idaho",22694,11491,11203,19329,13618,1454,336,103,49,22567,2861,2383,5244,3786,1633,2153,9363,43
16055,"Kootenai County, Idaho",147716,73116,74600,28275,100600,16066,5565,1615,881,146447,9868,9667,19535,18412,8119,10293,65013,657
16061,"Lewis County, Idaho",3826,1906,1920,23285,2710,321,104,4,5,3772,297,364,661,598,249,349,1530,19
16067,"Minidoka County, Idaho",20331,10251,10080,21887,12667,1334,412,117,22,20253,2491,2224,4715,3584,1499,2085,9117,56
16083,"Twin Falls County, Idaho",80955,39915,41040,22723,51370,6333,1942,746,300,80017,6348,5643,11991,12417,5671,6746,36831,350
06073,"San Diego County, California",3253356,1635137,1618219,34350,2161760,487026,199234,58066,44596,3154251,206057,179882,385939,444024,206662,237362,1536747,12269
06107,"Tulare County, California",455769,227963,227806,18962,263099,24659,8033,2901,1220,451619,37969,29158,67127,127130,61486,65644,165799,2009
06113,"Yolo County, California",209671,102268,107403,30615,122238,25078,12765,4541,6541,208157,11017,8631,19648,38898,18187,20711,91743,474
06023,"Humboldt County, California",135182,67449,67733,25208,90903,17031,5389,1872,1366,134149,10478,8788,19266,27641,13446,14195,57607,275
06057,"Nevada County, California",98639,48833,49806,35581,74327,16694,6092,1966,818,97667,6227,4684,10911,11835,5434,6401,40067,454
06003,"Alpine County, California",1184,692,492,27448,790,140,67,8,20,1184,121,54,175,221,106,115,401,1
06039,"Madera County, California",153366,74035,79331,19975,95172,8636,2558,784,518,145553,12270,8531,20801,32043,14454,17589,47613,689
06045,"Mendocino County, California",87409,43634,43775,27093,61660,9665,3374,1139,669,86630,6449,4482,10931,17366,8005,9361,35629,75
06087,"Santa Cruz County, California",270931,134367,136564,36388,175387,40953,18085,4872,4476,269538,15491,12109,27600,39211,17568,21643,128893,3304
06105,"Trinity County, California",13180,6752,6428,23575,10187,1594,339,72,39,12996,1230,905,2135,2607,1334,1273,4590,72
06037,"Los Angeles County, California",10057155,4954616,5102539,30798,6712079,1348250,474729,155849,86083,9988629,867025,718412,1585437,1764081,805455,958626,4591360,50285
06065,"Riverside County, California",2323892,1156126,1167766,25700,1468896,198192,79849,20311,12893,2301893,183509,154958,338467,376689,174616,202073,923845,8037
06071,"San Bernardino County, California",2106754,1047925,1058829,22867,1293779,162213,63738,14542,9429,2059141,154411,135858,290269,392195,177523,214672,834181,4848
06085,"Santa Clara County, California",1885056,949223,935833,48689,1284765,342701,208794,34369,44998,1876213,80071,64182,144253,172213,79442,92771,912304,7520
06041,"Marin County, California",259358,126745,132613,66748,189717,61100,28898,12285,6010,254546,9025,7206,16231,20445,9631,10814,127178,735
06061,"Placer County, California",370571,180790,189781,39734,256598,63509,21583,6611,2986,367805,16085,12241,28326,31932,15094,16838,163251,1282
06093,"Siskiyou County, California",43668,21713,21955,24605,31725,4715,1640,491,183,43514,2383,1908,4291,9524,4520,5004,15770,108
06089,"Shasta County, California",179228,87903,91325,26455,125235,16539,5537,2228,857,177820,11305,9242,20547,30945,14031,16914,69150,424
06095,"Solano County, California",429596,213518,216078,31934,289265,50923,14765,4536,2445,416581,21048,17165,38213,53265,23732,29533,189124,1147
06015,"Del Norte County, California",27628,15168,12460,20809,19394,1688,678,311,214,24148,1384,1221,2605,5219,2282,2937,8396,62
06021,"Glenn County, California",27976,14216,13760,21029,17855,1703,357,147,62,27665,2197,1818,4015,5578,2456,3122,10138,95
06007,"Butte County, California",223877,110926,112951,26304,144395,25225,8002,2915,1611,221452,13358,10356,23714,46456,22614,23842,87941,576
06063,"Plumas County, California",18754,9484,9270,32056,14499,1828,988,271,94,18597,1139,769,1908,2346,1003,1343,7189,41
06079,"San Luis Obispo County, California",278680,141572,137108,33972,184345,39994,15020,4296,3476,272052,15205,12286,27491,37208,17548,19660,127442,701
06029,"Kern County, California",871337,447079,424258,21716,518804,54412,18553,5182,3122,842403,62396,50032,112428,194354,86664,107690,323691,6265
06111,"Ventura County, California",843110,417442,425668,35771,555316,111571,45763,12888,8589,836448,56903,46114,103017,88486,40194,48292,395139,2138
42005,"Armstrong County, Pennsylvania",67512,33505,34007,25502,49477,5301,1862,290,218,66985,2505,2296,4801,8786,4056,4730,29148,272
42035,"Clinton County, Pennsylvania",39536,19383,20153,22794,25045,2805,1207,181,188,38933,2023,1686,3709,6436,2759,3677,17369,181
42025,"Carbon County, Pennsylvania",64330,31944,32386,25680,47165,4692,2251,335,257,63532,2730,2347,5077,7621,3597,4024,28509,112
42027,"Centre County, Pennsylvania",159178,83558,75620,28545,93781,20908,11917,1557,5377,155342,6020,4189,10209,27170,14238,12932,74235,739
42097,"Northumberland County, Pennsylvania",93590,47287,46303,24278,67943,6490,2859,559,298,89378,4114,3430,7544,12974,6239,6735,40337,293
42095,"Northampton County, Pennsylvania",300520,147510,153010,32608,208317,37060,15338,2996,2672,297641,12124,8800,20924,26379,11811,14568,143423,1879
42121,"Venango County, Pennsylvania",53460,26309,27151,25190,38606,4202,1793,280,99,52708,2360,2007,4367,7535,3408,4127,22585,122
42007,"Beaver County, Pennsylvania",169205,82025,87180,29162,122503,19734,6945,1406,586,167807,5594,4470,10064,18036,7984,10052,80272,505
42069,"Lackawanna County, Pennsylvania",213006,102979,110027,27258,149770,24636,10708,2161,1584,209168,8199,5892,14091,31288,13628,17660,95423,489
42083,"McKean County, Pennsylvania",42609,22024,20585,24868,30138,3148,1553,222,199,40498,1570,1351,2921,6705,3050,3655,18136,138
42051,"Fayette County, Pennsylvania",134229,66241,67988,24247,97484,9752,3529,619,463,130847,5567,4389,9956,24277,10650,13627,52528,441
42091,"Montgomery County, Pennsylvania",815876,396386,419490,45048,570837,152162,80971,22479,15292,802051,22625,18316,40941,52250,22853,29397,413212,1741
42033,"Clearfield County, Pennsylvania",81170,42256,38914,22568,59324,5427,1805,307,303,75771,3565,2885,6450,11196,4983,6213,32965,185
42075,"Lebanon County, Pennsylvania",136950,66914,70036,27916,93706,11395,5329,1321,564,135259,7892,6696,14588,14293,6421,7872,64417,240
42081,"Lycoming County, Pennsylvania",116313,57104,59209,26265,80680,10629,4381,1099,531,113144,4394,3605,7999,15932,6866,9066,52939,414
42093,"Montour County, Pennsylvania",18404,8836,9568,31818,13364,2095,972,493,248,17791,579,487,1066,1763,677,1086,8367,55
42123,"Warren County, Pennsylvania",40649,20363,20286,26558,29618,3652,1383,262,161,39928,1709,1317,3026,5042,2283,2759,17899,225
42019,"Butler County, Pennsylvania",185974,91929,94045,35101,130462,27839,12226,1834,1532,183953,5170,4296,9466,15257,6732,8525,90237,436
42047,"Elk County, Pennsylvania",31111,15541,15570,27163,22764,2777,1011,175,83,30784,877,525,1402,2688,1166,1522,14802,15
42071,"Lancaster County, Pennsylvania",533110,260976,272134,29280,354397,59026,23687,4945,3246,526391,33540,31286,64826,55977,25457,30520,257798,1984
42085,"Mercer County, Pennsylvania",114598,56473,58125,25499,79922,10914,4648,875,806,110657,4800,3892,8692,14962,6443,8519,48898,343
42105,"Potter County, Pennsylvania",17239,8694,8545,23213,12320,1069,656,108,21,17007,899,790,1689,2395,1071,1324,6864,52
42117,"Tioga County, Pennsylvania",42031,20843,21188,25353,29331,3672,1800,295,242,41616,2099,1872,3971,5509,2295,3214,18064,125
44005,"Newport County, Rhode Island",82714,40616,42098,43603,59418,16127,7832,1683,1398,79597,3199,2619,5818,7292,2742,4550,42658,396
44007,"Providence County, Rhode Island",631344,306301,325043,29025,425325,70136,31669,7560,6595,621405,34826,24535,59361,104178,46824,57354,295503,3807
44001,"Bristol County, Rhode Island",49228,23746,25482,42360,34149,8376,4881,1657,934,48557,1330,1258,2588,3246,1450,1796,24206,62
45003,"Aiken County, South Carolina",165146,79827,85319,26222,114311,18076,8102,1405,1353,163350,11359,10158,21517,28253,12240,16013,68496,337
45005,"Allendale County, South Carolina",9589,5114,4475,13439,6624,526,102,0,23,8487,745,685,1430,2519,1119,1400,2676,6
45037,"Edgefield County, South Carolina",26388,14310,12078,23804,18936,2274,890,177,184,23728,1457,1142,2599,4002,1612,2390,10516,63
45023,"Chester County, South Carolina",32435,15904,16531,20518,22206,2207,774,57,161,32242,2478,1824,4302,7554,3520,4034,12361,164
45029,"Colleton County, South Carolina",37884,18195,19689,21059,26062,2595,992,275,130,37192,3381,2664,6045,7733,3359,4374,14950,300
45067,"Marion County, South Carolina",31975,14687,17288,18556,21716,2357,995,42,140,31786,2417,2182,4599,8225,3400,4825,11957,57
45063,"Lexington County, South Carolina",277702,135372,142330,29311,189215,36081,15754,2670,2002,274691,16857,14457,31314,37445,16231,21214,131894,3142
45073,"Oconee County, South Carolina",75375,37104,38271,26798,53965,7486,3646,664,894,74817,5486,5148,10634,13806,5929,7877,29190,246
45015,"Berkeley County, South Carolina",199081,99053,100028,27010,130343,19834,8141,1176,795,193684,13119,12689,25808,25772,11269,14503,91953,658
45019,"Charleston County, South Carolina",380673,184332,196341,35587,266019,70588,25350,8564,4944,373840,26406,23308,49714,60063,25544,34519,188784,1480
45043,"Georgetown County, South Carolina",60804,28933,31871,28748,44375,7191,3186,802,408,60193,5186,4901,10087,11514,4611,6903,23324,246
45069,"Marlboro County, South Carolina",27702,14716,12986,16561,19675,1074,526,40,19,24566,1734,1459,3193,6551,2690,3861,9499,40
45007,"Anderson County, South Carolina",192709,92748,99961,24485,131561,16779,7326,1128,1105,191356,12237,12316,24553,30879,13186,17693,81518,647
45025,"Chesterfield County, South Carolina",46083,22552,23531,19768,31421,2368,878,200,172,45648,3708,2940,6648,11158,5624,5534,18397,584
45047,"Greenwood County, South Carolina",69881,32511,37370,22636,46691,7441,2675,424,450,68716,5635,5479,11114,16282,6772,9510,28207,135
45051,"Horry County, South Carolina",300418,145624,154794,25804,217748,33014,12270,2369,1577,298993,27395,23131,50526,52197,23313,28884,131140,907
45055,"Kershaw County, South Carolina",63090,30547,32543,23530,43219,5690,2689,289,237,62568,4026,3669,7695,9963,4554,5409,26333,247
45075,"Orangeburg County, South Carolina",89731,42228,47503,19489,59363,7031,3664,468,706,89007,7670,6314,13984,20319,8970,11349,33882,395
45083,"Spartanburg County, South Carolina",294229,142694,151535,24786,196173,28866,12132,2254,1531,290022,20506,18852,39358,48747,21167,27580,127878,703
45009,"Bamberg County, South Carolina",15057,7262,7795,19256,9866,1269,541,60,17,14905,1060,1399,2459,3806,1993,1813,5482,54
45013,"Beaufort County, South Carolina",175316,86370,88946,34966,124061,29389,13810,3615,2325,167442,12824,10544,23368,21115,8892,12223,76566,1050
45017,"Calhoun County, South Carolina",14886,7125,7761,24766,10715,1197,445,127,49,14762,1086,1138,2224,2834,1355,1479,6220,116
45033,"Dillon County, South Carolina",31273,14592,16681,15638,20376,1404,429,71,49,30921,2785,2342,5127,9431,4021,5410,11389,53
45081,"Saluda County, South Carolina",20113,10112,10001,20390,13889,1514,626,97,69,19862,1991,1452,3443,3764,1656,2108,8400,52
45079,"Richland County, South Carolina",401743,194943,206800,28018,248613,56096,27409,5725,4024,377588,21038,19962,41000,61606,26162,35444,193925,3569
45039,"Fairfield County, South Carolina",23025,11004,12021,21972,16464,1904,579,187,188,22721,2063,1470,3533,5563,2376,3187,8603,0
45049,"Hampton County, South Carolina",20296,10447,9849,17676,13974,1020,457,47,21,18883,1267,1044,2311,3282,1465,1817,7673,67
45045,"Greenville County, South Carolina",482191,234053,248138,29132,324486,68371,28074,6185,4068,477643,34486,30127,64613,67067,28961,38106,222920,1495
45057,"Lancaster County, South Carolina",83704,40886,42818,26425,58697,9142,3728,439,364,81803,5844,4790,10634,14201,6015,8186,33352,485
45035,"Dorchester County, South Carolina",148517,72395,76122,27317,97867,16517,7568,1060,647,145645,8773,8101,16874,17625,7098,10527,68989,420
42037,"Columbia County, Pennsylvania",66772,32139,34633,24908,43723,5874,2454,469,542,66010,2187,1787,3974,9498,4365,5133,29987,124
42065,"Jefferson County, Pennsylvania",44575,22136,22439,23895,31541,3100,1198,260,119,44043,2195,2075,4270,6364,2778,3586,19586,156
42099,"Perry County, Pennsylvania",45647,22995,22652,28900,32017,3501,1405,233,94,45137,2508,2017,4525,3921,1701,2220,22733,121
42113,"Sullivan County, Pennsylvania",6302,3303,2999,26720,4919,443,234,41,45,6109,384,189,573,731,419,312,2620,12
44003,"Kent County, Rhode Island",164886,79561,85325,37157,120588,24015,10787,2116,1464,163514,5387,3891,9278,13400,5609,7791,84324,264
44009,"Washington County, Rhode Island",126319,61073,65246,39568,85228,21642,11691,2349,2316,125359,3728,2657,6385,12045,5536,6509,62763,234
45071,"Newberry County, South Carolina",37750,18336,19414,22190,25619,2636,1186,106,249,37264,2403,1787,4190,6828,2955,3873,16065,17
45027,"Clarendon County, South Carolina",34056,16746,17310,20616,23639,2340,949,143,108,32468,2615,2356,4971,8400,3631,4769,10996,144
45085,"Sumter County, South Carolina",107682,51876,55806,21733,69468,8388,3644,700,491,103816,7192,6666,13858,21063,9372,11691,43422,433
45011,"Barnwell County, South Carolina",21917,10438,11479,20018,14349,1314,509,40,34,21618,1674,1427,3101,5680,2405,3275,7931,64
45031,"Darlington County, South Carolina",67689,31953,35736,21225,45884,5260,1983,244,372,66922,4906,4901,9807,15241,6348,8893,25674,35
45091,"York County, South Carolina",245606,118494,127112,30387,163095,32307,12677,1674,1464,244129,13216,13167,26383,30218,12990,17228,115601,717
45021,"Cherokee County, South Carolina",56274,27395,28879,20516,37210,3722,1593,414,213,55943,3533,3931,7464,12593,5321,7272,21084,81
45053,"Jasper County, South Carolina",27186,14081,13105,20067,18945,1773,774,104,101,26658,3332,2110,5442,6256,3191,3065,11955,145
45061,"Lee County, South Carolina",18189,9437,8752,16972,12444,925,319,54,6,16546,1172,990,2162,4666,2163,2503,5860,117
45001,"Abbeville County, South Carolina",24951,12212,12739,19234,17077,1581,554,109,103,24744,1428,1539,2967,5230,2531,2699,9339,76
46085,"Lyman County, South Dakota",3855,2028,1827,21155,2429,313,108,19,4,3827,478,348,826,829,386,443,1706,13
46039,"Deuel County, South Dakota",4309,2230,2079,29204,3023,470,86,19,23,4242,134,99,233,448,217,231,2268,6
46015,"Brule County, South Dakota",5312,2637,2675,26074,3566,586,220,59,48,5158,295,272,567,772,339,433,2597,119
46053,"Gregory County, South Dakota",4217,2158,2059,26169,2976,467,82,14,11,4166,210,212,422,686,326,360,2024,23
46099,"Minnehaha County, South Dakota",182014,91348,90666,29551,119030,25397,7377,2042,1200,179267,8810,7112,15922,20543,9135,11408,99226,661
46025,"Clark County, South Dakota",3639,1866,1773,26759,2456,331,63,15,1,3576,198,130,328,553,293,260,1751,18
46077,"Kingsbury County, South Dakota",5070,2561,2509,33333,3644,624,143,50,9,4981,181,137,318,465,198,267,2577,7
46027,"Clay County, South Dakota",14029,7001,7028,24541,6973,1822,754,220,539,13828,668,649,1317,3223,1617,1606,7032,26
46041,"Dewey County, South Dakota",5652,2784,2868,17267,3076,316,106,4,7,5605,935,865,1800,1545,722,823,1915,17
46065,"Hughes County, South Dakota",17518,8548,8970,32000,12125,2694,905,248,155,16486,769,539,1308,1451,656,795,9473,17
46111,"Sanborn County, South Dakota",2349,1239,1110,31965,1712,253,54,19,4,2290,97,59,156,199,81,118,1263,0
46059,"Hand County, South Dakota",3311,1680,1631,33109,2377,427,88,35,0,3256,150,53,203,197,99,98,1691,3
46135,"Yankton County, South Dakota",22649,11888,10761,30395,15846,2970,896,256,209,21195,984,638,1622,3055,1282,1773,11460,7
46005,"Beadle County, South Dakota",18155,9113,9042,24950,12084,1937,452,17,52,17853,685,864,1549,3812,1741,2071,8895,80
46035,"Davison County, South Dakota",19824,9974,9850,28086,13203,2649,694,143,32,19467,940,489,1429,2283,1310,973,10188,31
46073,"Jerauld County, South Dakota",2029,975,1054,38776,1470,188,53,20,0,1987,82,61,143,195,72,123,982,17
46117,"Stanley County, South Dakota",2964,1522,1442,32862,2019,271,188,46,40,2964,152,87,239,211,73,138,1650,7
28131,"Stone County, Mississippi",17995,9197,8798,21615,11914,1244,383,12,30,17377,1606,1166,2772,3513,1801,1712,7150,88
46023,"Charles Mix County, South Dakota",9277,4628,4649,21805,5736,740,167,74,59,9035,914,951,1865,1927,893,1034,3795,92
46091,"Marshall County, South Dakota",4743,2477,2266,28861,3306,526,139,30,52,4678,280,183,463,493,153,340,2462,54
46105,"Perkins County, South Dakota",3019,1547,1472,30120,2183,292,80,41,6,2975,204,120,324,400,184,216,1459,2
46121,"Todd County, South Dakota",10019,4890,5129,11665,4885,573,138,35,23,9978,1578,1459,3037,4582,2197,2385,2790,122
46102,"Oglala Lakota County, South Dakota",14263,6890,7373,9334,7027,647,123,17,0,14244,2751,2066,4817,7622,3489,4133,3085,106
47165,"Sumner County, Tennessee",172786,84479,88307,30669,116882,20190,7107,1699,927,171238,8947,7476,16423,16543,6972,9571,83075,700
47169,"Trousdale County, Tennessee",7970,4001,3969,22863,5339,521,207,54,8,7879,648,321,969,1043,450,593,3467,0
47027,"Clay County, Tennessee",7769,3823,3946,17667,5674,327,360,78,15,7675,547,483,1030,1904,912,992,2515,19
47157,"Shelby County, Tennessee",936990,446704,490286,28117,602898,112670,47897,13163,8162,924508,70319,56072,126391,196471,87994,108477,420644,5091
47077,"Henderson County, Tennessee",27952,13455,14497,21344,19242,1725,642,103,101,27646,1496,1508,3004,5703,2453,3250,11077,41
47089,"Jefferson County, Tennessee",52851,26034,26817,23724,36897,3473,1763,262,267,51998,3240,2705,5945,7724,3575,4149,22549,189
47153,"Sequatchie County, Tennessee",14710,7292,7418,22744,10344,826,310,112,122,14484,725,799,1524,2328,1001,1327,5676,8
47017,"Carroll County, Tennessee",28417,13815,14602,20557,19538,1763,909,145,109,27936,1661,1410,3071,5441,2476,2965,10880,254
47037,"Davidson County, Tennessee",667885,322044,345841,32347,454177,108196,43972,12641,8700,660681,52683,41058,93741,114238,51988,62250,344577,2684
47135,"Perry County, Tennessee",7891,3988,3903,20204,5545,394,119,16,16,7749,676,631,1307,2216,984,1232,2666,119
47121,"Meigs County, Tennessee",11804,5828,5976,22542,8500,392,220,124,14,11670,647,667,1314,2160,835,1325,3878,46
47075,"Haywood County, Tennessee",18129,8472,9657,21453,12534,911,425,91,65,17887,1182,874,2056,3744,1622,2122,7421,107
47125,"Montgomery County, Tennessee",189709,94948,94761,24827,115734,20011,7275,1122,908,175756,9575,8628,18203,28232,12255,15977,85552,882
47061,"Grundy County, Tennessee",13494,6686,6808,15824,9465,618,338,28,54,13313,1539,1024,2563,3718,1674,2044,4312,8
47029,"Cocke County, Tennessee",35256,17222,18034,20189,25243,1659,723,129,75,34976,2525,2522,5047,9081,4065,5016,13715,71
47041,"DeKalb County, Tennessee",19159,9493,9666,25443,13323,1252,385,134,118,18917,1363,1193,2556,4152,1780,2372,7489,90
47101,"Lewis County, Tennessee",11907,5904,6003,20099,8397,724,208,60,41,11688,879,840,1719,2384,1162,1222,4779,152
47131,"Obion County, Tennessee",30900,14833,16067,21939,21585,2164,1046,256,112,30481,2131,2064,4195,6399,2889,3510,12179,208
47167,"Tipton County, Tennessee",61558,30403,31155,26110,40282,3828,2016,378,69,60678,3964,2827,6791,8378,3688,4690,26989,119
16073,"Owyhee County, Idaho",11356,5826,5530,19909,7353,595,87,15,14,11208,1643,1284,2927,2643,1360,1283,4396,88
16013,"Blaine County, Idaho",21427,10824,10603,32736,15049,4486,1246,288,278,21401,2128,1409,3537,2707,1297,1410,11501,120
16015,"Boise County, Idaho",6891,3616,3275,29648,5247,948,315,80,72,6864,545,305,850,938,507,431,2641,19
16021,"Boundary County, Idaho",11141,5646,5495,24606,7716,879,319,115,35,11062,1121,1260,2381,1813,858,955,3794,27
16023,"Butte County, Idaho",2592,1374,1218,26227,1826,195,69,3,5,2553,164,184,348,396,214,182,959,5
16029,"Caribou County, Idaho",6813,3467,3346,25669,4411,590,102,31,74,6734,311,247,558,680,308,372,3035,6
16047,"Gooding County, Idaho",15157,7870,7287,20821,9560,1006,254,87,18,15075,1652,1484,3136,2348,1210,1138,6782,98
16001,"Ada County, Idaho",425798,213344,212454,31642,281818,69905,23725,6548,4010,419643,23887,20828,44715,51101,23989,27112,205169,1089
16005,"Bannock County, Idaho",83815,41777,42038,23872,52263,9505,2868,1054,962,82662,4664,4565,9229,14875,6978,7897,36058,214
16007,"Bear Lake County, Idaho",5928,2943,2985,24411,3923,624,101,16,25,5889,310,277,587,847,420,427,2457,4
16011,"Bingham County, Idaho",45261,22611,22650,20720,27068,3501,1034,267,84,44950,2967,2976,5943,6008,2957,3051,18586,145
16019,"Bonneville County, Idaho",108989,54256,54733,25706,65861,12670,3978,836,850,107706,6789,6070,12859,13711,5862,7849,46927,471
16025,"Camas County, Idaho",968,500,468,29193,643,113,10,2,7,968,112,100,212,192,88,104,458,12
16035,"Clearwater County, Idaho",8528,4772,3756,22169,6721,776,234,93,28,7444,448,550,998,972,435,537,2784,53
16051,"Jefferson County, Idaho",27096,13741,13355,21519,15446,2460,520,175,55,27065,2087,1478,3565,3023,1222,1801,11192,153
16059,"Lemhi County, Idaho",7743,3942,3801,22489,5972,906,238,73,40,7656,623,545,1168,1284,663,621,3005,60
16075,"Payette County, Idaho",22773,11394,11379,23361,14810,1692,324,193,138,22628,1962,1837,3799,4199,1998,2201,9338,135
16017,"Bonner County, Idaho",41389,20754,20635,25909,30431,4512,1436,446,318,41054,3042,3015,6057,6092,2750,3342,16008,186
16037,"Custer County, Idaho",4185,2122,2063,23290,3236,556,221,60,10,4152,176,398,574,852,416,436,1668,79
16039,"Elmore County, Idaho",26103,13525,12578,23029,15788,1823,621,100,71,23889,1536,1597,3133,4587,2165,2422,11659,65
16065,"Madison County, Idaho",38114,19220,18894,15257,15798,3778,1334,259,445,37906,1723,1431,3154,12226,6062,6164,16240,129
16079,"Shoshone County, Idaho",12551,6287,6264,23834,9156,848,199,62,65,12365,894,998,1892,2208,1022,1186,5018,113
16081,"Teton County, Idaho",10437,5375,5062,28004,6796,2046,501,99,70,10437,679,784,1463,1283,519,764,5428,2
16087,"Washington County, Idaho",10035,4975,5060,20435,6974,717,322,37,0,9898,888,918,1806,1508,749,759,3670,55
17067,"Hancock County, Illinois",18633,9267,9366,26118,13424,1843,570,69,149,18471,613,522,1135,2124,920,1204,8330,65
17063,"Grundy County, Illinois",50338,25173,25165,31914,33114,4774,2124,234,78,50076,1312,1436,2748,4899,2037,2862,23789,81
17091,"Kankakee County, Illinois",111493,54748,56745,26150,72888,8681,4183,612,342,109212,5696,3595,9291,16800,7826,8974,49015,865
17043,"DuPage County, Illinois",930514,456361,474153,42050,629381,180458,86866,19447,11002,924733,38364,31175,69539,64677,28159,36518,474127,2771
17003,"Alexander County, Illinois",7051,3462,3589,18564,4808,323,98,4,7,6865,466,379,845,2284,1028,1256,2247,31
17129,"Menard County, Illinois",12576,6142,6434,32839,8816,1556,362,109,82,12415,311,245,556,1564,662,902,6038,15
17099,"LaSalle County, Illinois",111935,56200,55735,27959,77885,8744,3141,871,456,108968,4935,3724,8659,15069,6487,8582,49487,401
17031,"Cook County, Illinois",5227575,2535190,2692385,33722,3546688,775888,367264,99785,50581,5182720,363517,288591,652108,856682,380715,475967,2442256,20239
17115,"Macon County, Illinois",108404,51954,56450,28280,74063,10916,4426,970,579,105887,4633,3144,7777,19626,8420,11206,47649,300
17137,"Morgan County, Illinois",34801,17511,17290,26253,24005,3124,1301,338,191,32924,1375,901,2276,4684,2185,2499,15578,57
17191,"Wayne County, Illinois",16517,8183,8334,25046,11569,1178,350,62,27,16471,780,565,1345,2552,1157,1395,7339,45
17203,"Woodford County, Illinois",39123,19428,19695,34198,25964,5630,1765,208,301,38567,955,759,1714,2942,1352,1590,18494,50
17055,"Franklin County, Illinois",39503,19434,20069,22346,27710,2805,1195,134,98,39035,2089,1769,3858,7440,3401,4039,15203,132
17109,"McDonough County, Illinois",31727,15668,16059,22527,18326,3356,1849,154,788,31356,1195,1030,2225,6513,2853,3660,13630,66
17111,"McHenry County, Illinois",307083,152971,154112,36208,203847,45268,18090,2846,1568,305899,11312,9968,21280,23653,11290,12363,156611,904
17139,"Moultrie County, Illinois",14915,7246,7669,26166,10154,1185,421,86,40,14607,1018,874,1892,1769,939,830,6817,141
17145,"Perry County, Illinois",21595,11698,9897,23929,15253,1502,466,32,41,19287,711,450,1161,3102,1164,1938,8149,27
17151,"Pope County, Illinois",4255,2247,2008,22191,3260,273,158,12,5,4071,150,108,258,604,233,371,1264,13
17163,"St. Clair County, Illinois",265569,128153,137416,28643,177512,28251,14818,2233,1108,259664,13985,9794,23779,46059,19546,26513,117738,1159
17173,"Shelby County, Illinois",22011,10930,11081,24808,15620,1682,618,53,20,21820,907,543,1450,2810,1355,1455,10189,36
17019,"Champaign County, Illinois",206420,103115,103305,28463,118545,26688,15958,3262,6165,204456,8095,5624,13719,41161,19770,21391,102204,518
17013,"Calhoun County, Illinois",4962,2496,2466,25660,3570,329,187,9,12,4884,115,80,195,595,300,295,2113,38
17053,"Ford County, Illinois",13758,6783,6975,26611,9602,1203,422,21,23,13349,590,393,983,1871,798,1073,6128,28
17085,"Jo Daviess County, Illinois",22186,11165,11021,32401,16281,2515,1168,163,78,22034,795,648,1443,2051,876,1175,10708,36
17093,"Kendall County, Illinois",121452,60053,61399,33369,76080,16580,8132,896,466,121167,3572,2341,5913,6578,2638,3940,61488,227
17101,"Lawrence County, Illinois",16582,9285,7297,21072,12081,896,276,45,9,12092,393,657,1050,1929,671,1258,4710,33
17121,"Marion County, Illinois",38503,18824,19679,24112,26548,2604,1171,168,47,37798,1969,1401,3370,6867,3073,3794,16354,62
17125,"Mason County, Illinois",13931,6921,7010,25952,9982,998,319,55,56,13737,501,450,951,2115,975,1140,5959,41
17075,"Iroquois County, Illinois",28814,14042,14772,26480,20276,1984,751,147,82,28362,1368,960,2328,4556,1990,2566,13195,185
17025,"Clay County, Illinois",13466,6642,6824,25700,9366,1021,260,71,34,13298,577,483,1060,1854,794,1060,6199,25
17059,"Gallatin County, Illinois",5325,2512,2813,24538,3813,316,100,5,18,5325,204,161,365,860,364,496,2046,27
17133,"Monroe County, Illinois",33703,16535,17168,37043,23552,4636,1897,296,185,33422,888,529,1417,1480,537,943,17074,40
17143,"Peoria County, Illinois",186818,90575,96243,29683,124198,23140,10276,2346,1246,184557,7929,5883,13812,29991,13074,16917,84169,543
20089,"Jewell County, Kansas",3003,1501,1502,24361,2241,244,57,3,39,2975,117,116,233,454,193,261,1315,13
20093,"Kearny County, Kansas",3943,2061,1882,24232,2483,200,108,46,0,3873,171,267,438,483,198,285,1751,0
20159,"Rice County, Kansas",9949,5020,4929,23355,6380,962,343,31,92,9744,662,537,1199,1404,690,714,4735,28
20185,"Stafford County, Kansas",4284,2170,2114,25941,2976,490,131,10,15,4171,230,235,465,654,365,289,2010,62
20113,"McPherson County, Kansas",29164,14453,14711,29508,19836,3918,1329,239,133,28489,815,888,1703,1833,716,1117,15483,110
20139,"Osage County, Kansas",16001,8018,7983,27209,11016,1486,555,61,95,15795,696,824,1520,1826,808,1018,7037,32
20071,"Greeley County, Kansas",1235,602,633,25775,872,208,34,13,3,1205,54,38,92,85,38,47,574,2
20031,"Coffey County, Kansas",8433,4215,4218,31679,5946,930,263,44,20,8323,458,345,803,892,415,477,4014,8
20037,"Crawford County, Kansas",39281,19575,19706,21207,23503,4143,1932,363,226,38648,2626,2373,4999,8176,4149,4027,18422,114
20051,"Ellis County, Kansas",29032,14529,14503,29339,17516,4197,1289,265,228,28776,1202,1183,2385,4008,2017,1991,15841,21
20073,"Greenwood County, Kansas",6304,3101,3203,24837,4546,556,214,21,12,6221,365,394,759,890,368,522,2772,21
20099,"Labette County, Kansas",20833,10291,10542,22841,14106,1609,639,198,93,20513,1207,1265,2472,3699,1702,1997,9338,100
20107,"Linn County, Kansas",9524,4695,4829,25796,6687,771,233,26,39,9459,387,442,829,1413,585,828,3961,27
20173,"Sedgwick County, Kansas",508221,251174,257047,27583,325515,64944,25073,4869,2903,502146,33961,29040,63001,75476,34618,40858,240607,2285
20175,"Seward County, Kansas",23185,11823,11362,21158,13194,1134,297,92,4,22994,2353,2051,4404,4285,1736,2549,10678,102
20157,"Republic County, Kansas",4768,2337,2431,27121,3547,457,237,19,31,4672,191,135,326,530,214,316,2414,45
20065,"Graham County, Kansas",2577,1278,1299,27165,1941,385,68,18,23,2549,129,79,208,262,88,174,1210,35
20091,"Johnson County, Kansas",572428,279962,292466,43061,383300,129276,55069,14601,6429,568331,19703,18140,37843,34189,14600,19589,300970,1388
20045,"Douglas County, Kansas",116352,57945,58407,29438,65863,17497,9719,2307,3211,115688,6158,5859,12017,20668,10948,9720,62117,368
20179,"Sheridan County, Kansas",2522,1303,1219,30165,1858,326,77,22,0,2494,114,140,254,152,45,107,1255,11
20121,"Miami County, Kansas",32787,16153,16634,31611,21936,3747,1381,197,94,32194,1146,1073,2219,3079,1332,1747,15867,114
20199,"Wallace County, Kansas",1584,799,785,29931,1061,205,47,2,10,1565,81,38,119,158,71,87,733,1
20189,"Stevens County, Kansas",5738,2903,2835,24691,3549,468,107,10,0,5632,400,519,919,1014,377,637,2583,8
20183,"Smith County, Kansas",3701,1820,1881,28122,2759,445,102,27,32,3643,96,148,244,505,195,310,1757,8
20085,"Jackson County, Kansas",13365,6670,6695,25920,8976,1189,565,53,27,13231,365,412,777,1075,412,663,6249,20
20095,"Kingman County, Kansas",7697,3904,3793,30927,5457,956,276,24,25,7558,382,235,617,662,212,450,3596,66
20131,"Nemaha County, Kansas",10177,5092,5085,27438,6749,1105,281,48,36,9904,264,289,553,1078,452,626,5173,31
20209,"Wyandotte County, Kansas",161777,79712,82065,20192,101519,11126,3997,850,548,160525,17720,16047,33767,36409,16340,20069,71474,310
20021,"Cherokee County, Kansas",20737,10184,10553,21006,14226,1663,797,136,32,20512,1512,1411,2923,3315,1593,1722,8906,30
20027,"Clay County, Kansas",8346,4090,4256,28115,5792,972,398,48,31,8038,285,236,521,797,304,493,4176,51
20105,"Lincoln County, Kansas",3134,1573,1561,25667,2181,301,90,22,6,3069,167,186,353,325,134,191,1448,5
20191,"Sumner County, Kansas",23509,11647,11862,25393,15758,2233,630,133,66,23014,1271,992,2263,2872,1205,1667,10576,53
20195,"Trego County, Kansas",2927,1431,1496,33233,2163,415,120,13,11,2852,120,90,210,123,52,71,1652,14
20205,"Wilson County, Kansas",8956,4371,4585,25107,6218,632,206,70,42,8826,681,628,1309,1456,695,761,4129,36
20123,"Mitchell County, Kansas",6299,3229,3070,26108,4274,775,262,54,8,6144,279,128,407,697,242,455,2944,4
20135,"Ness County, Kansas",3047,1563,1484,30761,2204,358,72,14,0,2995,102,105,207,338,204,134,1470,8
20005,"Atchison County, Kansas",16557,8046,8511,25494,10273,1336,497,41,171,16381,769,856,1625,2941,1325,1616,7493,53
20011,"Bourbon County, Kansas",14751,7276,7475,20707,9562,1352,543,154,29,14470,681,625,1306,2489,1131,1358,6553,69
20075,"Hamilton County, Kansas",2567,1368,1199,21694,1566,197,39,4,15,2567,393,254,647,282,130,152,1275,0
20103,"Leavenworth County, Kansas",78785,42238,36547,30170,53079,8849,6107,636,361,71725,2400,2249,4649,7238,3214,4024,34739,291
20177,"Shawnee County, Kansas",178567,86494,92073,28584,119829,22302,8946,2446,1357,175276,9486,7810,17296,25190,12173,13017,83343,743
20203,"Wichita County, Kansas",2168,1063,1105,27111,1423,191,62,7,0,2141,67,101,168,127,57,70,1011,0
20019,"Chautauqua County, Kansas",3470,1755,1715,23621,2527,359,83,9,11,3399,232,192,424,504,233,271,1482,16
20137,"Norton County, Kansas",5558,3204,2354,22935,4045,466,61,26,5,4749,128,143,271,419,166,253,2608,22
20155,"Reno County, Kansas",63803,32151,31652,25267,43380,5567,2246,344,167,61280,3102,3532,6634,8727,3968,4759,28801,317
20029,"Cloud County, Kansas",9302,4633,4669,25579,6213,757,369,68,64,9067,564,436,1000,1154,582,572,4447,66
20047,"Edwards County, Kansas",2975,1539,1436,27966,2085,301,68,6,5,2880,160,202,362,318,140,178,1413,46
20081,"Haskell County, Kansas",4087,2066,2021,24141,2480,288,131,15,4,4028,349,394,743,521,247,274,1905,16
20165,"Rush County, Kansas",3144,1557,1587,25983,2309,317,171,30,30,3078,118,132,250,230,100,130,1477,3
20171,"Scott County, Kansas",4958,2385,2573,31825,3323,685,128,62,0,4859,148,53,201,250,52,198,2472,15
20133,"Neosho County, Kansas",16358,7966,8392,23589,10801,1174,659,141,65,16142,672,954,1626,3113,1342,1771,7692,38
20143,"Ottawa County, Kansas",6004,3154,2850,28839,4129,672,172,17,26,5915,248,213,461,501,230,271,2950,28
20147,"Phillips County, Kansas",5484,2672,2812,24795,3801,596,192,46,15,5369,192,126,318,503,159,344,2767,9
06009,"Calaveras County, California",44787,22156,22631,31652,33853,4645,1550,424,226,44402,2078,1589,3667,5641,2346,3295,15995,75
06081,"San Mateo County, California",754748,371545,383203,53516,535502,148547,66121,20918,16375,750878,29874,24272,54146,57490,25845,31645,387602,3543
06109,"Tuolumne County, California",53864,28134,25730,31570,40694,5312,1929,538,255,50802,2545,1864,4409,7176,3129,4047,19075,107
06005,"Amador County, California",36963,19839,17124,29628,28746,4212,1192,540,240,33012,1422,901,2323,3684,1767,1917,12196,105
08095,"Phillips County, Colorado",4347,2256,2091,27790,3035,445,121,27,26,4280,296,264,560,509,217,292,2056,0
08031,"Denver County, Colorado",663303,331602,331701,38991,468263,131013,56260,18163,8649,657039,49598,35791,85389,106745,50708,56037,353976,2691
08061,"Kiowa County, Colorado",1465,699,766,23621,944,124,58,4,5,1439,98,66,164,154,50,104,668,14
08009,"Baca County, Colorado",3648,1743,1905,22853,2619,411,105,52,4,3548,250,212,462,634,258,376,1607,12
08047,"Gilpin County, Colorado",5708,3019,2689,45110,4394,1025,339,24,122,5657,306,295,601,392,185,207,3124,26
08063,"Kit Carson County, Colorado",8174,4682,3492,26125,5813,540,188,53,23,7304,667,479,1146,1033,446,587,3618,46
08051,"Gunnison County, Colorado",15889,8606,7283,27669,10085,3883,1052,177,192,15840,1272,822,2094,2319,1055,1264,8908,50
08059,"Jefferson County, Colorado",558810,277758,281052,40187,395230,105643,45927,8943,6354,552426,25132,19294,44426,44629,20267,24362,295608,2220
08091,"Ouray County, Colorado",4651,2216,2435,35544,3762,1211,580,138,121,4651,327,249,576,425,201,224,2242,29
08103,"Rio Blanco County, Colorado",6658,3403,3255,28185,4261,623,250,20,38,6552,373,308,681,788,377,411,3189,7
08123,"Weld County, Colorado",278065,139799,138266,29226,175279,32451,10966,1841,1650,275485,15625,14612,30237,34050,15245,18805,131610,862
08021,"Conejos County, Colorado",8213,4100,4113,19047,5289,718,207,20,25,8173,672,614,1286,1805,940,865,2812,48
08023,"Costilla County, Colorado",3590,1924,1666,20737,2611,234,228,27,34,3590,251,259,510,1092,536,556,1131,0
08035,"Douglas County, Colorado",314238,156120,158118,48725,203279,76292,31364,5603,3680,313326,7158,6184,13342,11807,5168,6639,162627,1548
08037,"Eagle County, Colorado",52894,28064,24830,40450,36594,12134,3018,1054,274,52844,5600,4107,9707,4237,2212,2025,32016,102
08067,"La Plata County, Colorado",53994,27292,26702,34501,37860,10138,3905,1124,1112,53516,4047,2834,6881,5569,2398,3171,27714,307
08081,"Moffat County, Colorado",13034,6761,6273,27331,8676,1097,473,30,37,12911,1057,764,1821,1419,725,694,6258,15
08105,"Rio Grande County, Colorado",11623,5733,5890,22412,7808,1081,465,136,80,11426,862,750,1612,2174,1057,1117,4681,18
08011,"Bent County, Colorado",5816,3821,1995,14028,4688,309,123,6,7,3758,330,225,555,943,429,514,1301,17
08025,"Crowley County, Colorado",5537,3173,2364,14393,3737,237,136,5,5,4308,181,267,448,1479,604,875,1605,3
08111,"San Juan County, Colorado",552,291,261,28889,457,110,18,0,2,552,49,51,100,21,11,10,349,0
08057,"Jackson County, Colorado",1306,634,672,24299,991,146,16,16,11,1301,94,65,159,179,73,106,723,25
08075,"Logan County, Colorado",21862,11972,9890,24595,14675,1655,569,142,87,21263,1740,1016,2756,3394,1621,1773,10351,74
08083,"Montezuma County, Colorado",26006,12843,13163,24440,18206,2883,1579,246,211,25822,2803,2212,5015,4811,2325,2486,10839,73
08119,"Teller County, Colorado",23472,11986,11486,34974,17572,3622,1648,291,163,23235,1002,995,1997,1752,827,925,11634,178
08013,"Boulder County, Colorado",313961,157617,156344,42119,202434,64270,37367,7700,10732,311909,12614,10546,23160,40732,19741,20991,164848,1563
08071,"Las Animas County, Colorado",14322,7392,6930,24268,10360,1225,617,101,20,13784,728,788,1516,1926,853,1073,6106,76
08073,"Lincoln County, Colorado",5515,3460,2055,14765,4079,415,112,17,14,3518,111,116,227,597,233,364,1353,17
08107,"Routt County, Colorado",23980,12465,11515,38111,17382,5677,2069,610,233,23881,1525,1230,2755,2408,1372,1036,13875,112
08003,"Alamosa County, Colorado",16353,7971,8382,19217,9332,1408,751,89,160,15910,1189,896,2085,4786,2037,2749,6238,26
08019,"Clear Creek County, Colorado",9238,4779,4459,41257,7172,2085,839,154,118,9113,541,298,839,677,348,329,5039,93
08043,"Fremont County, Colorado",46835,27365,19470,20919,36329,3606,1911,255,185,36309,1814,1720,3534,6012,2754,3258,14100,207
26105,"Mason County, Michigan",28755,14295,14460,26251,20576,2731,1155,216,170,28452,1716,1107,2823,4601,2081,2520,12098,125
26109,"Menominee County, Michigan",23568,11917,11651,26151,17312,1988,564,158,35,23264,1065,891,1956,3492,1430,2062,10085,88
26117,"Montcalm County, Michigan",62922,32440,30482,21509,43290,3786,1275,281,96,60444,3580,2665,6245,10448,4655,5793,24649,268
26113,"Missaukee County, Michigan",15032,7685,7347,21805,10411,937,383,56,20,14921,918,678,1596,2234,1039,1195,6021,36
26149,"St. Joseph County, Michigan",60923,30276,30647,23702,40651,3849,1865,299,216,60367,3378,2737,6115,9697,4433,5264,26433,184
26147,"St. Clair County, Michigan",160069,79403,80666,27807,111685,12656,5501,962,527,158877,7220,5615,12835,22366,9554,12812,69204,460
26159,"Van Buren County, Michigan",75216,37361,37855,25433,50901,6726,2803,439,380,74743,4735,3490,8225,12998,5937,7061,31869,132
26161,"Washtenaw County, Michigan",358082,177102,180980,37455,221550,55999,39394,9644,12907,353152,11308,8985,20293,51476,24932,26544,176009,879
26011,"Arenac County, Michigan",15327,7751,7576,22622,11426,789,443,45,24,15181,884,548,1432,2897,1434,1463,5643,60
26015,"Barry County, Michigan",59316,29844,29472,27166,41144,5060,2209,336,178,58893,1983,1823,3806,5461,2482,2979,26797,82
26027,"Cass County, Michigan",51795,26062,25733,28019,36542,4232,1672,280,165,51672,2992,2193,5185,7636,3690,3946,22059,128
26071,"Iron County, Michigan",11393,5619,5774,23658,8914,1116,386,73,42,11116,533,485,1018,1907,924,983,4249,18
26019,"Benzie County, Michigan",17462,8709,8753,26790,13009,1926,1066,206,136,17272,1161,700,1861,1926,926,1000,7530,64
26143,"Roscommon County, Michigan",23900,11858,12042,22333,18885,1592,871,77,92,23678,1500,1101,2601,4644,1997,2647,7490,79
26153,"Schoolcraft County, Michigan",8186,4047,4139,21534,6109,673,235,30,23,8076,456,322,778,1728,821,907,2713,5
26163,"Wayne County, Michigan",1767593,849914,917679,24847,1168342,157925,77609,15897,9554,1755443,104407,79462,183869,428189,195180,233009,694613,5602
26023,"Branch County, Michigan",43603,22540,21063,22977,29903,2769,1007,185,114,41585,2692,2273,4965,7368,3649,3719,18342,151
26055,"Grand Traverse County, Michigan",90715,44604,46111,31701,64721,12375,5735,1588,800,88868,4123,3391,7514,8649,4105,4544,44301,406
26075,"Jackson County, Michigan",159483,81632,77851,25952,109502,15493,5386,958,705,151652,6788,6057,12845,25032,10698,14334,64997,404
26049,"Genesee County, Michigan",413090,199181,213909,25180,278481,34598,16045,3184,1600,410606,18007,12978,30985,85283,38516,46767,160220,855
26009,"Antrim County, Michigan",23215,11544,11671,29307,17290,2859,1374,229,152,23049,1125,1017,2142,2962,1274,1688,9373,63
26093,"Livingston County, Michigan",185841,93057,92784,36845,127944,28598,11891,1934,1081,185009,5511,4535,10046,10972,4916,6056,91640,565
26069,"Iosco County, Michigan",25373,12625,12748,24099,19508,1946,940,184,101,25048,1429,1183,2612,4205,2045,2160,8733,81
45041,"Florence County, South Carolina",138575,64672,73903,23797,92344,13383,5492,954,855,136982,8310,8048,16358,26515,11007,15508,58222,452
45059,"Laurens County, South Carolina",66442,32155,34287,20748,45030,4056,1885,247,185,65152,4342,4322,8664,13028,5707,7321,27532,113
45065,"McCormick County, South Carolina",9806,5450,4356,22836,7984,977,389,49,74,8524,466,310,776,1672,766,906,2689,17
45077,"Pickens County, South Carolina",120722,60065,60657,23501,75105,10488,4825,968,1443,120016,7071,6513,13584,21236,10075,11161,50900,247
45087,"Union County, South Carolina",27928,13442,14486,21183,19700,1593,653,74,120,27441,1755,1298,3053,5464,2261,3203,11009,125
45089,"Williamsburg County, South Carolina",32816,15946,16870,17440,22900,1924,714,168,50,30990,2230,2257,4487,9056,3821,5235,11548,91
46003,"Aurora County, South Dakota",2732,1437,1295,30872,1823,292,58,10,16,2603,90,66,156,161,72,89,1396,37
46051,"Grant County, South Dakota",7195,3707,3488,29363,5100,666,67,10,2,7145,254,112,366,555,225,330,3853,0
46123,"Tripp County, South Dakota",5475,2763,2712,27613,3893,616,132,35,50,5334,285,236,521,1147,513,634,2867,15
46137,"Ziebach County, South Dakota",2818,1388,1430,13461,1518,182,41,5,8,2818,430,264,694,1106,515,591,945,21
46115,"Spink County, South Dakota",6539,3270,3269,31957,4504,754,137,47,12,6408,262,262,524,703,289,414,3203,18
46009,"Bon Homme County, South Dakota",7001,4064,2937,24858,5146,685,168,37,53,5604,164,163,327,601,275,326,2818,26
46011,"Brookings County, South Dakota",33435,17181,16254,27197,17474,4686,1604,155,711,33303,1250,906,2156,4949,2694,2255,18404,44
46047,"Fall River County, South Dakota",6874,3499,3375,26584,5211,920,194,105,29,6671,323,298,621,1115,525,590,3036,39
46057,"Hamlin County, South Dakota",5995,3034,2961,27060,3672,573,134,23,22,5849,174,129,303,449,187,262,2856,37
46071,"Jackson County, South Dakota",3268,1676,1592,16939,1820,242,77,14,6,3223,409,352,761,1167,573,594,1163,15
46033,"Custer County, South Dakota",8447,4241,4206,31015,6641,1230,264,46,87,8137,456,489,945,944,456,488,3908,59
46069,"Hyde County, South Dakota",1440,705,735,30277,1058,179,29,0,8,1402,70,61,131,154,67,87,746,4
46049,"Faulk County, South Dakota",2354,1182,1172,29714,1705,293,92,23,37,2295,125,90,215,287,126,161,1129,4
46067,"Hutchinson County, South Dakota",7264,3641,3623,29869,5016,806,202,57,18,7019,395,230,625,940,491,449,3647,19
46129,"Walworth County, South Dakota",5538,2717,2821,29457,3969,600,125,69,25,5375,227,238,465,576,202,374,2636,29
46017,"Buffalo County, South Dakota",2052,986,1066,10960,1030,63,11,6,3,2052,494,462,956,800,395,405,601,7
46037,"Day County, South Dakota",5588,2883,2705,30841,4045,543,94,39,17,5425,379,258,637,997,482,515,2721,25
46043,"Douglas County, South Dakota",2961,1458,1503,27603,2109,307,90,28,10,2865,196,154,350,208,64,144,1496,15
46063,"Harding County, South Dakota",1277,655,622,30464,842,201,44,5,0,1257,43,47,90,165,82,83,644,8
46089,"McPherson County, South Dakota",2252,1164,1088,25975,1714,205,40,7,7,2160,248,89,337,404,279,125,1019,0
46109,"Roberts County, South Dakota",10294,5167,5127,25767,6498,713,234,49,46,10098,1031,959,1990,2064,973,1091,4343,30
46119,"Sully County, South Dakota",1456,802,654,39888,972,205,37,4,0,1456,112,47,159,63,35,28,743,0
46083,"Lincoln County, South Dakota",51396,25464,25932,39404,32937,9482,2728,883,488,51103,1146,1317,2463,1903,682,1221,28369,156
46079,"Lake County, South Dakota",12331,6355,5976,31145,8257,2017,469,78,178,12181,528,315,843,1601,643,958,6232,49
46081,"Lawrence County, South Dakota",24859,12353,12506,28606,16919,3571,1298,145,333,24615,1604,1364,2968,2873,1236,1637,12581,99
46029,"Codington County, South Dakota",27886,14048,13838,29249,18573,3251,479,132,27,27572,948,1047,1995,2847,1260,1587,14982,48
46019,"Butte County, South Dakota",10268,5076,5192,26178,7032,1133,208,23,21,10147,902,758,1660,1028,433,595,5092,6
46031,"Corson County, South Dakota",4170,2120,2050,15160,2336,318,59,0,5,4170,556,423,979,1929,932,997,1246,8
46045,"Edmunds County, South Dakota",4000,2001,1999,31836,2724,437,148,13,27,3882,187,91,278,380,141,239,1970,17
46021,"Campbell County, South Dakota",1553,735,818,36158,1084,212,12,15,19,1553,26,55,81,117,54,63,712,0
46007,"Bennett County, South Dakota",3445,1576,1869,15287,1922,275,51,6,10,3406,392,368,760,1286,506,780,1114,44
46055,"Haakon County, South Dakota",2073,1009,1064,22863,1467,234,45,8,5,2035,94,78,172,365,190,175,954,0
46075,"Jones County, South Dakota",767,418,349,26526,612,74,13,1,0,767,66,45,111,79,54,25,459,9
46093,"Meade County, South Dakota",26840,13990,12850,26896,17464,3129,754,147,123,25605,1424,1303,2727,2353,973,1380,14194,3
46125,"Turner County, South Dakota",8289,4169,4120,27844,5820,911,247,47,43,8132,286,274,560,837,316,521,4195,44
46013,"Brown County, South Dakota",38430,18716,19714,31493,25504,5142,1320,299,361,37898,1478,1579,3057,4076,1832,2244,20537,180
46061,"Hanson County, South Dakota",3390,1724,1666,24805,2057,339,89,11,1,3387,146,103,249,339,218,121,1695,3
46087,"McCook County, South Dakota",5616,2793,2823,29254,3748,625,172,29,19,5466,243,176,419,566,265,301,2792,9
46095,"Mellette County, South Dakota",2083,1039,1044,14264,1257,156,14,6,0,2051,312,214,526,937,448,489,733,0
46101,"Moody County, South Dakota",6445,3268,3177,27774,4272,852,240,25,30,6389,445,242,687,935,425,510,3329,31
46103,"Pennington County, South Dakota",107298,53929,53369,28910,72302,13903,4899,1253,861,104572,6436,5616,12052,14402,6427,7975,53547,344
46127,"Union County, South Dakota",14842,7464,7378,37093,10074,1740,884,229,183,14702,487,449,936,943,342,601,7655,40
46097,"Miner County, South Dakota",2299,1180,1119,28633,1568,239,48,15,37,2257,102,109,211,223,107,116,1077,14
47031,"Coffee County, Tennessee",53808,26166,27642,24748,36481,4398,1782,293,258,53196,3252,2976,6228,8437,3766,4671,22116,102
47047,"Fayette County, Tennessee",39071,19264,19807,30471,28134,4131,1618,243,218,38611,1956,1539,3495,5774,2698,3076,17001,117
47067,"Hancock County, Tennessee",6609,3288,3321,19396,4752,335,155,15,33,6446,444,381,825,1757,710,1047,2053,16
47073,"Hawkins County, Tennessee",56567,27698,28869,22141,40416,3566,1138,352,193,55980,3545,2588,6133,10706,4487,6219,20840,188
47091,"Johnson County, Tennessee",17923,9618,8305,19183,13422,867,386,73,29,16087,1032,1005,2037,4313,2017,2296,5616,99
47103,"Lincoln County, Tennessee",33582,16438,17144,24029,23553,2715,1196,119,93,33236,1975,1639,3614,6123,2906,3217,13563,95
47111,"Macon County, Tennessee",22924,11376,11548,20666,15384,797,407,145,70,22591,1502,1104,2606,4167,1942,2225,9314,37
47127,"Moore County, Tennessee",6314,3093,3221,31479,4645,542,177,48,33,6228,253,332,585,644,218,426,2835,0
13167,"Johnson County, Georgia",9694,5141,4553,19706,6444,327,161,0,72,9446,1033,714,1747,2363,1187,1176,3798,123
13195,"Madison County, Georgia",28362,14038,14324,22885,19410,1754,883,235,131,28169,2309,2201,4510,4520,2105,2415,11380,93
13277,"Tift County, Georgia",40691,19224,21467,20800,25633,2284,1417,420,370,40277,4233,4024,8257,10638,4572,6066,16276,275
13263,"Talbot County, Georgia",6373,3043,3330,21351,4665,400,123,25,42,6354,379,509,888,1307,625,682,2539,126
13273,"Terrell County, Georgia",9132,4313,4819,17562,6128,412,197,74,57,8801,825,798,1623,3053,1236,1817,3132,0
13319,"Wilkinson County, Georgia",9312,4454,4858,19823,6423,316,192,34,13,9218,538,446,984,1915,795,1120,3297,25
13243,"Randolph County, Georgia",7224,3734,3490,19781,4800,390,193,20,38,7105,860,554,1414,2018,1049,969,2542,40
13299,"Ware County, Georgia",35671,17684,17987,19246,23805,1784,776,343,150,33339,2885,3141,6026,9310,3599,5711,12982,101
13315,"Wilcox County, Georgia",8884,5240,3644,15119,6359,356,179,46,25,6818,494,525,1019,1422,618,804,2460,22
13155,"Irwin County, Georgia",9365,4797,4568,19429,6386,373,165,101,73,8926,969,673,1642,2217,1063,1154,3102,30
13005,"Bacon County, Georgia",11251,5597,5654,18856,7312,612,276,61,16,10651,917,826,1743,1949,872,1077,4352,0
13033,"Burke County, Georgia",22838,10941,11897,19720,14706,818,444,180,88,22590,1867,1681,3548,6862,2885,3977,8552,76
13053,"Chattahoochee County, Georgia",11882,8023,3859,22774,5090,1182,260,44,47,7137,501,219,720,1174,700,474,6670,51
13087,"Decatur County, Georgia",27237,13219,14018,19650,17982,1810,810,218,199,25946,2620,2379,4999,6885,2883,4002,9817,414
13137,"Habersham County, Georgia",43724,20741,22983,20656,29334,2824,1643,408,262,41434,3727,3625,7352,7471,3552,3919,16240,188
47045,"Dyer County, Tennessee",37970,18329,19641,24695,25544,2837,1335,325,214,37444,2105,1935,4040,6915,2729,4186,15828,170
47065,"Hamilton County, Tennessee",351305,169346,181959,29711,243329,46339,18256,4786,2639,347387,20027,16390,36417,50631,22453,28178,161812,1260
47139,"Polk County, Tennessee",16697,8330,8367,24247,12014,759,310,75,19,16463,932,839,1771,2918,1401,1517,6350,42
47185,"White County, Tennessee",26373,12880,13493,19867,18599,1428,560,107,97,25972,1706,1625,3331,4662,2250,2412,9424,95
47163,"Sullivan County, Tennessee",156644,75878,80766,25946,113116,14814,6516,1488,1345,154992,9265,7242,16507,25982,11907,14075,64978,451
36095,"Schoharie County, New York",31667,15789,15878,26953,22026,2632,1504,207,169,31594,1232,660,1892,4273,2061,2212,13586,27
36035,"Fulton County, New York",54297,27062,27235,26298,38699,3695,2512,281,92,53503,2672,1909,4581,8861,4026,4835,23674,334
36083,"Rensselaer County, New York",159959,78890,81069,33067,110059,18613,10039,1942,1665,158204,5064,3298,8362,19064,8664,10400,78576,290
36033,"Franklin County, New York",51007,27788,23219,24294,35796,3291,2632,392,272,46172,2258,1782,4040,8706,4098,4608,19643,244
36081,"Queens County, New York",2310011,1120010,1190001,28814,1630963,316435,137606,30028,14937,2294929,177935,140943,318878,334149,145569,188580,1090910,5334
36115,"Washington County, New York",62465,32308,30157,26064,44794,5322,3082,435,230,59457,2889,1931,4820,7627,3608,4019,28175,92
36061,"New York County, New York",1634989,773232,861757,69529,1237623,393504,220929,90250,43270,1624084,71048,51694,122742,279847,121555,158292,875398,6812
36011,"Cayuga County, New York",78783,40388,38395,27957,55396,7079,3920,636,343,75490,3340,2163,5503,8494,3893,4601,36006,268
36087,"Rockland County, New York",322642,158136,164506,36898,202987,45139,27694,6045,3175,320199,13980,11228,25208,46128,21952,24176,144060,679
36063,"Niagara County, New York",213374,103798,109576,28395,150231,20581,12226,1465,1024,211319,6681,4823,11504,28523,12647,15876,98585,697
36031,"Essex County, New York",38598,20158,18440,29008,29016,3956,2432,383,367,36349,1466,1011,2477,3638,1569,2069,16975,523
36059,"Nassau County, New York",1356801,658161,698640,46839,934765,223888,128614,41380,13151,1346876,49685,38737,88422,80282,35043,45239,660186,3798
36097,"Schuyler County, New York",18336,9183,9153,25285,13277,1481,956,185,145,18062,963,579,1542,2617,1121,1496,8135,44
36017,"Chenango County, New York",49286,24601,24685,25233,34728,3224,2368,262,201,48706,2003,1352,3355,7468,3237,4231,20846,115
36045,"Jefferson County, New York",117966,61754,56212,24717,73692,8648,5272,948,426,105638,4710,3523,8233,16236,7638,8598,54184,558
36103,"Suffolk County, New York",1498130,737351,760779,40277,1024860,192708,119081,25880,14727,1483117,65239,47323,112562,106499,46853,59646,723743,4104
28069,"Kemper County, Mississippi",10128,4931,5197,15790,6852,515,222,35,8,9596,647,679,1326,2755,1029,1726,3508,110
36075,"Oswego County, New York",120513,60384,60129,25791,80149,8349,5061,563,480,119812,5047,3407,8454,21100,9714,11386,50895,205
36117,"Wayne County, New York",91874,45514,46360,27318,63894,8175,4494,581,306,90882,3684,2654,6338,10761,5120,5641,42287,383
36007,"Broome County, New York",197381,96991,100390,26790,130537,20084,12087,2179,1884,194413,6873,4357,11230,32624,14889,17735,86807,419
36029,"Erie County, New York",922129,446259,475870,31083,637800,113511,68330,14213,9313,910418,25857,18138,43995,132072,57904,74168,434029,2318
36105,"Sullivan County, New York",75818,38803,37015,28224,53020,6514,4150,664,525,73437,4219,2748,6967,12479,5735,6744,31731,251
36071,"Orange County, New York",376242,188285,187957,32616,238224,39527,22722,3783,2332,367037,14535,10484,25019,46342,20718,25624,171898,994
37087,"Haywood County, North Carolina",59577,28798,30779,27166,44393,6451,3136,549,415,59127,3978,3734,7712,9851,4662,5189,24548,227
37067,"Forsyth County, North Carolina",364691,173059,191632,28640,242327,51269,20404,5719,4040,361541,24671,22304,46975,69253,31017,38236,161825,1238
37017,"Bladen County, North Carolina",34454,16361,18093,20839,24247,2461,826,158,148,34088,2364,2501,4865,9549,4132,5417,12503,92
37031,"Carteret County, North Carolina",68537,33660,34877,30903,51177,7934,3807,898,636,66913,4907,4243,9150,8869,3800,5069,30151,480
37015,"Bertie County, North Carolina",20324,10389,9935,18319,14946,1152,444,101,28,19081,1630,963,2593,3992,1838,2154,6998,130
37117,"Martin County, North Carolina",23510,10951,12559,22161,16797,1786,551,159,155,23338,1777,1695,3472,4721,2004,2717,9066,31
37143,"Perquimans County, North Carolina",13470,6439,7031,25848,10020,1295,316,93,40,13373,939,1044,1983,2208,938,1270,5314,10
37157,"Rockingham County, North Carolina",91898,44313,47585,22521,65420,6372,2055,318,303,90850,5640,5437,11077,17517,7651,9866,37356,194
37029,"Camden County, North Carolina",10228,5133,5095,27468,7029,913,320,72,126,10034,582,455,1037,1060,492,568,4458,56
37071,"Gaston County, North Carolina",211753,102235,109518,24937,144794,20501,6255,1194,767,209643,15201,13975,29176,35812,15062,20750,91608,575
37125,"Moore County, North Carolina",93070,44833,48237,31554,67105,13816,6231,1780,1107,90500,5087,4769,9856,13478,5850,7628,38342,263
37167,"Stanly County, North Carolina",60610,30158,30452,23398,41814,4824,1487,236,187,59238,3566,3740,7306,10047,4379,5668,26204,162
37199,"Yancey County, North Carolina",17599,8609,8990,21947,12972,1731,534,173,175,17418,1263,1142,2405,3713,1692,2021,6623,64
37037,"Chatham County, North Carolina",68778,33303,35475,36933,50607,10310,5650,1743,1936,68048,4676,4014,8690,9185,4484,4701,28976,234
37101,"Johnston County, North Carolina",182155,89432,92723,24872,119442,18482,5367,927,555,180447,14254,12031,26285,26272,12217,14055,81508,367
37145,"Person County, North Carolina",39196,19019,20177,24477,27539,3119,801,83,101,38770,2636,1988,4624,7127,3305,3822,16185,121
37009,"Ashe County, North Carolina",26992,13302,13690,23650,20231,2799,946,105,101,26750,2595,1720,4315,5290,2611,2679,11415,155
37107,"Lenoir County, North Carolina",58343,27863,30480,21594,40257,3638,1474,192,204,57185,5219,4085,9304,12614,5631,6983,23819,148
37133,"Onslow County, North Carolina",185755,100854,84901,23141,99874,13534,4533,966,458,154944,9672,8541,18213,23890,10250,13640,90037,795
37161,"Rutherford County, North Carolina",66701,32392,34309,21092,47393,5212,1928,497,291,65822,4710,4525,9235,12668,5699,6969,25029,257
37197,"Yadkin County, North Carolina",37819,18602,19217,23038,26459,2198,827,107,79,37547,2883,2499,5382,7112,3349,3763,15200,103
37023,"Burke County, North Carolina",89082,44089,44993,21885,63189,7018,2603,704,333,86692,6806,5198,12004,17135,7818,9317,35924,220
38097,"Traill County, North Dakota",8075,4071,4004,31774,5462,1087,340,26,31,7893,200,150,350,637,328,309,4131,33
38021,"Dickey County, North Dakota",5160,2590,2570,30510,3531,754,127,75,31,5016,148,204,352,417,150,267,2737,0
38101,"Ward County, North Dakota",68954,36151,32803,33414,42320,8389,2070,441,263,64969,3046,2254,5300,4889,1906,2983,39373,164
38067,"Pembina County, North Dakota",7136,3689,3447,34824,5189,816,171,56,7,6959,369,227,596,415,199,216,3519,15
38041,"Hettinger County, North Dakota",2639,1252,1387,32544,1951,223,35,8,3,2480,102,92,194,207,61,146,1179,2
38017,"Cass County, North Dakota",166852,84300,82552,34193,103797,27277,7564,1998,1944,165567,7220,5451,12671,19089,9236,9853,95471,567
38029,"Emmons County, North Dakota",3426,1713,1713,29622,2473,340,22,7,9,3371,103,91,194,403,171,232,1456,21
38077,"Richland County, North Dakota",16329,8454,7875,29818,10478,1767,376,107,41,16153,394,387,781,1501,625,876,8667,35
20007,"Barber County, Kansas",4831,2472,2359,28840,3391,365,219,31,19,4790,233,277,510,674,323,351,2280,34
20039,"Decatur County, Kansas",2886,1431,1455,30890,2167,424,115,19,9,2801,173,140,313,373,92,281,1342,0
20087,"Jefferson County, Kansas",18880,9593,9287,27783,13165,1914,589,87,118,18614,1141,689,1830,1690,697,993,8906,45
21089,"Greenup County, Kentucky",36255,17640,18615,25378,25679,2723,1189,272,131,35838,1795,1643,3438,6268,2814,3454,13451,73
21069,"Fleming County, Kentucky",14543,7180,7363,23351,9817,678,448,66,54,14543,1336,1096,2432,3226,1414,1812,5636,14
21043,"Carter County, Kentucky",27292,13473,13819,18477,18391,1391,794,153,78,26985,1816,1594,3410,4933,2229,2704,9742,51
21063,"Elliott County, Kentucky",7661,4321,3340,13436,5639,301,157,20,18,6601,341,326,667,2210,1075,1135,1797,0
21111,"Jefferson County, Kentucky",759724,366994,392730,31039,520121,97303,48406,12877,7033,751564,35326,30007,65333,119158,52668,66490,362193,3544
21123,"Larue County, Kentucky",14127,6917,7210,21879,9905,652,354,49,9,13845,850,388,1238,2260,885,1375,5910,20
21161,"Mason County, Kentucky",17229,8535,8694,25285,11771,954,707,179,25,16943,1187,797,1984,3446,1614,1832,6976,36
26101,"Manistee County, Michigan",24465,12691,11774,24398,18130,2229,1032,238,112,23243,1314,884,2198,3723,1615,2108,8932,43
26119,"Montmorency County, Michigan",9317,4738,4579,23155,7434,556,276,27,17,9208,591,399,990,1496,594,902,2758,21
26051,"Gladwin County, Michigan",25367,12741,12626,23491,18727,1485,887,114,22,25177,1758,1396,3154,5099,2290,2809,8573,148
26107,"Mecosta County, Michigan",43259,21816,21443,21978,26482,3459,1597,219,341,43033,2191,1608,3799,9084,4372,4712,17127,189
26103,"Marquette County, Michigan",67418,34041,33377,25550,44635,8958,3169,796,490,65383,3224,2057,5281,10403,4905,5498,28938,150
26133,"Osceola County, Michigan",23172,11692,11480,21090,15991,1353,582,86,64,22912,1570,1260,2830,5172,2298,2874,8601,48
26137,"Otsego County, Michigan",24198,11924,12274,26012,16963,2230,996,211,37,24010,1075,1017,2092,3365,1440,1925,10850,36
26031,"Cheboygan County, Michigan",25579,12719,12860,24956,19223,2229,1041,153,87,25264,1627,1370,2997,4704,2055,2649,10056,64
26095,"Luce County, Michigan",6451,3784,2667,19442,4916,482,142,42,14,5444,324,212,536,1140,541,599,1968,35
26099,"Macomb County, Michigan",859703,418599,441104,29740,597899,92908,40270,6096,3013,853142,37977,29989,67966,102536,44358,58178,399727,1949
26155,"Shiawassee County, Michigan",68800,33922,34878,25218,47519,4950,2082,325,135,68370,3423,2680,6103,9649,4300,5349,29266,213
26013,"Baraga County, Michigan",8612,5262,3350,18975,6422,638,259,68,40,6418,206,279,485,947,409,538,2360,17
26029,"Charlevoix County, Michigan",26172,12905,13267,31730,19033,3196,1608,406,214,25913,1268,985,2253,3208,1420,1788,11615,39
26045,"Eaton County, Michigan",108544,52977,55567,30064,75109,12563,4881,938,566,107860,4205,3212,7417,11895,5237,6658,51356,250
26053,"Gogebic County, Michigan",15650,8425,7225,22297,11901,1395,527,102,64,14223,877,744,1621,2908,1360,1548,5716,41
26047,"Emmet County, Michigan",33091,16364,16727,31356,23718,4889,2072,586,252,32758,1727,1369,3096,3426,1555,1871,15613,150
27093,"Meeker County, Minnesota",23094,11734,11360,29216,15791,2156,603,160,65,22786,866,553,1419,2116,908,1208,11283,54
27113,"Pennington County, Minnesota",14156,7121,7035,28562,9690,1268,288,71,58,13958,422,206,628,1211,548,663,7481,76
27131,"Rice County, Minnesota",65116,33132,31984,28603,41110,6952,2857,708,678,62450,2146,1826,3972,6678,2675,4003,33398,190
27167,"Wilkin County, Minnesota",6479,3258,3221,28575,4632,779,164,28,17,6323,159,156,315,577,215,362,3273,9
27125,"Red Lake County, Minnesota",4042,2056,1986,26988,2790,319,79,15,6,4019,169,54,223,418,184,234,1974,7
27027,"Clay County, Minnesota",61402,30311,31091,28122,36983,8901,2494,260,553,60917,1975,1275,3250,6827,3109,3718,32954,157
27043,"Faribault County, Minnesota",14119,7060,7059,29116,10153,1292,287,112,30,13817,458,413,871,1728,727,1001,6963,42
27045,"Fillmore County, Minnesota",20877,10470,10407,28441,14422,2093,648,138,63,20538,1054,852,1906,2476,1102,1374,10381,107
27075,"Lake County, Minnesota",10721,5481,5240,32319,8135,1394,465,199,158,10549,285,232,517,1255,648,607,4717,32
27119,"Polk County, Minnesota",31550,15931,15619,28260,20979,3503,1125,225,155,30974,1059,874,1933,3950,1910,2040,15630,35
27135,"Roseau County, Minnesota",15609,7999,7610,27935,10486,1441,381,105,31,15415,336,230,566,1286,631,655,8249,76
27143,"Sibley County, Minnesota",14957,7555,7402,29884,10244,1301,253,115,45,14826,390,371,761,1442,636,806,7860,27
27165,"Watonwan County, Minnesota",10996,5414,5582,26884,7428,947,214,37,16,10861,858,748,1606,1272,435,837,5664,16
27005,"Becker County, Minnesota",33375,16693,16682,28525,22835,3778,1077,319,244,32989,1780,1245,3025,4209,1784,2425,15864,73
27011,"Big Stone County, Minnesota",5098,2494,2604,29035,3709,460,96,40,19,4965,146,134,280,562,219,343,2399,9
27015,"Brown County, Minnesota",25327,12563,12764,29696,17370,2665,589,242,133,24984,730,516,1246,1925,946,979,13352,36
27021,"Cass County, Minnesota",28633,14588,14045,28004,20695,3025,965,193,136,28396,1391,932,2323,4468,2057,2411,11947,155
27049,"Goodhue County, Minnesota",46450,23180,23270,33477,32472,5556,1710,373,267,45649,1483,1497,2980,4980,2363,2617,23345,185
27057,"Hubbard County, Minnesota",20640,10302,10338,28073,14961,2551,895,229,124,20542,938,636,1574,2363,1011,1352,9180,81
27063,"Jackson County, Minnesota",10163,5130,5033,31010,7147,1134,295,61,22,10038,294,113,407,895,442,453,5255,18
27091,"Martin County, Minnesota",20193,9989,10204,30806,14336,2055,409,128,56,19969,760,555,1315,2308,866,1442,9996,116
27105,"Nobles County, Minnesota",21729,11130,10599,24935,13963,1327,376,121,62,21443,1340,975,2315,3004,1303,1701,10337,67
27115,"Pine County, Minnesota",29067,15548,13519,24044,21058,2049,685,81,87,27442,1279,985,2264,3737,1832,1905,12412,74
47147,"Robertson County, Tennessee",67905,33429,34476,26441,45660,5565,2130,306,278,67076,4136,2800,6936,7067,3138,3929,31454,499
47051,"Franklin County, Tennessee",41348,20171,21177,25637,28149,3147,1480,338,388,40985,2056,2020,4076,6397,2846,3551,16818,154
47009,"Blount County, Tennessee",126192,61268,64924,28334,89312,13732,4464,1572,882,124988,6956,5719,12675,16793,7430,9363,56729,474
47021,"Cheatham County, Tennessee",39575,19558,20017,25673,27138,3596,1341,145,188,39248,2241,1915,4156,5061,2194,2867,18557,111
47019,"Carter County, Tennessee",56707,27824,28883,21001,41161,4427,1622,342,237,55665,4225,3435,7660,13110,5929,7181,22593,332
47057,"Grainger County, Tennessee",22813,11306,11507,20966,16317,1330,392,101,70,22667,1258,1153,2411,4578,2035,2543,8588,46
47055,"Giles County, Tennessee",29034,14140,14894,22994,20348,1897,739,113,103,28627,1908,1439,3347,4721,1952,2769,11678,145
47097,"Lauderdale County, Tennessee",27261,14248,13013,17178,18415,987,394,156,42,24378,1794,1500,3294,6014,2726,3288,8846,46
47099,"Lawrence County, Tennessee",42406,20841,21565,19879,28517,1947,962,373,48,41965,3404,3399,6803,8136,3430,4706,15957,174
47113,"Madison County, Tennessee",98128,46518,51610,24600,64505,10982,3455,952,1083,96919,5666,4642,10308,18345,7718,10627,42124,1140
47115,"Marion County, Tennessee",28363,13843,14520,23807,20200,1621,673,140,60,28042,1664,1564,3228,5374,2285,3089,11475,62
47133,"Overton County, Tennessee",22090,10963,11127,19961,15393,1381,529,154,67,21812,1430,1045,2475,4340,2088,2252,8679,32
47137,"Pickett County, Tennessee",5096,2531,2565,21300,3868,153,92,100,12,5002,363,283,646,827,337,490,1894,0
47181,"Wayne County, Tennessee",16842,9338,7504,18702,12371,785,303,127,102,14790,907,878,1785,2796,1345,1451,5968,228
47187,"Williamson County, Tennessee",205645,100438,105207,48482,133044,48304,19337,4407,3229,205114,5607,5005,10612,10547,4365,6182,100255,1199
47003,"Bedford County, Tennessee",46331,22685,23646,22953,30407,2970,961,245,158,45928,3715,2695,6410,7423,3218,4205,20493,108
47059,"Greene County, Tennessee",68502,33474,35028,21960,49012,4716,1922,344,216,67312,4553,3619,8172,12373,5681,6692,27086,423
47035,"Cumberland County, Tennessee",57895,28237,29658,23668,43646,5093,2287,479,330,57246,4123,3035,7158,9075,3762,5313,19945,110
47175,"Van Buren County, Tennessee",5641,2835,2806,20672,4111,250,157,51,25,5540,344,333,677,1058,531,527,2125,25
47025,"Claiborne County, Tennessee",31701,15470,16231,20184,22492,1683,931,148,204,31144,1630,1311,2941,6771,2895,3876,11249,71
47081,"Hickman County, Tennessee",24251,12719,11532,20936,16829,1299,466,95,58,22779,1789,1636,3425,5181,2575,2606,9398,246
47085,"Humphreys County, Tennessee",18216,8971,9245,23498,12762,928,581,78,56,18003,1048,759,1807,3308,1555,1753,6874,43
47141,"Putnam County, Tennessee",74652,36847,37805,23337,47571,7570,2631,623,775,73863,5308,3884,9192,17180,7807,9373,31185,144
47155,"Sevier County, Tennessee",94537,46406,48131,23298,66646,7320,3173,779,414,93634,8855,8268,17123,14285,6273,8012,44170,173
47161,"Stewart County, Tennessee",13257,6479,6778,22680,9370,743,342,89,48,13046,737,636,1373,2520,1097,1423,4814,70
47023,"Chester County, Tennessee",17355,8373,8982,20497,10958,997,460,103,170,17272,1144,1020,2164,2911,1448,1463,7245,52
47039,"Decatur County, Tennessee",11703,5698,6005,21098,8392,610,286,22,30,11476,641,649,1290,2399,1083,1316,4554,40
47087,"Jackson County, Tennessee",11526,5795,5731,18643,8429,392,198,24,61,11348,959,663,1622,2835,1216,1619,3762,15
47109,"McNairy County, Tennessee",26057,12734,13323,19745,18163,1375,423,89,102,25710,1783,1694,3477,5916,2663,3253,8926,104
47145,"Roane County, Tennessee",52983,26121,26862,25555,38763,4435,2089,348,407,52377,2752,2378,5130,8449,3975,4474,20493,87
47011,"Bradley County, Tennessee",102860,49964,52896,25144,69225,9286,3746,839,597,101860,7145,6192,13337,18291,7994,10297,43897,549
47063,"Hamblen County, Tennessee",63203,30662,32541,21962,43388,4397,1880,414,237,62448,5053,4085,9138,13112,6043,7069,24934,716
47173,"Union County, Tennessee",19081,9506,9575,20478,13326,870,369,59,28,18913,1223,1073,2296,4420,1866,2554,6714,25
47071,"Hardin County, Tennessee",25839,12638,13201,23328,18628,1436,747,159,15,25434,1870,1535,3405,5634,2353,3281,9673,120
47043,"Dickson County, Tennessee",50926,24989,25937,25211,34804,3231,1078,272,339,50393,3089,2803,5892,8019,3348,4671,21808,204
47129,"Morgan County, Tennessee",21688,12087,9601,18649,15533,725,359,30,44,18836,1259,1011,2270,4415,2156,2259,6726,150
47123,"Monroe County, Tennessee",45482,22698,22784,20353,31986,2572,912,292,111,44969,3093,2615,5708,8575,3881,4694,16225,190
47079,"Henry County, Tennessee",32291,15680,16611,22952,23226,1917,1069,176,251,31797,2018,1454,3472,6151,2579,3572,12645,228
47033,"Crockett County, Tennessee",14558,6912,7646,21056,9884,859,368,63,52,14350,1224,949,2173,2602,1256,1346,5716,30
47095,"Lake County, Tennessee",7643,4823,2820,14232,5685,329,168,20,2,4927,394,247,641,1413,588,825,1734,13
47093,"Knox County, Tennessee",448164,217833,230331,30541,297488,64540,26673,7863,7011,444681,24095,19978,44073,70612,31822,38790,214673,1234
47107,"McMinn County, Tennessee",52606,25618,26988,21583,36650,3260,1239,282,233,51757,3398,2628,6026,10012,4441,5571,20132,75
47117,"Marshall County, Tennessee",31335,15380,15955,23920,21409,2260,549,136,59,31008,1826,1764,3590,4655,1928,2727,13288,92
47143,"Rhea County, Tennessee",32461,15970,16491,22031,22010,1791,854,179,77,32091,1768,1606,3374,7160,3160,4000,13165,82
47151,"Scott County, Tennessee",22029,10865,11164,18748,14804,674,392,180,74,21704,1485,1313,2798,6000,2677,3323,7602,263
47001,"Anderson County, Tennessee",75545,36834,38711,26972,53614,7311,3544,813,1182,74667,4265,2681,6946,12747,5526,7221,31134,192
47049,"Fentress County, Tennessee",17936,8806,9130,18171,12652,1004,431,118,32,17714,1342,999,2341,4107,2029,2078,6250,43
47053,"Gibson County, Tennessee",49511,23596,25915,21858,33608,3689,1646,323,162,48388,2761,2334,5095,9039,4033,5006,20305,228
47069,"Hardeman County, Tennessee",25975,14094,11881,16938,18254,1187,611,120,56,22384,1449,1328,2777,5285,2317,2968,8092,16
47105,"Loudon County, Tennessee",50637,24646,25991,30177,37123,5784,2537,552,547,50256,2974,2857,5831,6767,3070,3697,19391,114
47149,"Rutherford County, Tennessee",290289,143078,147211,27932,179453,38281,11676,2400,1895,287993,17892,14163,32055,35764,16454,19310,145141,711
47159,"Smith County, Tennessee",19176,9524,9652,23015,13105,831,365,121,88,18945,967,872,1839,3050,1369,1681,8133,31
47189,"Wilson County, Tennessee",125616,61321,64295,31155,85573,17100,5580,1193,824,124597,5424,4556,9980,11266,4244,7022,60090,492
47171,"Unicoi County, Tennessee",17945,8919,9026,21374,13264,1039,405,126,98,17600,1202,844,2046,3687,1554,2133,6636,272
35027,"Lincoln County, New Mexico",19726,9736,9990,26820,14974,3034,944,139,162,19580,1119,998,2117,3515,1480,2035,7506,109
35005,"Chaves County, New Mexico",65610,32534,33076,21177,41113,5333,2071,312,214,64624,5225,4341,9566,14196,6223,7973,26217,266
35025,"Lea County, New Mexico",68930,35420,33510,24507,41228,3351,1646,172,220,67277,5978,5974,11952,10549,4346,6203,28587,228
35049,"Santa Fe County, New Mexico",147320,71604,75716,35801,107601,22509,14251,3930,3381,145574,11988,10892,22880,22507,10198,12309,68321,523
35059,"Union County, New Mexico",4292,2398,1894,23180,3065,303,170,9,6,3661,372,304,676,614,215,399,1531,16
56031,"Platte County, Wyoming",8740,4570,4170,31242,6325,925,313,5,3,8628,895,565,1460,1340,558,782,3996,13
56033,"Sheridan County, Wyoming",29924,14821,15103,31643,21042,3978,1588,520,253,29447,1598,1268,2866,2378,1029,1349,14241,65
56003,"Big Horn County, Wyoming",11931,6037,5894,23724,8044,1150,342,35,26,11700,948,819,1767,1385,632,753,5248,86
56011,"Crook County, Wyoming",7284,3761,3523,34186,5111,772,268,35,17,7230,431,378,809,441,234,207,3537,88
56029,"Park County, Wyoming",29083,14308,14775,32557,20371,3992,1895,266,366,28817,1707,1703,3410,2288,668,1620,14781,70
56001,"Albany County, Wyoming",37836,19767,18069,26034,20498,5626,2384,511,1290,37625,1849,1439,3288,9070,4634,4436,20509,53
56007,"Carbon County, Wyoming",15696,8501,7195,27797,10616,1498,498,101,60,14891,1001,858,1859,2133,958,1175,7443,57
56015,"Goshen County, Wyoming",13546,7167,6379,27253,9463,1333,600,122,118,13052,994,658,1652,2031,891,1140,5989,93
56041,"Uinta County, Wyoming",20893,10587,10306,27115,13039,1728,491,126,29,20705,1562,1685,3247,3462,1728,1734,9312,87
56043,"Washakie County, Wyoming",8351,4062,4289,27345,5836,869,266,75,20,8183,666,715,1381,1198,511,687,3640,33
56017,"Hot Springs County, Wyoming",4781,2388,2393,30939,3622,498,248,39,24,4691,239,314,553,524,193,331,2195,3
56013,"Fremont County, Wyoming",40683,20379,20304,27220,27023,4136,1303,337,264,40058,4058,3838,7896,5585,2622,2963,17577,164
56035,"Sublette County, Wyoming",10032,5322,4710,32175,6976,1284,387,28,0,10010,803,574,1377,775,459,316,5386,18
56045,"Weston County, Wyoming",7175,3734,3441,30955,5179,640,283,32,19,6819,499,473,972,1002,445,557,3231,17
13191,"McIntosh County, Georgia",13941,6865,7076,25226,10293,793,472,61,91,13827,1236,988,2224,2788,1223,1565,5252,0
13207,"Monroe County, Georgia",27044,13551,13493,30359,18968,2271,1364,342,231,25875,1655,1667,3322,3419,1468,1951,10712,90
13265,"Taliaferro County, Georgia",1904,970,934,17939,1437,82,31,6,7,1904,232,130,362,593,246,347,637,17
13029,"Bryan County, Georgia",34104,17013,17091,29880,21502,4605,2038,306,219,33255,2212,2188,4400,4509,1972,2537,15480,187
13039,"Camden County, Georgia",52092,26946,25146,26854,31946,4568,2112,295,251,48375,3528,2834,6362,7029,3110,3919,23783,300
13079,"Crawford County, Georgia",12483,6398,6085,22212,8944,636,379,111,47,12322,1000,747,1747,2343,1123,1220,4782,34
13069,"Coffee County, Georgia",43042,22025,21017,18945,27606,2196,919,337,160,39652,4487,4320,8807,9618,4017,5601,15625,289
13123,"Gilmer County, Georgia",28956,14535,14421,23688,20808,2329,931,330,122,28736,3587,2819,6406,5556,2776,2780,11573,331
13297,"Walton County, Georgia",87436,42594,44842,25184,57494,7341,2263,780,300,86665,5248,5870,11118,11365,4408,6957,37545,286
13091,"Dodge County, Georgia",20995,11107,9888,18563,14510,1096,702,77,89,19154,1729,1106,2835,4219,1989,2230,7737,452
13057,"Cherokee County, Georgia",230629,113565,117064,33466,152050,37080,12095,3032,1766,229621,16949,13660,30609,22891,10651,12240,111944,1629
13177,"Lee County, Georgia",29134,14605,14529,28061,18946,2603,1547,298,130,27959,1641,1504,3145,3334,1476,1858,13154,13
13227,"Pickens County, Georgia",29992,14904,15088,29460,21707,3425,1441,387,121,29760,2048,1731,3779,3058,1375,1683,12530,199
13075,"Cook County, Georgia",17103,8313,8790,17587,11114,959,396,125,58,16969,1834,1985,3819,4429,1957,2472,6969,33
13121,"Fulton County, Georgia",996757,483429,513328,41041,663465,198321,94178,25083,12864,987648,69532,65812,135344,163674,70953,92721,476794,4488
15001,"Hawaii County, Hawaii",193680,96563,97117,26959,135381,24704,8144,2524,1981,192492,7256,5468,12724,35737,17483,18254,81650,851
15007,"Kauai County, Hawaii",70447,35176,35271,30515,49582,9217,3114,857,591,69686,2894,1780,4674,6703,3216,3487,34031,217
16031,"Cassia County, Idaho",23441,11954,11487,20007,13705,1776,534,185,49,23090,2199,2037,4236,3563,1619,1944,9617,12
16063,"Lincoln County, Idaho",5292,2692,2600,19095,3205,255,106,8,10,5245,690,594,1284,630,302,328,2334,79
16041,"Franklin County, Idaho",13013,6632,6381,20454,7555,1057,304,69,49,12971,815,866,1681,1606,731,875,5350,50
16027,"Canyon County, Idaho",202782,100584,102198,19765,122815,15985,5173,556,828,201184,17285,15760,33045,37366,17379,19987,84136,917
16057,"Latah County, Idaho",38593,19614,18979,24166,21318,5896,2411,507,979,38422,1472,1678,3150,7929,3999,3930,18301,104
16009,"Benewah County, Idaho",9068,4621,4447,23120,6379,562,233,43,30,8982,917,643,1560,1510,710,800,3459,60
16033,"Clark County, Idaho",960,488,472,15283,545,60,23,0,0,960,204,117,321,260,162,98,411,0
16043,"Fremont County, Idaho",12896,6664,6232,21611,8169,1251,344,55,55,12323,828,936,1764,1475,658,817,5124,66
16049,"Idaho County, Idaho",16251,8435,7816,20741,11886,1480,353,94,81,15708,1014,1058,2072,2536,1292,1244,5991,22
16077,"Power County, Idaho",7696,3932,3764,21513,4582,436,125,112,29,7627,441,666,1107,937,397,540,3019,0
17119,"Madison County, Illinois",266759,130430,136329,30278,183772,30186,12865,2277,1836,264272,10409,7148,17557,34400,15291,19109,123390,704
17131,"Mercer County, Illinois",15971,7917,8054,27844,11325,1391,496,61,37,15711,341,281,622,1618,657,961,7432,36
17167,"Sangamon County, Illinois",198639,95430,103209,33277,136182,29382,12535,3414,1406,196527,6946,4793,11739,29600,13621,15979,94643,798
17157,"Randolph County, Illinois",32934,18105,14829,24716,23979,2241,590,197,88,29283,997,957,1954,3219,1350,1869,13234,47
17141,"Ogle County, Illinois",52034,25934,26100,29239,35891,4736,1947,308,129,51553,1862,1684,3546,5617,2387,3230,24513,145
17177,"Stephenson County, Illinois",46283,22383,23900,25792,32576,3752,1557,357,153,45533,1812,1340,3152,7203,3195,4008,21204,152
17193,"White County, Illinois",14410,7025,7385,26522,10266,929,392,50,38,14076,680,505,1185,1960,801,1159,5770,13
17071,"Henderson County, Illinois",6966,3417,3549,27949,5132,544,110,22,5,6901,264,240,504,731,289,442,3243,20
17113,"McLean County, Illinois",173254,84335,88919,32943,104229,30959,11172,2018,2264,172070,5192,4095,9287,23485,10444,13041,90470,514
17149,"Pike County, Illinois",16054,7999,8055,23218,11188,1286,360,29,42,15528,810,639,1449,2233,1047,1186,6963,78
17161,"Rock Island County, Illinois",146536,72130,74406,27822,100539,14642,5780,1025,713,144039,6443,5283,11726,21375,9195,12180,67155,1340
17185,"Wabash County, Illinois",11587,5649,5938,25105,8034,1009,321,25,25,11509,444,431,875,1376,593,783,5184,35
17035,"Cumberland County, Illinois",10890,5473,5417,24956,7576,815,239,35,30,10761,382,287,669,1747,796,951,4741,28
17089,"Kane County, Illinois",526615,261893,264722,33486,336969,69910,30759,4628,2884,523379,32872,25810,58682,57312,25715,31597,253070,1555
17009,"Brown County, Illinois",6836,4420,2416,21906,4979,543,134,31,4,5047,87,162,249,591,287,304,2617,11
17123,"Marshall County, Illinois",12060,6008,6052,29025,8659,1080,246,35,36,11795,378,246,624,1163,434,729,5516,18
17021,"Christian County, Illinois",33888,17274,16614,25614,23974,2533,823,143,116,32123,1318,819,2137,4356,1724,2632,14900,69
17077,"Jackson County, Illinois",59188,29683,29505,23455,35084,6172,4302,774,1349,58543,2847,1894,4741,15533,7665,7868,25296,196
17181,"Union County, Illinois",17458,8803,8655,24646,12524,1603,823,155,86,17308,817,655,1472,2667,1340,1327,7311,31
17165,"Saline County, Illinois",24659,12054,12605,22725,17189,1786,786,100,75,24132,1100,951,2051,5334,2348,2986,9427,41
17195,"Whiteside County, Illinois",57155,28128,29027,28188,39744,4431,1953,374,105,56269,2344,1696,4040,6388,2930,3458,26207,403
17037,"DeKalb County, Illinois",104458,51767,52691,26511,60786,11394,5697,567,1080,103643,4359,4282,8641,18001,7713,10288,50416,350
17079,"Jasper County, Illinois",9592,4776,4816,25806,6696,866,289,40,28,9532,362,277,639,775,298,477,4591,6
17197,"Will County, Illinois",685378,340422,344956,33731,440254,94754,41877,6168,4486,678484,27827,21318,49145,51976,22124,29852,331755,3153
17041,"Douglas County, Illinois",19770,9743,10027,26284,13135,1927,469,62,52,19607,1485,1449,2934,2223,943,1280,9163,111
17061,"Greene County, Illinois",13390,6774,6616,22836,9435,787,190,51,25,13112,561,535,1096,2250,967,1283,5700,87
17069,"Hardin County, Illinois",4173,2126,2047,20025,3118,238,81,34,0,4117,294,121,415,774,326,448,1428,23
17095,"Knox County, Illinois",51752,26180,25572,23676,36060,4148,1777,358,233,49182,2509,1788,4297,8418,3906,4512,21138,163
17127,"Massac County, Illinois",14883,7055,7828,23434,10547,1045,299,45,17,14658,594,536,1130,2750,1081,1669,5599,80
17179,"Tazewell County, Illinois",135400,66832,68568,32082,94070,16650,5466,935,477,132943,3918,3320,7238,10485,4532,5953,64123,213
18061,"Harrison County, Indiana",39370,19678,19692,25993,27457,2930,1532,144,35,39133,1864,1506,3370,5139,2275,2864,17885,93
18169,"Wabash County, Indiana",32177,15775,16402,24700,21971,2433,1274,144,169,31199,1635,1462,3097,3839,1585,2254,14604,45
18075,"Jay County, Indiana",21196,10402,10794,20193,13930,965,452,38,62,20985,1378,1157,2535,3317,1528,1789,9406,176
38001,"Adams County, North Dakota",2348,1187,1161,35933,1682,319,79,30,35,2297,77,80,157,241,89,152,1233,14
38027,"Eddy County, North Dakota",2370,1144,1226,35444,1693,278,69,22,6,2300,116,67,183,306,151,155,1189,36
38057,"Mercer County, North Dakota",8671,4477,4194,36720,6137,940,241,52,35,8552,510,533,1043,634,136,498,4284,75
38073,"Ransom County, North Dakota",5457,2780,2677,33574,3852,549,63,25,26,5305,143,113,256,487,197,290,2823,0
38085,"Sioux County, North Dakota",4431,2223,2208,15944,2306,304,48,11,20,4387,732,521,1253,1646,774,872,1289,18
38033,"Golden Valley County, North Dakota",1895,931,964,28840,1237,213,58,3,2,1843,182,136,318,175,72,103,1003,14
38095,"Towner County, North Dakota",2292,1142,1150,36099,1630,240,60,3,0,2258,113,105,218,317,139,178,920,7
38023,"Divide County, North Dakota",2369,1190,1179,39171,1781,388,17,0,6,2294,73,72,145,215,100,115,1239,2
38081,"Sargent County, North Dakota",3889,2053,1836,36207,2780,448,72,3,4,3851,113,75,188,221,80,141,2080,5
35051,"Sierra County, New Mexico",11442,5663,5779,22749,8948,1027,448,60,46,11200,646,549,1195,2471,1387,1084,3885,0
35053,"Socorro County, New Mexico",17324,8856,8468,17017,10697,1300,538,88,168,17225,1431,1179,2610,3796,1639,2157,5667,161
35041,"Roosevelt County, New Mexico",19618,9843,9775,18954,11118,1394,845,52,229,19056,1514,1244,2758,4755,2198,2557,7779,161
35013,"Doña Ana County, New Mexico",213825,105129,108696,21050,127632,20459,10726,1830,2122,210440,16794,15887,32681,57626,27063,30563,89484,409
35028,"Los Alamos County, New Mexico",17895,9187,8708,52125,12720,3103,2430,197,2486,17792,490,449,939,904,394,510,8971,118
35039,"Rio Arriba County, New Mexico",39924,19608,20316,19602,26836,3178,1239,332,111,39667,3807,3129,6936,9275,4541,4734,14424,223
35047,"San Miguel County, New Mexico",28350,14268,14082,18012,19311,1984,1231,211,304,27772,2284,2007,4291,8093,3646,4447,9247,38
35061,"Valencia County, New Mexico",75993,38178,37815,20572,50347,5660,2462,227,272,74387,5203,3891,9094,17177,8046,9131,27702,445
35057,"Torrance County, New Mexico",15599,8098,7501,19129,10890,1211,548,102,66,14925,1074,738,1812,4604,2175,2429,5419,18
35001,"Bernalillo County, New Mexico",674777,330751,344026,28340,455336,82208,46150,10118,10799,667383,44784,39054,83838,124678,56821,67857,309193,2807
35035,"Otero County, New Mexico",65333,33491,31842,21876,42385,4084,2800,334,253,60281,4411,4017,8428,15439,7353,8086,24795,99
35006,"Cibola County, New Mexico",27373,13884,13489,17768,18094,1583,558,63,48,25721,2745,2151,4896,7005,3345,3660,9370,403
35011,"De Baca County, New Mexico",1977,915,1062,24571,1488,83,59,0,0,1949,168,92,260,389,170,219,641,27
35019,"Guadalupe County, New Mexico",4469,2602,1867,18086,3284,271,165,19,0,3828,166,115,281,542,249,293,1245,2
35003,"Catron County, New Mexico",3547,1860,1687,22487,2920,458,245,0,20,3538,333,263,596,809,283,526,1024,27
36005,"Bronx County, New York",1436785,676440,760345,19721,905151,113265,44840,9131,5933,1414859,101564,72479,174043,427715,182123,245592,560324,3258
36067,"Onondaga County, New York",468050,226022,242028,31436,315056,60720,34310,7776,5322,462864,15633,11165,26798,68285,30645,37640,219060,1491
36019,"Clinton County, New York",81505,41893,39612,25833,55217,6420,4501,778,582,76963,2645,1634,4279,11865,5166,6699,34648,672
36099,"Seneca County, New York",35036,18470,16566,26541,24924,2842,1687,231,222,32261,1761,1361,3122,3952,1672,2280,15113,154
36079,"Putnam County, New York",99408,49388,50020,44063,69769,15744,8964,1369,1086,98778,3571,2868,6439,5061,2603,2458,49848,154
36043,"Herkimer County, New York",63558,31375,32183,24932,44238,5583,3292,427,222,62918,3045,1795,4840,8738,3993,4745,28266,129
36069,"Ontario County, New York",109450,53705,55745,33685,76016,13224,8656,1225,1280,108522,3712,2593,6305,10898,4720,6178,52951,278
36101,"Steuben County, New York",98151,48750,49401,27731,68291,7941,5820,841,660,96973,4496,3288,7784,14558,6474,8084,42245,406
36041,"Hamilton County, New York",4697,2382,2315,24891,3575,387,330,34,22,4669,325,122,447,526,280,246,1830,126
36013,"Chautauqua County, New York",131748,65093,66655,23962,90235,10220,6920,1009,657,129115,5199,3896,9095,24410,11132,13278,55259,200
36047,"Kings County, New York",2606852,1234959,1371893,29928,1753695,362659,175664,41278,18084,2596190,157069,121476,278545,587518,260957,326561,1165434,5485
36107,"Tioga County, New York",49649,24549,25100,30252,34981,5464,2717,350,227,49274,1813,1242,3055,5405,2239,3166,22446,174
36073,"Orleans County, New York",41938,20887,21051,23929,29695,2891,1529,193,99,39187,1622,1377,2999,6089,2705,3384,17496,229
36091,"Saratoga County, New York",224929,111025,113904,39653,158211,36963,19676,3071,3020,221645,5582,4113,9695,14193,6148,8045,114143,502
36021,"Columbia County, New York",61860,31058,30802,34737,45731,6901,5078,1050,471,60143,2056,1597,3653,7605,3587,4018,29416,127
36049,"Lewis County, New York",27107,13671,13436,25779,18490,1562,1066,157,83,26714,1352,1049,2401,3750,1684,2066,11593,112
36119,"Westchester County, New York",969229,468336,500893,52049,661283,157929,104595,35635,14652,956762,48863,36206,85069,92600,41150,51450,459790,3442
36025,"Delaware County, New York",46480,23356,23124,26016,32976,4045,2504,242,234,45975,1817,1865,3682,6987,3218,3769,19380,175
36057,"Montgomery County, New York",49667,24468,25199,25307,34243,3323,1697,314,133,48884,2601,1684,4285,10014,4361,5653,21140,184
36085,"Richmond County, New York",473324,229095,244229,33922,324340,60675,31186,7010,2841,469465,17984,13103,31087,60530,26762,33768,206773,1279
36089,"St. Lawrence County, New York",111529,56822,54707,23554,72141,8189,6108,1019,1112,107906,5483,3829,9312,19107,9279,9828,43218,358
36109,"Tompkins County, New York",104268,51285,52983,29759,59666,13254,10156,2150,5229,103385,3323,2126,5449,18133,8161,9972,48415,135
36113,"Warren County, New York",64911,31835,33076,33127,47419,7369,4789,850,467,64348,2731,1653,4384,7079,3100,3979,31466,155
36023,"Cortland County, New York",48713,23778,24935,26271,30566,4320,2526,309,420,48238,1818,1009,2827,6209,2350,3859,23749,77
36027,"Dutchess County, New York",295905,147197,148708,36704,202687,37842,23663,3866,3483,288137,11278,7854,19132,25562,11910,13652,140507,606
36055,"Monroe County, New York",749236,361925,387311,31291,507237,103720,60943,11757,9557,742076,22947,15638,38585,107724,47629,60095,355665,1896
36065,"Oneida County, New York",232858,116027,116831,27283,159946,22943,11423,2273,1408,225239,7493,5100,12593,36789,17108,19681,100764,415
36111,"Ulster County, New York",180505,89631,90874,32453,129015,21827,13977,2217,1936,176129,8453,6269,14722,22480,10269,12211,83526,468
36015,"Chemung County, New York",87742,43482,44260,27209,60379,8040,5460,801,458,84179,2838,2504,5342,13179,5690,7489,37386,111
36051,"Livingston County, New York",64622,32439,32183,25882,42621,5666,3614,630,522,62084,1799,1407,3206,8720,4026,4694,29090,270
36077,"Otsego County, New York",60979,29517,31462,26688,39869,6067,3618,940,739,60310,2554,1814,4368,9106,4143,4963,27541,147
36039,"Greene County, New York",48069,24956,23113,27402,35014,4147,2323,437,192,45128,1664,1345,3009,5826,2463,3363,19234,221
36001,"Albany County, New York",307891,148964,158927,35278,204003,42048,27676,6298,5025,304048,10087,6236,16323,37749,16940,20809,153524,1261
36003,"Allegany County, New York",47700,24124,23576,22377,30449,3085,2412,302,437,47207,2299,1856,4155,7284,3334,3950,19888,199
36009,"Cattaraugus County, New York",78506,38795,39711,23984,53233,5525,3462,395,268,77748,3830,3238,7068,13265,6161,7104,33359,256
36053,"Madison County, New York",72089,35429,36660,28010,47606,7135,4151,734,696,71502,2348,1474,3822,7932,3703,4229,32625,205
36093,"Schenectady County, New York",154845,75383,79462,29981,106136,17769,11219,1747,1723,153116,5108,3892,9000,18055,7943,10112,72215,517
36037,"Genesee County, New York",59053,29325,29728,27499,41449,5199,2961,374,266,58542,2113,1499,3612,7245,3258,3987,29209,201
36123,"Yates County, New York",25106,12110,12996,26608,16434,2155,1359,131,161,24747,2605,2627,5232,3319,1549,1770,10980,116
37079,"Greene County, North Carolina",21241,11452,9789,18662,14865,1010,220,35,107,19109,1744,1362,3106,4646,1968,2678,7983,53
37121,"Mitchell County, North Carolina",15263,7465,7798,22302,11286,1268,482,181,40,15134,1104,958,2062,2688,1148,1540,5924,45
37041,"Chowan County, North Carolina",14556,6925,7631,23542,10580,1250,708,114,57,14290,1176,913,2089,3491,1538,1953,5399,69
37005,"Alleghany County, North Carolina",10868,5391,5477,21153,8022,961,405,89,38,10738,926,772,1698,2089,874,1215,4334,22
72009,"Aibonito Municipio, Puerto Rico",24438,11787,12651,10224,16805,2546,809,52,81,24411,329,243,572,11433,5407,6026,5875,37
72059,"Guayanilla Municipio, Puerto Rico",20025,9619,10406,8347,13504,2285,289,63,101,19975,517,378,895,11725,5715,6010,4360,44
72079,"Lajas Municipio, Puerto Rico",24323,11859,12464,7229,17020,1907,489,102,152,24284,754,501,1255,14552,7062,7490,4923,8
72121,"Sabana Grande Municipio, Puerto Rico",24013,11376,12637,9158,16405,2701,363,46,95,23903,815,316,1131,11762,5474,6288,5409,13
72027,"Camuy Municipio, Puerto Rico",33481,16098,17383,9738,22880,3730,888,94,141,33457,941,933,1874,16173,7560,8613,8647,44
72055,"Guánica Municipio, Puerto Rico",17788,8577,9211,7207,12141,1350,360,43,53,17778,533,498,1031,11199,5313,5886,3405,6
72091,"Manatí Municipio, Puerto Rico",41468,19651,21817,10559,28091,5008,832,150,232,41331,1977,1486,3463,19121,8620,10501,10951,38
72103,"Naguabo Municipio, Puerto Rico",26722,12636,14086,10016,17547,2805,557,32,35,26690,619,510,1129,13311,5968,7343,7174,0
72125,"San Germán Municipio, Puerto Rico",33546,16312,17234,9563,23014,3782,1039,143,284,33454,786,731,1517,16865,8114,8751,8676,57
72141,"Utuado Municipio, Puerto Rico",30869,15045,15824,8140,21033,3121,423,101,102,30849,994,856,1850,16103,7761,8342,6386,18
72015,"Arroyo Municipio, Puerto Rico",18778,8758,10020,7639,12431,1760,292,36,0,18767,428,314,742,9958,4482,5476,3793,0
72033,"Cataño Municipio, Puerto Rico",26137,12382,13755,11627,17426,2614,629,324,161,26137,1166,700,1866,12829,5681,7148,7592,159
72115,"Quebradillas Municipio, Puerto Rico",24904,12078,12826,9287,16939,2240,327,39,144,24898,619,396,1015,13897,6592,7305,6273,24
72057,"Guayama Municipio, Puerto Rico",43210,21461,21749,9183,28742,4489,905,89,120,41185,1412,775,2187,22189,9748,12441,9277,125
72049,"Culebra Municipio, Puerto Rico",1508,832,676,11450,1044,92,16,8,14,1508,101,62,163,679,319,360,649,8
72063,"Gurabo Municipio, Puerto Rico",46990,22315,24675,16559,31488,7360,2298,444,735,46817,1613,1312,2925,15141,6697,8444,16838,221
72017,"Barceloneta Municipio, Puerto Rico",24699,11785,12914,8762,16595,2237,512,0,46,24670,775,444,1219,13083,6273,6810,5274,166
72087,"Loíza Municipio, Puerto Rico",27857,13031,14826,8729,18216,1890,385,37,47,27831,1636,1105,2741,13785,6165,7620,7733,14
72061,"Guaynabo Municipio, Puerto Rico",92444,43750,48694,24264,66395,17882,6757,3974,1361,92166,4225,2147,6372,25064,11226,13838,36937,427
72005,"Aguadilla Municipio, Puerto Rico",56893,27711,29182,10872,39257,6835,1939,349,263,55268,1837,1190,3027,27469,12448,15021,13913,138
72053,"Fajardo Municipio, Puerto Rico",33912,15898,18014,10900,22799,3941,854,120,117,33694,1389,985,2374,14866,6432,8434,10093,721
72109,"Patillas Municipio, Puerto Rico",18135,8909,9226,8679,12505,1436,416,16,88,18135,552,225,777,10279,4977,5302,3713,76
72117,"Rincón Municipio, Puerto Rico",14700,7108,7592,10220,10606,1555,368,0,168,14664,318,218,536,7068,3270,3798,4293,0
72007,"Aguas Buenas Municipio, Puerto Rico",27323,13315,14008,10615,18542,2247,429,92,14,27230,1023,375,1398,13814,6646,7168,6587,38
72021,"Bayamón Municipio, Puerto Rico",192974,91526,101448,14138,134525,27952,7127,1658,1000,187415,7862,5112,12974,66051,28284,37767,66117,1909
72031,"Carolina Municipio, Puerto Rico",165040,75944,89096,16188,114314,24532,7109,1584,1236,164386,8739,4890,13629,49105,20663,28442,60324,385
72035,"Cayey Municipio, Puerto Rico",46071,22174,23897,12594,31689,5267,1859,277,242,46032,1958,1172,3130,19824,9136,10688,13734,965
72065,"Hatillo Municipio, Puerto Rico",41327,19913,21414,10360,28567,5112,1590,99,178,41292,1118,749,1867,18400,8372,10028,12269,0
72069,"Humacao Municipio, Puerto Rico",55621,26358,29263,11682,38376,6426,1787,255,486,55162,1365,933,2298,24941,11317,13624,15511,32
72075,"Juana Díaz Municipio, Puerto Rico",48658,23302,25356,10244,31723,5338,896,505,256,48313,1125,864,1989,23218,10511,12707,14479,56
72101,"Morovis Municipio, Puerto Rico",32087,15954,16133,8816,20840,2832,607,23,131,32069,1245,901,2146,16601,7700,8901,8111,79
72097,"Mayagüez Municipio, Puerto Rico",81594,39059,42535,10656,53370,8186,2210,430,1140,81021,3107,1739,4846,41350,19357,21993,20319,92
72133,"Santa Isabel Municipio, Puerto Rico",22732,10991,11741,10478,14604,2295,824,107,110,22732,851,937,1788,11449,5365,6084,6946,0
72139,"Trujillo Alto Municipio, Puerto Rico",70737,33423,37314,15703,47992,11863,3248,907,840,70437,3203,2081,5284,21023,9384,11639,26313,370
72047,"Corozal Municipio, Puerto Rico",35484,17261,18223,7887,23494,2926,736,42,86,35251,879,312,1191,19774,9252,10522,7516,30
72095,"Maunabo Municipio, Puerto Rico",11506,5678,5828,8830,7933,1033,219,0,16,11501,353,166,519,6431,2975,3456,2280,78
72111,"Peñuelas Municipio, Puerto Rico",22231,10825,11406,7983,14308,2266,307,76,63,22192,414,270,684,12748,6147,6601,5307,178
72113,"Ponce Municipio, Puerto Rico",152594,73452,79142,10775,102435,19429,4100,1377,1647,149853,4664,3066,7730,76635,34702,41933,39966,405
72131,"San Sebastián Municipio, Puerto Rico",39755,19358,20397,8072,27647,3919,693,150,48,39651,1744,1011,2755,22387,10714,11673,8058,34
18127,"Porter County, Indiana",167016,82416,84600,31879,113063,18661,7724,1760,1394,165535,7321,7109,14430,17560,7403,10157,77010,489
18147,"Spencer County, Indiana",20777,10530,10247,29114,14473,1435,619,91,73,20559,909,810,1719,2013,821,1192,9698,99
18157,"Tippecanoe County, Indiana",183397,93774,89623,25481,100694,19941,10031,1590,3960,181721,10734,8930,19664,36513,18142,18371,86140,658
18057,"Hamilton County, Indiana",303042,148054,154988,44443,195132,69838,26730,8368,4886,301604,9596,8589,18185,15381,6332,9049,157155,811
18087,"LaGrange County, Indiana",38395,19459,18936,22780,21954,1649,726,46,37,38218,7717,7678,15395,4728,2206,2522,15864,423
18011,"Boone County, Indiana",61884,30594,31290,42844,40735,10613,4608,1828,1084,61268,2444,2032,4476,3719,1779,1940,30909,232
18107,"Montgomery County, Indiana",38108,19274,18834,25519,25564,2895,989,250,148,37584,2456,1948,4404,4635,1971,2664,17584,44
18019,"Clark County, Indiana",113993,55492,58501,26875,78451,11116,3558,670,502,112420,7312,5967,13279,11153,5181,5972,54322,351
18021,"Clay County, Indiana",26568,12983,13585,24339,18248,2007,814,201,67,26194,1383,1244,2627,4358,1907,2451,11862,48
18047,"Franklin County, Indiana",22887,11456,11431,26267,15517,1931,785,76,179,22801,1010,894,1904,2591,1151,1440,10766,107
18071,"Jackson County, Indiana",43637,21674,21963,23260,29563,3157,1331,215,77,42995,2459,2291,4750,6317,2447,3870,20027,436
18129,"Posey County, Indiana",25527,12774,12753,30763,17683,2438,902,200,96,25289,725,667,1392,2451,1184,1267,12134,50
18165,"Vermillion County, Indiana",15752,7742,8010,23891,11030,1043,318,41,30,15538,786,831,1617,2077,916,1161,6376,34
18003,"Allen County, Indiana",365565,178324,187241,26932,235198,42160,16367,4152,1694,361922,22629,21666,44295,54545,24399,30146,170281,923
18043,"Floyd County, Indiana",76290,36917,39373,30663,51839,8938,3930,670,421,75281,3616,3175,6791,9050,3987,5063,36992,147
18081,"Johnson County, Indiana",147567,72527,75040,31101,97494,19304,7434,1170,854,145471,6906,6574,13480,13473,6197,7276,72131,411
18051,"Gibson County, Indiana",33684,16846,16838,27342,22845,2429,969,70,103,33102,1816,1509,3325,3610,1549,2061,15807,119
18117,"Orange County, Indiana",19579,9696,9883,22715,13354,946,523,92,29,19329,1116,1003,2119,3154,1342,1812,8371,131
18099,"Marshall County, Indiana",46833,23262,23571,24289,30894,3677,1549,396,103,46339,3351,3636,6987,5351,2194,3157,20641,172
18009,"Blackford County, Indiana",12364,6135,6229,22328,8700,546,315,51,42,12199,809,824,1633,1447,569,878,5180,44
18143,"Scott County, Indiana",23734,11672,12062,24186,16315,1346,596,106,71,23357,1226,935,2161,3267,1547,1720,10360,120
18039,"Elkhart County, Indiana",201640,99741,101899,23817,127176,15497,6018,1241,478,199208,18439,18225,36664,29381,12529,16852,91204,520
18017,"Cass County, Indiana",38324,19227,19097,23592,25871,2335,987,152,135,37636,2550,2101,4651,5640,2608,3032,17165,222
18177,"Wayne County, Indiana",67423,32580,34843,23895,46204,4611,2511,387,408,66244,5036,4857,9893,12903,5509,7394,28237,343
19023,"Butler County, Iowa",14933,7469,7464,28584,10504,1159,399,55,33,14675,349,378,727,1289,552,737,7352,13
19079,"Hamilton County, Iowa",15227,7535,7692,27963,10647,1678,422,166,78,15024,553,437,990,1612,659,953,7447,33
19175,"Union County, Iowa",12539,6042,6497,25098,8538,1044,280,71,5,12401,445,572,1017,1585,568,1017,6275,21
19195,"Worth County, Iowa",7562,3751,3811,26781,5316,611,175,11,15,7460,270,172,442,775,361,414,3702,9
19001,"Adair County, Iowa",7330,3612,3718,28861,5275,691,124,40,19,7193,262,190,452,687,255,432,3659,19
19037,"Chickasaw County, Iowa",12164,6124,6040,27973,8356,884,268,41,17,12034,371,321,692,1073,513,560,6053,19
19059,"Dickinson County, Iowa",17046,8536,8510,36588,12648,2487,742,353,89,16845,441,365,806,1153,419,734,8822,115
19107,"Keokuk County, Iowa",10234,5166,5068,26638,7152,888,253,74,2,10114,343,208,551,1296,585,711,4791,42
19171,"Tama County, Iowa",17423,8610,8813,27074,11868,1397,399,86,54,17048,683,613,1296,2195,1039,1156,8128,125
19069,"Franklin County, Iowa",10393,5266,5127,25248,7244,897,209,83,24,10246,320,287,607,1509,719,790,4838,28
19031,"Cedar County, Iowa",18389,9038,9351,30362,12886,2119,495,108,119,18164,350,303,653,1162,450,712,9741,79
19067,"Floyd County, Iowa",16004,7866,8138,28323,11107,1649,356,91,87,15795,534,587,1121,2219,843,1376,7806,44
19115,"Louisa County, Iowa",11251,5752,5499,27234,7659,790,174,40,16,11119,277,352,629,1392,645,747,5399,78
19091,"Humboldt County, Iowa",9607,4672,4935,29587,6697,1039,235,36,20,9495,204,173,377,1286,502,784,4570,46
19183,"Washington County, Iowa",22115,10972,11143,28397,14978,2169,632,199,130,21796,957,921,1878,1947,801,1146,11011,182
19035,"Cherokee County, Iowa",11752,5865,5887,30973,8412,1247,232,87,46,11397,536,398,934,1321,594,727,5965,39
19057,"Des Moines County, Iowa",40114,19749,20365,27168,27782,3865,1128,274,169,39635,1624,1077,2701,6574,2610,3964,18793,194
19109,"Kossuth County, Iowa",15226,7610,7616,29949,10730,1681,298,96,20,14975,394,279,673,1454,619,835,7595,59
19139,"Muscatine County, Iowa",42949,21329,21620,28028,28370,4069,1328,288,127,42465,1465,1348,2813,4802,2188,2614,20995,110
19153,"Polk County, Iowa",459159,225935,233224,33524,302061,74656,22645,6891,3247,454372,16131,12526,28657,55972,24580,31392,240248,1158
19193,"Woodbury County, Iowa",102426,50605,51821,25699,65067,9676,3059,985,387,101475,5187,4076,9263,14084,6280,7804,51199,800
19097,"Jackson County, Iowa",19529,9711,9818,27672,13778,1566,552,112,39,19339,651,664,1315,2653,1139,1514,9274,83
19111,"Lee County, Iowa",35172,17813,17359,24408,24733,2693,641,226,46,34365,1316,1006,2322,5615,2526,3089,16084,256
19181,"Warren County, Iowa",48170,23532,24638,33013,31423,6565,1676,553,271,47582,1046,851,1897,3402,1418,1984,24730,34
19149,"Plymouth County, Iowa",24972,12302,12670,30686,16859,2604,528,111,49,24684,709,664,1373,2111,939,1172,12677,102
19041,"Clay County, Iowa",16478,8093,8385,28514,11488,1877,370,102,48,16224,480,444,924,1907,798,1109,8351,74
19055,"Delaware County, Iowa",17445,8710,8735,30768,11915,1178,451,85,80,17279,358,319,677,1645,783,862,9173,16
19185,"Wayne County, Iowa",6403,3109,3294,23367,4382,396,134,38,4,6300,349,455,804,924,406,518,2726,47
19163,"Scott County, Iowa",171116,84119,86997,30798,115182,23147,10309,2175,1130,169362,6186,4634,10820,20413,9073,11340,82187,392
20181,"Sherman County, Kansas",6038,3048,2990,25653,4132,573,173,26,14,5966,247,165,412,1010,566,444,2826,40
20193,"Thomas County, Kansas",7909,3901,4008,26718,5046,953,370,92,17,7792,248,294,542,756,371,385,4323,41
20127,"Morris County, Kansas",5694,2835,2859,26569,4145,438,213,46,0,5611,256,267,523,492,209,283,2751,19
20163,"Rooks County, Kansas",5160,2500,2660,25415,3627,563,254,39,24,4976,241,216,457,673,318,355,2526,15
20025,"Clark County, Kansas",2131,1078,1053,27087,1485,335,70,11,11,2069,109,116,225,281,121,160,982,9
20077,"Harper County, Kansas",5798,2939,2859,25698,4049,559,195,24,19,5650,393,302,695,771,372,399,2644,23
20111,"Lyon County, Kansas",33401,16250,17151,24307,19999,3445,1386,248,255,33003,2370,2155,4525,6671,3084,3587,16597,74
20145,"Pawnee County, Kansas",6840,3895,2945,24404,5052,677,360,78,15,5758,201,253,454,423,120,303,2920,9
46107,"Potter County, South Dakota",2306,1103,1203,32853,1752,268,62,14,6,2227,78,83,161,235,118,117,1134,0
39021,"Champaign County, Ohio",39175,19599,19576,25528,26605,2931,1283,102,75,38687,1604,1073,2677,4279,1969,2310,17673,55
39057,"Greene County, Ohio",164325,80712,83613,33138,109074,21775,14430,2079,2780,160467,6023,4282,10305,19929,8553,11376,77282,287
39087,"Lawrence County, Ohio",61503,30191,31312,22844,42820,3806,1707,380,163,60918,3306,2317,5623,11183,5128,6055,24142,274
39115,"Morgan County, Ohio",14857,7392,7465,22122,10417,877,336,34,21,14677,899,732,1631,2936,1312,1624,5341,57
39175,"Wyandot County, Ohio",22359,11090,11269,25431,15415,1582,553,89,31,22096,978,664,1642,2440,1025,1415,10667,109
39043,"Erie County, Ohio",75808,37092,38716,30223,53707,7236,3149,865,347,74861,3601,2516,6117,9584,4334,5250,34822,72
39091,"Logan County, Ohio",45388,22470,22918,26525,31017,3143,1339,211,132,45073,2742,2017,4759,6258,2585,3673,20586,105
39153,"Summit County, Ohio",541372,262454,278918,30803,375132,73796,29612,7179,4630,536315,23593,18888,42481,75894,33204,42690,255806,882
39149,"Shelby County, Ohio",48949,24679,24270,28410,32301,3277,1884,193,166,48603,1632,1156,2788,4600,1927,2673,23702,142
39171,"Williams County, Ohio",37270,18437,18833,24160,25769,2418,966,171,104,36106,1471,929,2400,5176,2179,2997,16852,197
39029,"Columbiana County, Ohio",105230,52906,52324,24758,75173,7046,2757,420,253,101691,5550,4415,9965,15946,6929,9017,45624,342
39051,"Fulton County, Ohio",42466,21055,21411,27922,28535,3126,1300,334,97,42077,1362,835,2197,4688,2218,2470,20063,94
39053,"Gallia County, Ohio",30376,14839,15537,22293,20590,1862,1090,113,116,29998,2114,1508,3622,6334,2599,3735,11360,96
39099,"Mahoning County, Ohio",233015,113472,119543,25901,164692,24386,9637,2265,1245,227859,9904,7845,17749,40823,17826,22997,100590,1082
39145,"Scioto County, Ohio",77366,38260,39106,22586,53122,4815,2471,392,287,74512,4048,3345,7393,17569,8059,9510,27661,142
39117,"Morrow County, Ohio",35032,17580,17452,24864,23736,2237,821,134,14,34768,1701,1386,3087,3816,1963,1853,16351,155
39135,"Preble County, Ohio",41561,20594,20967,25374,28699,2695,937,152,86,41226,1756,1876,3632,5536,2475,3061,19102,172
39003,"Allen County, Ohio",104664,52851,51813,24551,69294,7063,3567,926,492,102085,5561,3698,9259,16228,7679,8549,47134,246
39033,"Crawford County, Ohio",42485,20785,21700,24386,29720,2478,1055,198,35,41907,1882,1588,3470,6566,2836,3730,17953,122
39059,"Guernsey County, Ohio",39478,19497,19981,22864,27290,2373,1054,195,103,38985,2160,1617,3777,7722,3463,4259,16146,168
39107,"Mercer County, Ohio",40886,20558,20328,27540,27115,2957,1477,75,55,40499,1295,968,2263,3347,1352,1995,20286,96
39023,"Clark County, Ohio",136175,65897,70278,25270,92888,10432,4858,809,590,134417,6287,5193,11480,23792,10593,13199,58685,368
39093,"Lorain County, Ohio",304091,149762,154329,28555,207879,30342,14272,2542,1672,297506,11555,8880,20435,41156,16700,24456,136657,2226
39113,"Montgomery County, Ohio",532761,256454,276307,27602,362549,56864,29054,5258,3606,524589,27401,20542,47943,95684,42761,52923,235180,1568
39165,"Warren County, Ohio",222184,111615,110569,37479,147940,38132,17098,3221,2140,215732,5744,5323,11067,11581,4990,6591,105093,227
39007,"Ashtabula County, Ohio",99175,49847,49328,21936,68800,5866,2541,329,290,96088,5853,4720,10573,18735,8383,10352,39685,242
40071,"Kay County, Oklahoma",45398,22517,22881,24057,29914,4196,1191,260,178,44735,3827,3298,7125,7919,3436,4483,19218,218
40035,"Craig County, Oklahoma",14683,7494,7189,20666,10264,1027,317,77,50,13934,1250,1219,2469,2458,1084,1374,5664,119
40017,"Canadian County, Oklahoma",129571,64268,65303,29852,85210,16196,4486,756,529,127742,6870,6010,12880,10237,4674,5563,63929,693
40077,"Latimer County, Oklahoma",10643,5393,5250,24233,7103,700,334,26,67,10449,1117,1026,2143,1957,796,1161,3827,36
40139,"Texas County, Oklahoma",21499,11359,10140,23324,13083,2031,339,164,97,21373,1910,1576,3486,2814,1145,1669,11128,106
40127,"Pushmataha County, Oklahoma",11149,5462,5687,22596,7896,716,354,46,23,11019,1159,1045,2204,2414,1081,1333,4065,18
40069,"Johnston County, Oklahoma",11027,5422,5605,21022,7468,707,402,39,33,10905,1046,1226,2272,2272,899,1373,3828,20
40007,"Beaver County, Oklahoma",5479,2707,2772,25935,3636,613,126,17,27,5398,321,440,761,547,242,305,2550,26
40063,"Hughes County, Oklahoma",13727,7368,6359,18004,9639,712,260,28,48,12038,1215,1248,2463,2373,1094,1279,4193,38
40031,"Comanche County, Oklahoma",124583,64689,59894,25186,77549,10404,4186,772,667,111780,8463,8331,16794,19294,8464,10830,56886,724
40001,"Adair County, Oklahoma",22161,10997,11164,16576,14239,1416,384,39,73,22035,3062,2784,5846,6595,3134,3461,8065,20
40137,"Stephens County, Oklahoma",44631,21698,22933,25177,30468,4077,944,268,200,44042,3300,3330,6630,6798,2969,3829,18402,265
40019,"Carter County, Oklahoma",48530,23448,25082,24965,32200,4056,1601,387,225,47870,3574,3394,6968,7395,3185,4210,20500,122
40055,"Greer County, Oklahoma",6081,3546,2535,20073,4311,450,138,29,4,5035,398,426,824,957,432,525,2180,21
40091,"McIntosh County, Oklahoma",20161,9950,10211,22241,14666,1352,542,57,67,19858,1768,1722,3490,3757,1732,2025,6888,51
40099,"Murray County, Oklahoma",13792,6801,6991,24804,9514,1307,491,52,69,13379,1111,1227,2338,1925,732,1193,6093,9
40115,"Ottawa County, Oklahoma",32022,15720,16302,19415,20815,1891,719,187,95,31578,2898,2721,5619,6957,3298,3659,12653,99
40145,"Wagoner County, Oklahoma",76190,37685,38505,27337,50989,8032,2351,387,333,75899,5247,4782,10029,8206,3565,4641,34773,361
40015,"Caddo County, Oklahoma",29510,15389,14121,21071,19473,2269,767,38,56,28457,3319,3184,6503,5883,2940,2943,11215,133
40101,"Muskogee County, Oklahoma",69939,34194,35745,21800,46411,6362,1930,372,232,67049,6613,6628,13241,14085,6040,8045,26715,322
36121,"Wyoming County, New York",41239,22339,18900,25635,29560,2789,1385,178,81,37655,1321,883,2204,4312,2007,2305,18049,146
40013,"Bryan County, Oklahoma",44529,21641,22888,22171,29488,4200,1840,238,232,44080,3827,3885,7712,7551,3461,4090,17904,261
51023,"Botetourt County, Virginia",33192,16425,16767,34733,24034,4398,1681,257,234,32914,925,717,1642,2732,1163,1569,15851,57
51520,"Bristol city, Virginia",17340,8084,9256,21589,12269,1883,686,137,169,17175,1461,915,2376,3498,1233,2265,7307,191
17201,"Winnebago County, Illinois",288896,141203,147693,27297,194929,27796,12255,2433,1198,285739,14016,9965,23981,44086,19561,24525,129506,856
17147,"Piatt County, Illinois",16469,8145,8324,33672,11576,2223,1014,108,112,16418,360,345,705,927,379,548,8380,30
17153,"Pulaski County, Illinois",5792,2839,2953,20195,4052,331,111,5,0,5784,253,182,435,1051,464,587,1886,5
01099,"Monroe County, Alabama",21975,10522,11453,17264,14893,1158,505,57,126,21750,1772,1799,3571,6972,3135,3837,6424,53
01079,"Lawrence County, Alabama",33433,16272,17161,22419,23427,1700,619,73,23,33206,1989,1680,3669,6050,2774,3276,12429,45
01081,"Lee County, Alabama",153947,76027,77920,26170,90099,17732,8781,1497,2995,152225,7870,6599,14469,34085,15745,18340,70201,382
01093,"Marion County, Alabama",30239,14958,15281,21835,21538,1713,816,123,33,29669,1535,1303,2838,5509,2603,2906,11521,130
01107,"Pickens County, Alabama",20042,9877,10165,20089,14084,1105,354,60,47,19132,1300,820,2120,4575,1969,2606,6728,45
01119,"Sumter County, Alabama",13285,6135,7150,14739,8278,907,464,61,68,13155,1229,1163,2392,4582,2012,2570,4199,9
01073,"Jefferson County, Alabama",659096,311971,347125,29456,446097,84843,34094,13929,7388,651846,37463,33618,71081,116750,50114,66636,292781,1869
01023,"Choctaw County, Alabama",13287,6349,6938,20994,9448,740,296,81,13,13159,797,719,1516,2743,1152,1591,4143,76
01059,"Franklin County, Alabama",31573,15553,16020,19314,20928,1660,702,131,100,31322,2018,2397,4415,6951,2689,4262,12197,449
01091,"Marengo County, Alabama",20066,9433,10633,22996,13679,1414,455,90,64,19852,1247,1184,2431,5504,2176,3328,6554,144
01113,"Russell County, Alabama",58636,28519,30117,21279,38568,4152,1862,336,212,56906,4563,4090,8653,12423,5158,7265,24308,114
01019,"Cherokee County, Alabama",25897,12883,13014,23010,18694,1463,766,279,102,25566,1259,1158,2417,4188,2037,2151,9952,22
01039,"Covington County, Alabama",37729,18219,19510,22431,26492,2653,977,272,51,37212,2384,2233,4617,7031,3088,3943,14210,189
01041,"Crenshaw County, Alabama",13896,6863,7033,21580,9551,1045,318,21,15,13718,821,728,1549,2484,1107,1377,5550,36
01047,"Dallas County, Alabama",41426,19128,22298,18248,27038,2233,1134,277,83,41115,2719,2422,5141,14027,5546,8481,13879,205
08101,"Pueblo County, Colorado",162158,79805,82353,23110,108786,14603,6607,1075,820,158695,8945,5981,14926,31907,14623,17284,64701,460
08085,"Montrose County, Colorado",40866,20143,20723,24308,28950,4230,2076,363,216,40485,3076,2955,6031,7278,3193,4085,16553,166
08087,"Morgan County, Colorado",28288,14071,14217,24077,18182,1805,815,237,71,27958,1368,1262,2630,2986,1057,1929,13009,30
08093,"Park County, Colorado",16440,8640,7800,34377,12809,2720,872,104,208,16299,1254,641,1895,1022,436,586,8744,147
08109,"Saguache County, Colorado",6255,3074,3181,22267,4429,768,282,15,63,6234,753,791,1544,1409,573,836,2445,24
08077,"Mesa County, Colorado",148166,73393,74773,27612,99979,17395,6219,1287,1194,146965,9841,8881,18722,23633,10888,12745,66979,852
08099,"Prowers County, Colorado",12121,6089,6032,22033,7821,846,296,30,32,11934,1001,517,1518,2422,1059,1363,5379,106
08053,"Hinsdale County, Colorado",856,407,449,29574,701,221,31,17,18,856,49,53,102,96,45,51,407,4
08041,"El Paso County, Colorado",665171,334605,330566,31217,422966,94598,47296,7424,5344,633612,32779,26511,59290,73012,32977,40035,320427,2552
08121,"Washington County, Colorado",4814,2477,2337,26279,3383,411,106,14,10,4548,215,144,359,529,230,299,2140,18
08049,"Grand County, Colorado",14490,7752,6738,32919,10737,3030,691,208,62,14430,1398,1146,2544,1523,787,736,8234,54
08005,"Arapahoe County, Colorado",617668,303932,313736,36951,413227,108428,44392,10204,5282,612295,37492,32062,69554,65383,29560,35823,316545,2278
08089,"Otero County, Colorado",18440,9072,9368,20358,12348,1425,533,131,24,18251,1204,1090,2294,4154,2026,2128,7155,17
08014,"Broomfield County, Colorado",62449,30980,31469,43736,42402,13968,6315,980,980,62115,2084,1357,3441,3667,1551,2116,32938,398
10003,"New Castle County, Delaware",551997,267276,284721,34541,373316,77943,38515,7779,8026,543604,20688,17010,37698,60817,26035,34782,265673,1647
10005,"Sussex County, Delaware",211224,102453,108771,31874,155215,21624,11442,2539,1468,208518,10180,7839,18019,26765,11489,15276,90267,974
10001,"Kent County, Delaware",171474,82687,88787,27420,112384,16203,7280,1332,1170,168146,7313,5747,13060,21866,9363,12503,76484,521
11001,"District of Columbia, District of Columbia",659009,312629,346380,50832,462997,108252,90366,38536,19162,648263,20265,13154,33419,112060,48859,63201,345735,2066
09009,"New Haven County, Connecticut",860874,415286,445588,35085,591915,109536,63749,16955,12717,850312,33267,26698,59965,106796,46555,60241,414017,2366
09005,"Litchfield County, Connecticut",185141,91469,93672,40619,135352,26729,14833,2894,1587,183779,6385,4628,11013,12706,6179,6527,96122,659
37027,"Caldwell County, North Carolina",81623,40166,41457,21991,57994,5561,1829,420,189,80778,6052,5670,11722,14137,6291,7846,33236,449
37035,"Catawba County, North Carolina",155461,76086,79375,25960,106667,15711,5576,1178,587,153975,10419,9158,19577,24269,10999,13270,69477,627
37045,"Cleveland County, North Carolina",97113,46731,50382,21664,66196,6380,3308,569,535,96868,7589,6278,13867,19866,8310,11556,39452,125
37049,"Craven County, North Carolina",104190,52791,51399,26830,67479,9770,4020,764,604,96561,7176,5955,13131,15205,6410,8795,46375,517
37065,"Edgecombe County, North Carolina",54669,25396,29273,18946,37030,2496,1089,176,86,53769,4383,3459,7842,13750,5909,7841,20840,899
37077,"Granville County, North Carolina",58341,29722,28619,24859,40513,5498,1732,416,222,55352,3688,2807,6495,9109,4169,4940,23936,163
37085,"Harnett County, North Carolina",126620,62640,63980,22351,80278,10485,3979,643,357,120300,8360,7485,15845,22461,10008,12453,51265,342
37093,"Hoke County, North Carolina",51853,25654,26199,19654,32562,4315,1170,96,199,47833,3468,3579,7047,11545,5128,6417,20223,265
37089,"Henderson County, North Carolina",110905,53523,57382,28290,81797,15743,6316,1181,1072,109798,8303,6755,15058,14559,6677,7882,46669,209
37095,"Hyde County, North Carolina",5629,2977,2652,19181,4069,266,77,13,0,4951,420,477,897,1108,431,677,2080,51
37097,"Iredell County, North Carolina",167493,82362,85131,30393,113529,20177,6809,1369,804,166284,9766,10320,20086,22114,9216,12898,76677,867
37119,"Mecklenburg County, North Carolina",1011774,486037,525737,35669,669789,191987,72577,16329,7772,1006217,75023,65334,140357,141024,61267,79757,508464,4793
37131,"Northampton County, North Carolina",20628,10017,10611,19126,15083,1024,499,99,79,19846,1536,1523,3059,5616,2380,3236,6837,34
37147,"Pitt County, North Carolina",175150,82515,92635,25462,103759,19154,7920,1755,1737,173917,12136,11661,23797,41412,17525,23887,80774,495
37159,"Rowan County, North Carolina",138694,68575,70119,23838,94810,12060,3688,555,407,136184,10326,8929,19255,24142,10589,13553,56970,422
37181,"Vance County, North Carolina",44508,20766,23742,21188,29683,2448,678,183,93,44051,3425,3032,6457,11177,4944,6233,16664,24
37039,"Cherokee County, North Carolina",27226,13308,13918,21152,20675,2453,1151,257,116,26946,2618,2344,4962,5247,2370,2877,9364,151
37053,"Currituck County, North Carolina",24864,12299,12565,29340,17586,2803,848,110,84,24549,1977,1474,3451,2468,914,1554,11985,87
37179,"Union County, North Carolina",217614,107221,110393,32754,137190,32883,10024,2067,1162,216646,12801,11256,24057,20772,9373,11399,101446,688
37193,"Wilkes County, North Carolina",68888,33902,34986,21798,48877,4747,1524,257,198,68019,5208,3964,9172,14278,6552,7726,27311,86
37127,"Nash County, North Carolina",94385,45309,49076,25232,64449,8474,3121,552,468,92985,6134,6063,12197,16057,6109,9948,40446,144
37003,"Alexander County, North Carolina",37211,18974,18237,22655,26287,2394,910,174,24,35980,2286,1837,4123,6240,2909,3331,15281,256
37055,"Dare County, North Carolina",35187,17290,17897,30898,26002,5028,1784,387,353,35027,3541,2711,6252,2885,1320,1565,18056,225
37185,"Warren County, North Carolina",20324,10196,10128,21543,14437,1280,635,84,114,19335,1800,1330,3130,4662,2187,2475,6845,50
37195,"Wilson County, North Carolina",81617,38626,42991,23383,55015,7035,2479,407,292,80492,6393,5753,12146,18043,7891,10152,34322,1601
37073,"Gates County, North Carolina",11615,5762,5853,24335,8245,788,268,101,36,11510,678,533,1211,1391,581,810,4989,80
37075,"Graham County, North Carolina",8651,4326,4325,19095,6004,557,231,52,0,8536,802,813,1615,1650,802,848,2959,0
37115,"Madison County, North Carolina",21130,10447,10683,22653,14943,2132,1156,229,175,20899,1511,978,2489,3337,1436,1901,9044,61
37137,"Pamlico County, North Carolina",12892,6599,6293,25461,9832,1200,506,58,125,12233,964,977,1941,1773,710,1063,4766,62
37149,"Polk County, North Carolina",20324,9732,10592,29728,15498,3159,1265,329,174,20042,1157,1395,2552,2902,1389,1513,8327,187
37151,"Randolph County, North Carolina",142588,70281,72307,22349,97483,10502,3220,489,527,141369,11557,9968,21525,23757,10985,12772,62644,413
37169,"Stokes County, North Carolina",46453,22749,23704,23500,33618,3744,850,53,166,46011,3031,2782,5813,7052,3178,3874,19887,68
37187,"Washington County, North Carolina",12503,5815,6688,21117,8641,559,212,50,15,12321,885,1001,1886,2916,923,1993,4400,15
37043,"Clay County, North Carolina",10730,5059,5671,25433,8070,1067,401,92,134,10680,897,980,1877,1731,751,980,4063,56
37051,"Cumberland County, North Carolina",325841,159259,166582,23627,201229,31694,13368,1939,1522,298408,18581,17778,36359,55235,22754,32481,143280,1096
37081,"Guilford County, North Carolina",511815,242827,268988,28582,339288,76052,29389,6180,5296,507863,34311,30695,65006,87165,37656,49509,236026,1252
37099,"Jackson County, North Carolina",41227,20392,20835,23674,26312,4338,2145,472,772,40951,3353,2420,5773,8646,4138,4508,17218,79
37139,"Pasquotank County, North Carolina",39909,19548,20361,23714,26667,3177,1512,157,188,38471,2768,2701,5469,6521,2798,3723,16737,192
37155,"Robeson County, North Carolina",134576,64911,69665,17161,85168,7545,2371,542,298,132630,12732,11008,23740,40313,18242,22071,47527,448
37173,"Swain County, North Carolina",14234,6940,7294,20918,9749,979,392,71,53,14055,1783,1299,3082,3277,1544,1733,5359,35
37183,"Wake County, North Carolina",998576,485068,513508,37315,656256,209531,86957,15793,16312,989818,55394,48037,103431,105133,47986,57147,510506,3854
37007,"Anson County, North Carolina",25883,13575,12308,19105,18180,1204,342,69,117,24129,2304,1657,3961,5484,2475,3009,9920,23
37111,"McDowell County, North Carolina",45013,22731,22282,20439,32087,3307,1007,251,134,44107,3517,2758,6275,8814,4184,4630,17198,136
37069,"Franklin County, North Carolina",62989,31235,31754,23862,43150,6141,2251,298,115,61965,4582,4006,8588,9967,4415,5552,26686,259
37103,"Jones County, North Carolina",10074,4878,5196,21058,7453,687,247,41,71,9985,933,686,1619,2285,1007,1278,3815,60
37113,"Macon County, North Carolina",33991,16429,17562,27282,25339,3866,1394,357,164,33774,3190,2832,6022,6183,2829,3354,13501,360
37019,"Brunswick County, North Carolina",119167,57790,61377,29707,91995,16111,6721,1124,875,118194,9058,7642,16700,17992,7317,10675,45376,455
37175,"Transylvania County, North Carolina",33062,15910,17152,26037,24839,4448,2044,423,451,32587,2938,2695,5633,4598,1926,2672,13088,65
37013,"Beaufort County, North Carolina",47513,22714,24799,24657,33861,4039,1724,275,248,47150,3227,2697,5924,8215,3445,4770,18773,73
37047,"Columbus County, North Carolina",57015,28027,28988,21849,39320,3236,1163,213,98,54225,4447,4146,8593,12443,5386,7057,20127,155
37109,"Lincoln County, North Carolina",79783,39547,40236,27359,55973,7801,2462,375,395,79193,4965,4929,9894,11907,5667,6240,36071,317
37123,"Montgomery County, North Carolina",27475,13437,14038,20900,19275,2067,549,112,69,26635,2255,2332,4587,5821,2486,3335,10571,62
37135,"Orange County, North Carolina",139807,66666,73141,38348,85572,22331,14807,4650,7581,139108,6174,5487,11661,18713,8072,10641,69700,723
37153,"Richmond County, North Carolina",45710,22113,23597,19966,30690,2818,1150,171,99,44428,3504,3117,6621,11443,5010,6433,17032,121
37163,"Sampson County, North Carolina",63713,31190,32523,20872,42520,3712,1024,182,152,63135,5963,5233,11196,15207,6960,8247,26236,130
37171,"Surry County, North Carolina",72767,35422,37345,22533,50839,5078,2099,371,221,71976,5793,5068,10861,12801,5872,6929,29195,223
72135,"Toa Alta Municipio, Puerto Rico",74467,35897,38570,14162,48681,11898,2749,566,298,74383,3056,1852,4908,22739,10492,12247,26249,329
72137,"Toa Baja Municipio, Puerto Rico",83645,39379,44266,12240,56813,10049,2304,423,282,83453,3677,2610,6287,30811,14243,16568,28542,1025
72147,"Vieques Municipio, Puerto Rico",9046,4551,4495,11136,6199,812,182,16,165,9046,448,327,775,3220,1287,1933,2920,0
72151,"Yabucoa Municipio, Puerto Rico",35670,17329,18341,8672,24287,3139,828,46,58,35605,955,749,1704,17603,8017,9586,7625,74
72025,"Caguas Municipio, Puerto Rico",136372,63752,72620,13904,93422,19794,5773,883,1394,135839,5553,3969,9522,50464,21608,28856,45230,705
72029,"Canóvanas Municipio, Puerto Rico",47174,22812,24362,11094,31172,4943,1170,92,164,47098,3059,2094,5153,20421,8972,11449,13525,66
72043,"Coamo Municipio, Puerto Rico",40090,19502,20588,10307,27152,4294,1134,35,254,40059,1149,788,1937,19726,9368,10358,11002,45
72051,"Dorado Municipio, Puerto Rico",38013,18187,19826,15495,25425,5580,1459,382,292,37885,1118,686,1804,13587,6330,7257,11254,455
72019,"Barranquitas Municipio, Puerto Rico",29548,14565,14983,7716,18789,2515,664,27,23,29467,705,323,1028,17728,8188,9540,6201,0
72129,"San Lorenzo Municipio, Puerto Rico",39283,19209,20074,10497,26931,3934,1091,181,24,39217,1091,647,1738,18300,8796,9504,10865,82
72011,"Añasco Municipio, Puerto Rico",28250,13706,14544,9344,19546,2554,474,12,140,28172,468,324,792,13760,6510,7250,8413,95
72039,"Ciales Municipio, Puerto Rico",17644,8631,9013,8049,11891,1516,142,0,19,17627,645,158,803,10694,5103,5591,3500,33
72045,"Comerío Municipio, Puerto Rico",20153,10022,10131,7047,13463,1292,334,7,21,20153,487,313,800,12220,5957,6263,4350,83
72073,"Jayuya Municipio, Puerto Rico",15605,7778,7827,7179,10094,1212,382,0,39,15388,290,173,463,9196,4536,4660,2990,0
72081,"Lares Municipio, Puerto Rico",28052,13847,14205,8212,19342,2600,547,50,27,27825,1202,889,2091,15984,7468,8516,6172,0
72119,"Río Grande Municipio, Puerto Rico",52479,25534,26945,10804,35706,5411,1373,132,216,51665,2195,1254,3449,19400,8581,10819,16332,654
72127,"San Juan Municipio, Puerto Rico",363744,166874,196870,18160,255537,54584,19470,9730,4961,360036,21656,14548,36204,151520,65002,86518,129146,3343
72145,"Vega Baja Municipio, Puerto Rico",55866,26869,28997,10197,37969,6067,1442,139,219,55691,1819,2044,3863,25518,11720,13798,13913,143
72093,"Maricao Municipio, Puerto Rico",6274,3115,3159,5943,4335,349,49,15,13,6274,70,83,153,4001,1982,2019,1467,5
20033,"Comanche County, Kansas",1898,912,986,28388,1339,191,66,12,0,1822,97,146,243,156,48,108,965,6
20063,"Gove County, Kansas",2682,1354,1328,29352,1943,352,65,17,2,2631,163,136,299,241,127,114,1307,7
20079,"Harvey County, Kansas",34814,17027,17787,26587,22978,3985,1860,282,233,34174,1596,1419,3015,4180,1746,2434,16445,51
20069,"Gray County, Kansas",6037,3002,3035,27031,3768,539,156,4,24,5952,323,354,677,495,194,301,3041,34
20017,"Chase County, Kansas",2694,1357,1337,24469,1908,304,101,8,50,2591,94,71,165,324,167,157,1165,25
20067,"Grant County, Kansas",7748,4026,3722,26138,4669,505,93,51,60,7670,856,722,1578,870,336,534,3592,20
20109,"Logan County, Kansas",2800,1384,1416,28549,1914,237,87,24,3,2760,96,71,167,264,120,144,1338,1
20149,"Pottawatomie County, Kansas",22920,11326,11594,27978,14399,2993,1068,166,380,22416,866,765,1631,2045,937,1108,10865,146
20015,"Butler County, Kansas",66264,33269,32995,28478,43118,8244,3428,385,277,64032,2840,3022,5862,6171,2542,3629,30929,287
20169,"Saline County, Kansas",55547,27433,28114,27951,36669,5864,1929,602,321,54707,3242,3342,6584,7986,3320,4666,27916,496
20197,"Wabaunsee County, Kansas",6960,3510,3450,25790,4766,769,277,44,41,6858,304,247,551,459,160,299,3329,48
20207,"Woodson County, Kansas",3186,1601,1585,21419,2331,240,66,9,5,3168,226,260,486,726,338,388,1501,23
20141,"Osborne County, Kansas",3746,1868,1878,26559,2697,396,115,36,19,3642,201,199,400,631,300,331,1765,28
20055,"Finney County, Kansas",36983,18835,18148,23074,21545,2689,1019,170,117,36742,2594,2437,5031,5790,2472,3318,17986,137
20097,"Kiowa County, Kansas",2520,1236,1284,24961,1643,302,114,17,16,2449,124,94,218,254,132,122,1251,6
20201,"Washington County, Kansas",5613,2863,2750,26927,3951,560,148,17,3,5478,205,181,386,574,243,331,2793,31
20129,"Morton County, Kansas",3033,1596,1437,23038,1949,208,64,7,0,2944,159,161,320,297,123,174,1342,4
20009,"Barton County, Kansas",27214,13553,13661,26264,18177,2125,635,156,120,26797,2043,1626,3669,4137,1837,2300,13309,59
20043,"Doniphan County, Kansas",7793,3938,3855,24520,5160,619,197,28,27,7674,533,443,976,873,420,453,3782,35
20101,"Lane County, Kansas",1687,829,858,29768,1171,193,54,0,2,1678,95,55,150,148,63,85,852,0
20115,"Marion County, Kansas",12213,6086,6127,25620,8413,1279,483,95,57,11857,402,512,914,1243,610,633,5569,19
20013,"Brown County, Kansas",9810,4729,5081,24319,6675,792,415,82,51,9737,460,573,1033,1408,584,824,4549,16
20161,"Riley County, Kansas",75026,39816,35210,26619,37238,9155,4780,1083,2120,68566,2481,1852,4333,14347,6684,7663,40443,256
20041,"Dickinson County, Kansas",19384,9705,9679,24434,13339,1839,546,84,129,18956,849,553,1402,2131,794,1337,8969,93
21079,"Garrard County, Kentucky",17051,8359,8692,24874,12040,1127,536,118,81,16946,912,876,1788,3259,1580,1679,7056,69
21037,"Campbell County, Kentucky",91456,44729,46727,31065,61794,12045,4802,1192,863,89957,4037,3760,7797,13138,5624,7514,45413,441
21081,"Grant County, Kentucky",24705,12263,12442,20892,15780,1162,573,203,11,24266,1132,1256,2388,4857,2117,2740,9431,93
21141,"Logan County, Kentucky",26757,13151,13606,21465,18219,1651,650,104,29,26461,1559,1526,3085,4778,2156,2622,10350,107
21167,"Mercer County, Kentucky",21411,10599,10812,24981,14986,1654,875,82,168,21236,1184,760,1944,3846,1708,2138,9281,11
01115,"St. Clair County, Alabama",86576,43498,43078,24686,60054,6314,2493,471,393,84654,4092,3519,7611,11582,5103,6479,37613,453
01003,"Baldwin County, Alabama",199510,97371,102139,29364,139946,27056,10063,2967,1264,197046,12704,10551,23255,25551,11658,13893,86310,697
01069,"Houston County, Alabama",103891,49782,54109,24781,70773,9614,3799,951,511,102993,6644,5838,12482,19415,8297,11118,43371,265
01125,"Tuscaloosa County, Alabama",202471,97672,104799,24895,123155,22314,9408,1937,2511,200972,10356,9191,19547,34470,14323,20147,88779,390
01031,"Coffee County, Alabama",50991,25210,25781,26216,34614,5251,2252,436,253,49139,2749,2504,5253,8219,3669,4550,21990,160
01109,"Pike County, Alabama",33277,15865,17412,20808,19618,2888,1425,123,270,33074,1804,1686,3490,8074,3842,4232,14002,43
21225,"Union County, Kentucky",15065,7775,7290,21758,9725,645,432,64,41,14897,968,536,1504,3528,1854,1674,6173,25
21035,"Calloway County, Kentucky",38302,18356,19946,21757,23270,3899,1884,339,531,37877,1995,1836,3831,8615,4116,4499,16599,102
21059,"Daviess County, Kentucky",98724,47998,50726,26501,66401,8435,4360,794,511,96812,4306,3241,7547,15599,6831,8768,43021,180
21101,"Henderson County, Kentucky",46362,22480,23882,23958,31966,3269,1887,285,132,45434,2117,1617,3734,8696,3879,4817,20515,59
21109,"Jackson County, Kentucky",13357,6646,6711,16827,9273,572,330,100,36,13247,1102,753,1855,4381,2112,2269,4137,30
21163,"Meade County, Kentucky",28751,14554,14197,25119,19124,1782,1042,85,22,27779,1543,1493,3036,4426,2010,2416,11822,47
21185,"Oldham County, Kentucky",63876,33698,30178,38063,42333,10358,4718,1211,559,59669,1468,1046,2514,3566,1262,2304,29135,169
21203,"Rockcastle County, Kentucky",16893,8257,8636,19750,11828,602,427,117,4,16603,775,658,1433,3875,1718,2157,5949,84
21003,"Allen County, Kentucky",20421,10146,10275,21652,13827,1122,584,114,65,20236,1630,1373,3003,3420,1570,1850,8219,241
21029,"Bullitt County, Kentucky",77727,38657,39070,26643,53090,4864,2103,421,144,77351,2882,1939,4821,7904,3769,4135,37453,216
21075,"Fulton County, Kentucky",6323,3141,3182,18111,4437,373,176,19,28,5870,297,353,650,1566,723,843,2171,37
21119,"Knott County, Kentucky",15884,7887,7997,17670,10913,687,514,158,50,15703,904,807,1711,4784,2198,2586,4630,84
21177,"Muhlenberg County, Kentucky",31216,15627,15589,20376,21649,1297,1021,270,39,30253,1680,1272,2952,5914,2597,3317,11632,223
21237,"Wolfe County, Kentucky",7221,3516,3705,13533,5018,263,303,18,9,7095,407,371,778,2896,1406,1490,1808,13
21013,"Bell County, Kentucky",27676,13503,14173,14754,19428,929,665,197,64,26845,1405,1562,2967,9776,4173,5603,7436,108
21057,"Cumberland County, Kentucky",6780,3363,3417,18669,4786,469,181,27,3,6692,560,449,1009,1484,630,854,2409,23
21129,"Lee County, Kentucky",6896,3540,3356,16489,4962,146,196,36,0,6173,311,322,633,2360,1055,1305,1579,50
21061,"Edmonson County, Kentucky",12086,5991,6095,21851,8595,675,246,92,10,11991,378,388,766,2606,1057,1549,4420,55
21023,"Bracken County, Kentucky",8404,4188,4216,22433,5698,534,247,34,19,8369,338,310,648,1718,770,948,3419,14
21179,"Nelson County, Kentucky",44875,22161,22714,28156,29822,3156,1457,359,170,44590,1881,1804,3685,6185,2852,3333,20511,43
21155,"Marion County, Kentucky",19497,9882,9615,21823,13237,1027,605,52,41,18630,945,701,1646,3541,1474,2067,7718,15
21015,"Boone County, Kentucky",125656,62107,63549,33553,81533,16373,6902,1304,746,124674,4079,4251,8330,9856,3863,5993,62598,402
21121,"Knox County, Kentucky",31740,15460,16280,15869,21288,1212,732,254,122,31389,2286,1718,4004,10613,4983,5630,9052,39
21133,"Letcher County, Kentucky",23382,11444,11938,18085,16557,1076,520,169,89,23199,1289,1232,2521,6889,3129,3760,7214,51
21195,"Pike County, Kentucky",62791,30796,31995,20576,43893,2958,1748,680,263,62078,2892,2673,5565,15528,6924,8604,20377,196
51830,"Williamsburg city, Virginia",14988,6532,8456,26921,7318,2041,1321,366,422,14825,440,335,775,2476,1038,1438,5763,0
51035,"Carroll County, Virginia",29733,14897,14836,23690,21913,2109,514,47,138,29598,1979,2031,4010,4625,2073,2552,12745,21
51191,"Washington County, Virginia",54562,27008,27554,25640,39783,6182,2522,685,468,53859,2989,2870,5859,7569,3611,3958,24040,246
51139,"Page County, Virginia",23759,11636,12123,24057,17170,1487,614,46,68,23557,1527,1667,3194,3770,1723,2047,10198,64
51510,"Alexandria city, Virginia",151473,73054,78419,57019,115156,33889,25192,8370,4048,148470,11511,9667,21178,14688,5922,8766,94430,776
51650,"Hampton city, Virginia",136789,65983,70806,27053,90364,13706,6541,761,680,131597,8313,7132,15445,20596,9362,11234,64324,499
51013,"Arlington County, Virginia",226092,112644,113448,67061,169813,58654,44417,14644,7377,222252,10349,8731,19080,19528,8610,10918,143100,820
51027,"Buchanan County, Virginia",23158,11673,11485,19241,17309,1082,505,83,50,22169,1541,1564,3105,5297,2648,2649,6735,64
51179,"Stafford County, Virginia",139548,70245,69303,39158,87903,19237,11702,961,917,133418,5953,4510,10463,6880,2851,4029,68955,567
51760,"Richmond city, Virginia",216773,102936,113837,30113,146548,32078,14793,4352,2547,214063,18656,14935,33591,52470,22985,29485,104501,1184
51057,"Essex County, Virginia",11130,5137,5993,25730,7903,852,355,69,40,11053,598,731,1329,1477,488,989,5274,131
51185,"Tazewell County, Virginia",43367,21489,21878,24325,31344,2971,1012,351,230,42152,2909,2459,5368,7466,3315,4151,15784,95
51685,"Manassas Park city, Virginia",15827,8387,7440,29641,10243,2113,734,145,124,15786,2041,1485,3526,1364,679,685,7984,13
51183,"Sussex County, Virginia",11733,7715,4018,15882,9794,661,382,43,17,6690,174,385,559,1238,383,855,2879,49
51683,"Manassas city, Virginia",41149,20455,20694,30572,26230,4939,2408,332,210,41121,3986,3732,7718,3557,1434,2123,21425,78
51775,"Salem city, Virginia",25290,11904,13386,30141,16975,2836,1335,181,214,24568,1068,1163,2231,2158,984,1174,12223,31
51037,"Charlotte County, Virginia",12232,6121,6111,19830,8488,705,365,10,27,12100,1023,922,1945,2979,1283,1696,4878,167
51081,"Greensville County, Virginia",11698,7254,4444,16835,8660,412,234,66,24,8596,495,432,927,1534,604,930,4057,185
53067,"Thurston County, Washington",266311,130394,135917,32410,184136,37766,16897,4551,2109,260340,13066,9632,22698,31605,14441,17164,121298,990
53013,"Columbia County, Washington",3971,1950,2021,28950,2959,528,166,22,36,3909,125,176,301,577,277,300,1590,34
53039,"Klickitat County, Washington",20930,10486,10444,25069,15063,2527,915,112,124,20888,1011,978,1989,3261,1202,2059,7681,81
53027,"Grays Harbor County, Washington",71233,36656,34577,24081,50788,5270,1899,261,344,68271,5180,3966,9146,11269,5263,6006,25938,282
53069,"Wahkiakum County, Washington",4051,1975,2076,26964,3072,320,128,8,7,3988,187,145,332,562,247,315,1207,18
53025,"Grant County, Washington",92530,46630,45900,22508,55417,5781,2270,398,205,92022,8708,7141,15849,15441,6970,8471,37647,891
53061,"Snohomish County, Washington",758649,380430,378219,35737,517950,109719,36130,7610,5025,749283,38004,31532,69536,69695,31211,38484,374583,2669
54089,"Summers County, West Virginia",13325,6170,7155,20142,10162,932,480,62,28,12286,577,447,1024,2254,1139,1115,4559,19
54025,"Greenbrier County, West Virginia",35580,17384,18196,23777,26059,3181,1281,476,165,34955,2048,1671,3719,6398,2905,3493,13703,43
54057,"Mineral County, West Virginia",27606,13724,13882,21888,19334,1533,706,96,56,27376,1468,1821,3289,4386,2016,2370,10796,59
54041,"Lewis County, West Virginia",16422,8229,8193,21513,11833,1027,416,181,36,16296,852,772,1624,3142,1411,1731,6027,76
54075,"Pocahontas County, West Virginia",8620,4451,4169,23219,6535,617,324,38,80,8337,693,439,1132,1545,626,919,3582,6
54083,"Randolph County, West Virginia",29287,15020,14267,23642,21148,2034,1397,203,236,27480,1507,1497,3004,4568,2060,2508,11469,42
54105,"Wirt County, West Virginia",5826,2986,2840,19747,4144,237,84,45,34,5826,227,402,629,876,340,536,2166,0
54015,"Clay County, West Virginia",9033,4523,4510,16229,6350,341,279,12,10,8985,437,302,739,2073,941,1132,2588,20
54061,"Monongalia County, West Virginia",102827,53232,49595,29285,62141,12369,7003,2408,2558,101185,4957,3845,8802,21353,10780,10573,48228,237
54103,"Wetzel County, West Virginia",15997,7839,8158,22088,11471,721,397,48,67,15899,730,849,1579,3340,1466,1874,5469,39
54039,"Kanawha County, West Virginia",189636,91385,98251,28201,136129,19763,9619,3425,1473,187842,9113,7621,16734,29779,13076,16703,81592,353
54077,"Preston County, West Virginia",33793,17411,16382,22540,24754,2115,1218,109,166,31263,1816,1568,3384,4761,2137,2624,13388,39
54085,"Ritchie County, West Virginia",10044,4982,5062,21533,7229,461,225,49,16,9977,751,586,1337,1919,877,1042,3674,26
54043,"Lincoln County, West Virginia",21482,10732,10750,19321,15076,840,354,148,18,21423,1156,797,1953,5394,2528,2866,7226,155
54007,"Braxton County, West Virginia",14463,7234,7229,20633,10465,956,221,42,58,14119,659,763,1422,2842,1425,1417,5305,240
54005,"Boone County, West Virginia",23645,11731,11914,20992,16675,873,510,51,15,23527,1161,875,2036,6090,2752,3338,6846,106
54109,"Wyoming County, West Virginia",22537,11145,11392,20474,16061,817,450,52,0,22458,1333,1191,2524,4483,2212,2271,6264,177
39105,"Meigs County, Ohio",23345,11465,11880,22396,16515,1367,733,61,58,23138,1323,1197,2520,5247,2409,2838,8672,57
41029,"Jackson County, Oregon",210916,102814,108102,27081,149411,24040,10133,2930,1835,209779,12694,11488,24182,37595,17334,20261,87916,764
41023,"Grant County, Oregon",7227,3608,3619,25154,5491,658,422,83,30,7095,422,325,747,1059,503,556,2928,7
41005,"Clackamas County, Oregon",394967,194409,200558,37551,275392,60596,23059,6727,3427,393403,16965,14809,31774,36160,16149,20011,188117,1187
41057,"Tillamook County, Oregon",25552,12929,12623,25458,18934,2451,1087,223,189,24883,1421,1277,2698,3821,1751,2070,9715,127
41033,"Josephine County, Oregon",84063,41141,42922,24349,61626,6499,3181,696,267,83403,5106,3954,9060,16177,8077,8100,28755,417
41059,"Umatilla County, Oregon",76582,39827,36755,22153,49500,4745,2303,355,302,72041,5030,4373,9403,12918,5349,7569,31015,225
41009,"Columbia County, Oregon",49645,24908,24737,28460,35024,4634,1755,220,110,49355,2525,2234,4759,6598,3074,3524,20051,93
41065,"Wasco County, Oregon",25657,12789,12868,24727,17800,2067,904,213,118,25232,1436,1287,2723,3651,1708,1943,10932,45
41039,"Lane County, Oregon",360273,177392,182881,27032,244078,42348,18797,4481,4376,358711,21496,16317,37813,69588,33565,36023,158322,1192
41067,"Washington County, Oregon",564088,278000,286088,35369,380395,98869,41198,7927,8728,560582,29284,24116,53400,61817,28334,33483,277778,1649
41007,"Clatsop County, Oregon",37660,18744,18916,28115,27112,3990,1889,363,288,36914,2291,1843,4134,5187,2341,2846,16796,189
55033,"Dunn County, Wisconsin",44348,22351,21997,26354,27055,4541,1909,333,421,44018,2000,1436,3436,5768,2599,3169,22208,143
55043,"Grant County, Wisconsin",51723,26874,24849,23753,31846,4178,1912,382,323,50593,2251,1693,3944,7335,3626,3709,25708,198
55117,"Sheboygan County, Wisconsin",115269,57928,57341,28849,79871,13186,4502,637,542,112989,3928,2858,6786,9942,4433,5509,58653,265
55078,"Menominee County, Wisconsin",4457,2205,2252,17197,2508,266,120,12,15,4406,705,569,1274,1449,703,746,1454,0
17169,"Schuyler County, Illinois",7205,3893,3312,23670,5383,672,227,44,74,7124,976,222,1198,1411,993,418,2955,15
17175,"Stark County, Illinois",5840,2888,2952,30009,4180,494,165,28,12,5738,275,177,452,768,286,482,2503,6
17045,"Edgar County, Illinois",17828,8730,9098,26344,12713,1553,677,48,14,17554,651,654,1305,2845,1269,1576,7504,15
17005,"Bond County, Illinois",17137,8736,8401,24473,11958,1378,640,58,108,15985,533,353,886,2553,1076,1477,7331,10
17007,"Boone County, Illinois",53656,26951,26705,29029,34640,4542,2092,526,291,53332,2347,1983,4330,5908,2468,3440,24426,32
17011,"Bureau County, Illinois",33822,16657,17165,28332,23786,2921,1130,277,145,33446,1444,1107,2551,4340,1757,2583,15983,210
17015,"Carroll County, Illinois",14793,7366,7427,27605,10832,1167,458,93,54,14638,637,478,1115,1663,760,903,6765,47
17029,"Coles County, Illinois",52802,25466,27336,26060,32608,4674,2552,304,728,52114,2818,2022,4840,10711,4783,5928,24584,70
17033,"Crawford County, Illinois",19441,10046,9395,25955,13957,1569,623,153,53,17909,909,659,1568,2192,1109,1083,8104,52
17083,"Jersey County, Illinois",22441,11007,11434,27528,15435,1824,826,101,86,22091,876,870,1746,1954,738,1216,9860,55
17155,"Putnam County, Illinois",5746,2912,2834,33697,4188,403,148,41,11,5740,225,177,402,595,251,344,2903,19
17039,"De Witt County, Illinois",16322,8188,8134,27866,11591,1699,536,93,37,16081,811,303,1114,1926,832,1094,8007,38
17051,"Fayette County, Illinois",22025,11670,10355,21844,15228,1442,519,88,17,20311,1422,948,2370,3240,1518,1722,8838,64
17103,"Lee County, Illinois",34718,18344,16374,28179,24854,2724,1347,209,122,31873,1247,1022,2269,3783,1785,1998,15063,136
17107,"Logan County, Illinois",29820,15158,14662,26479,20958,2757,848,142,104,24787,896,601,1497,2996,1316,1680,11563,33
17117,"Macoupin County, Illinois",46482,22939,23543,27255,32705,3933,1570,346,119,45959,2041,1322,3363,5875,2297,3578,20624,136
17159,"Richland County, Illinois",16072,7913,8159,25262,11168,1675,521,81,22,15864,561,508,1069,2311,998,1313,7142,49
17189,"Washington County, Illinois",14369,7253,7116,29687,10257,1463,540,90,48,14162,450,367,817,1580,681,899,7045,42
17135,"Montgomery County, Illinois",29301,15308,13993,23172,20959,1792,883,87,145,24357,622,810,1432,3725,1357,2368,9841,30
17001,"Adams County, Illinois",66949,32663,34286,27256,46128,6879,2763,436,347,65675,2551,1907,4458,8457,3778,4679,31989,340
17027,"Clinton County, Illinois",37858,19639,18219,30382,26690,4041,1341,188,77,35862,1021,847,1868,3406,1449,1957,18495,140
17047,"Edwards County, Illinois",6612,3270,3342,26549,4603,370,146,26,11,6580,340,135,475,760,349,411,3009,12
17081,"Jefferson County, Illinois",38523,19712,18811,24617,26805,2718,1160,349,177,36240,1594,1430,3024,6392,2827,3565,15715,76
17183,"Vermilion County, Illinois",79613,39531,40082,23416,53999,5297,1854,295,92,77191,4088,2514,6602,15093,6760,8333,31700,193
17199,"Williamson County, Illinois",67336,33555,33781,26023,47275,6269,3142,584,441,65456,3175,2161,5336,9724,4249,5475,28467,194
17023,"Clark County, Illinois",16089,7840,8249,28495,11175,1223,532,39,47,15855,607,661,1268,2576,1041,1535,7212,53
17049,"Effingham County, Illinois",34356,17210,17146,29300,23212,3793,1120,220,85,33951,1236,1020,2256,3634,1755,1879,16966,119
17057,"Fulton County, Illinois",36047,18804,17243,24269,25866,2964,1012,182,93,33641,1668,1014,2682,5232,2296,2936,15067,73
17065,"Hamilton County, Illinois",8251,4046,4205,25945,5798,567,289,28,28,8165,410,428,838,1219,583,636,3476,13
17073,"Henry County, Illinois",49681,24692,24989,28443,34409,5184,1637,394,104,48935,1713,1194,2907,6019,2642,3377,22935,178
17087,"Johnson County, Illinois",12866,7322,5544,20726,9347,1056,392,62,48,10855,418,409,827,1363,607,756,4282,32
17097,"Lake County, Illinois",702890,350890,352000,42388,452827,117263,58275,14766,7564,687451,34285,27919,62204,60664,28051,32613,348748,3069
17105,"Livingston County, Illinois",37278,18946,18332,27318,26071,2519,1021,247,179,34252,1214,1028,2242,4364,1933,2431,15739,124
17171,"Scott County, Illinois",5169,2523,2646,26918,3638,314,93,26,7,5120,270,122,392,747,351,396,2291,3
17017,"Cass County, Illinois",13068,6638,6430,25451,8835,874,266,67,15,12918,764,532,1296,1787,792,995,6057,51
17187,"Warren County, Illinois",17611,8488,9123,24840,11556,1811,432,112,180,17419,554,514,1068,2533,992,1541,8026,37
18069,"Huntington County, Indiana",36696,18039,18657,24222,24876,2867,1456,166,204,36221,2027,1765,3792,4227,1774,2453,17815,62
18091,"LaPorte County, Indiana",110993,57380,53613,25004,77055,8840,3474,797,441,102325,5315,5425,10740,17621,7190,10431,46551,408
18181,"White County, Indiana",24265,12061,12204,26275,16749,1730,788,84,25,24026,1192,1156,2348,2376,1050,1326,11143,91
18073,"Jasper County, Indiana",33461,16556,16905,24953,22198,2339,1018,242,73,33097,1359,1527,2886,2488,1097,1391,14857,77
18101,"Martin County, Indiana",10218,5114,5104,25138,7129,459,286,31,35,10108,572,554,1126,1228,514,714,4732,58
18145,"Shelby County, Indiana",44404,21912,22492,27317,30570,3210,1470,255,150,43707,2918,2455,5373,5446,2419,3027,21112,272
18137,"Ripley County, Indiana",28633,14138,14495,25385,19437,2300,903,118,69,28165,1304,980,2284,2834,1215,1619,13162,219
18153,"Sullivan County, Indiana",21026,11324,9702,22239,14929,1383,423,76,8,18919,1433,1170,2603,3265,1209,2056,8246,13
18159,"Tipton County, Indiana",15447,7611,7836,28507,10926,1462,774,46,19,15266,683,790,1473,1328,543,785,7193,74
18167,"Vigo County, Indiana",108099,54944,53155,22932,69166,9840,4523,757,910,103879,6385,5807,12192,20053,9234,10819,46367,426
18173,"Warrick County, Indiana",61427,30350,31077,33528,41847,7431,3066,800,420,60683,2493,1988,4481,5757,2331,3426,29449,259
18033,"DeKalb County, Indiana",42489,21142,21347,26057,28274,3272,1403,159,77,42126,2384,2403,4787,5387,2342,3045,19992,137
18005,"Bartholomew County, Indiana",80203,40059,40144,29955,54155,9685,5255,499,632,79360,4357,4128,8485,9975,4523,5452,38947,457
18139,"Rush County, Indiana",16873,8272,8601,23749,11605,1050,455,93,30,16686,1368,1044,2412,2981,1255,1726,7576,10
18049,"Fulton County, Indiana",20412,10089,10323,23557,14009,1291,583,39,9,20191,1276,1189,2465,2828,1307,1521,9094,134
18089,"Lake County, Indiana",489698,236906,252792,26590,325433,45298,17643,3398,1637,486138,30658,26744,57402,84905,36881,48024,209791,2322
18113,"Noble County, Indiana",47587,23839,23748,25260,31373,3078,1068,196,96,46783,2836,2700,5536,5320,2338,2982,21828,173
18001,"Adams County, Indiana",34813,17271,17542,21534,20942,2311,768,126,64,34366,3674,3695,7369,6140,2705,3435,14798,187
18041,"Fayette County, Indiana",23608,11644,11964,22428,16435,1208,409,118,20,23279,1621,1781,3402,4472,1856,2616,9377,71
18063,"Hendricks County, Indiana",155817,77782,78035,33031,102640,24094,9223,1387,903,153217,6130,5351,11481,7834,3015,4819,78171,441
18037,"Dubois County, Indiana",42345,21183,21162,28302,28562,4004,1362,163,106,41552,1486,1316,2802,3545,1560,1985,21761,28
18053,"Grant County, Indiana",68269,32725,35544,21024,44699,4580,2250,298,348,67374,4020,3848,7868,12183,5179,7004,28843,154
18059,"Hancock County, Indiana",71955,35160,36795,31428,48651,9387,3791,690,232,71323,3138,3022,6160,5274,2252,3022,35448,124
01077,"Lauderdale County, Alabama",92641,44261,48380,25803,63148,8196,4132,725,637,91796,5124,4991,10115,16538,6886,9652,38705,157
01085,"Lowndes County, Alabama",10565,5045,5520,18976,7165,679,162,20,19,10470,806,519,1325,3005,1380,1625,3390,25
01087,"Macon County, Alabama",19684,9072,10612,19564,12414,1369,793,175,151,19476,1282,816,2098,4442,1978,2464,7375,104
01083,"Limestone County, Alabama",90257,45146,45111,26685,62036,9700,3843,477,410,87228,5552,5361,10913,12290,5359,6931,37985,167
01117,"Shelby County, Alabama",205951,100098,105853,35330,139017,38107,14250,3520,1708,204231,9053,7633,16686,17227,7524,9703,101261,521
01133,"Winston County, Alabama",24013,11814,12199,20580,17274,1387,615,132,127,23694,1537,1515,3052,4833,1933,2900,8471,122
01043,"Cullman County, Alabama",81316,40200,41116,21857,56323,5435,2159,641,196,80496,5878,5826,11704,13718,6382,7336,31809,261
01051,"Elmore County, Alabama",80957,39347,41610,26251,54950,7600,3736,571,313,75952,3648,3017,6665,10893,4478,6415,32720,153
01071,"Jackson County, Alabama",52608,25763,26845,20946,37119,2929,1378,183,179,52100,3492,2731,6223,9780,4443,5337,20676,162
01121,"Talladega County, Alabama",81057,39342,41715,21382,55993,4519,2197,408,206,78252,4665,4023,8688,16119,6947,9172,30027,198
01129,"Washington County, Alabama",16909,8389,8520,23239,11524,710,321,77,1,16778,1011,1285,2296,3585,1497,2088,5536,39
01027,"Clay County, Alabama",13483,6532,6951,21330,9446,626,291,64,64,13214,914,791,1705,2195,909,1286,5382,28
01103,"Morgan County, Alabama",119555,58849,60706,25013,82033,11960,4384,853,382,117739,7737,7105,14842,19172,7992,11180,49680,244
01021,"Chilton County, Alabama",43817,21559,22258,23368,29735,2830,1243,236,108,43491,3405,3470,6875,8779,4051,4728,17304,287
01033,"Colbert County, Alabama",54377,26271,28106,23675,38271,4501,1990,353,225,53950,2608,2324,4932,8910,3715,5195,21628,101
21191,"Pendleton County, Kentucky",14509,7250,7259,23191,9959,697,259,57,12,14412,622,587,1209,2126,902,1224,6331,0
21201,"Robertson County, Kentucky",2191,1116,1075,21764,1587,182,58,29,0,2131,41,90,131,520,218,302,836,3
21207,"Russell County, Kentucky",17684,8652,9032,18857,12424,935,436,156,53,17539,1235,1243,2478,4606,2165,2441,6013,116
21215,"Spencer County, Kentucky",17798,8952,8846,30779,12177,1464,681,97,31,17674,621,507,1128,1782,730,1052,8667,106
21229,"Washington County, Kentucky",12017,5936,6081,22611,8016,532,514,127,15,11891,654,580,1234,2060,1010,1050,5395,43
21011,"Bath County, Kentucky",12113,6015,6098,20059,8115,689,196,73,24,12016,766,642,1408,2931,1265,1666,4432,48
21007,"Ballard County, Kentucky",8216,4081,4135,25063,5766,524,281,57,18,8091,442,384,826,1298,530,768,3373,58
21009,"Barren County, Kentucky",43287,21084,22203,20493,29416,2725,1368,356,119,42548,2401,2028,4429,9066,4045,5021,18335,186
21021,"Boyle County, Kentucky",29650,14774,14876,23822,19857,2346,1615,331,276,28338,1463,1109,2572,4381,2046,2335,12093,113
21087,"Green County, Kentucky",11123,5447,5676,23448,7916,439,299,48,33,11008,594,467,1061,2151,942,1209,4560,50
21091,"Hancock County, Kentucky",8716,4500,4216,22438,5849,448,184,37,20,8664,295,276,571,1481,706,775,3522,30
21095,"Harlan County, Kentucky",28031,13647,14384,15457,19405,1358,699,240,48,27553,1775,1554,3329,8857,4043,4814,7787,12
21159,"Martin County, Kentucky",12478,6922,5556,14914,8719,204,227,95,20,10973,686,650,1336,3538,1605,1933,2592,4
21093,"Hardin County, Kentucky",107573,53666,53907,26436,69718,9231,5929,995,312,102314,4399,4200,8599,14847,5781,9066,50052,494
21137,"Lincoln County, Kentucky",24424,11927,12497,19351,16801,1017,469,153,18,24200,1948,1503,3451,6049,2801,3248,8950,6
21149,"McLean County, Kentucky",9492,4693,4799,22884,6578,311,219,68,9,9408,493,429,922,1718,849,869,3883,0
21171,"Monroe County, Kentucky",10692,5325,5367,21985,7449,638,364,70,73,10524,594,594,1188,2749,1290,1459,3955,23
21183,"Ohio County, Kentucky",24152,11927,12225,21368,16448,859,467,188,113,23828,1123,979,2102,5003,2150,2853,9046,37
21197,"Powell County, Kentucky",12387,6073,6314,19302,8346,537,577,33,33,12146,532,546,1078,3115,1153,1962,4198,27
21233,"Webster County, Kentucky",13331,6597,6734,21150,9155,523,242,41,13,13017,666,615,1281,2615,1166,1449,5037,34
21033,"Caldwell County, Kentucky",12758,6123,6635,25272,8938,628,653,43,37,12636,788,433,1221,2647,1124,1523,5186,236
21045,"Casey County, Kentucky",15928,7854,8074,18319,11088,688,501,149,35,15593,1254,1022,2276,4114,1848,2266,5719,53
21047,"Christian County, Kentucky",73936,39157,34779,21393,41893,4284,2119,469,141,64581,4018,3719,7737,13719,5684,8035,30849,416
21085,"Grayson County, Kentucky",26092,13029,13063,19520,17649,965,540,240,47,25757,1651,1521,3172,6212,2969,3243,10504,89
21103,"Henry County, Kentucky",15528,7699,7829,23932,10635,740,353,55,50,15449,758,718,1476,2661,1212,1449,7049,63
21107,"Hopkins County, Kentucky",46359,22520,23839,23288,32189,2712,1646,394,99,45329,2339,2525,4864,7280,2976,4304,18831,250
21125,"Laurel County, Kentucky",59950,29173,30777,20446,40879,2971,1540,402,217,59217,3785,2819,6604,13475,5999,7476,21908,100
21157,"Marshall County, Kentucky",31213,15413,15800,27391,22645,2143,1117,265,85,30679,1189,1029,2218,3201,1574,1627,12759,217
21173,"Montgomery County, Kentucky",27391,13477,13914,21371,18505,1748,1034,201,84,27039,1940,1504,3444,6777,3164,3613,10773,18
21181,"Nicholas County, Kentucky",7062,3421,3641,21519,4881,218,169,42,84,6964,465,582,1047,1804,840,964,2776,6
21187,"Owen County, Kentucky",10673,5240,5433,22802,7315,543,229,54,0,10636,419,507,926,1858,970,888,3891,49
21209,"Scott County, Kentucky",51348,25446,25902,30702,33057,5762,2563,641,429,51090,2025,2222,4247,5309,2253,3056,25972,178
21227,"Warren County, Kentucky",121066,59236,61830,25840,73406,12826,6122,1293,1088,119751,6703,4833,11536,21838,9759,12079,56086,450
21017,"Bourbon County, Kentucky",20004,9772,10232,25994,13879,1588,585,183,112,19773,1324,1021,2345,3347,1278,2069,8933,113
21019,"Boyd County, Kentucky",48716,24164,24552,26420,34732,3985,1873,530,260,46608,2229,2401,4630,8795,3827,4968,18205,194
21055,"Crittenden County, Kentucky",9211,4652,4559,22765,6459,501,186,128,12,9012,689,654,1343,1909,875,1034,3516,46
21067,"Fayette County, Kentucky",311529,152953,158576,31653,200906,47372,22813,7174,5899,306358,16561,13213,29774,56444,25427,31017,156659,1405
21115,"Johnson County, Kentucky",23280,11432,11848,19925,16204,955,665,222,58,22846,1220,1049,2269,5964,2690,3274,6847,12
21165,"Menifee County, Kentucky",6345,3334,3011,19744,4586,341,178,15,28,6268,288,196,484,1495,660,835,2303,0
21175,"Morgan County, Kentucky",13379,7426,5953,17089,9853,671,362,111,33,11689,586,461,1047,2889,1317,1572,3579,38
21193,"Perry County, Kentucky",27818,13624,14194,19890,19511,1244,963,286,230,27171,1454,1509,2963,7394,3091,4303,8389,344
21199,"Pulaski County, Kentucky",63772,31166,32606,21036,44608,3881,1839,586,271,62980,3263,2555,5818,15643,7511,8132,24242,280
21051,"Clay County, Kentucky",21160,11267,9893,15388,14897,826,576,138,38,19533,1191,807,1998,7961,3907,4054,5579,58
21001,"Adair County, Kentucky",19156,9484,9672,18408,12753,1118,779,142,64,18870,1296,996,2292,4146,1862,2284,7895,56
09003,"Hartford County, Connecticut",895699,434485,461214,37817,619328,129822,71798,18356,8346,881190,29593,22280,51873,100830,45278,55552,433633,3193
09011,"New London County, Connecticut",272033,136190,135843,36881,188716,33597,20758,3781,3038,260184,8608,5519,14127,25645,11356,14289,138562,1055
09013,"Tolland County, Connecticut",151689,75894,75795,37830,95330,20999,11962,1956,2128,148651,3354,2654,6008,9223,4051,5172,76855,438
09001,"Fairfield County, Connecticut",941618,458490,483128,53433,636392,165089,95188,24779,9991,933085,51627,42169,93796,81553,35680,45873,458236,3128
12031,"Duval County, Florida",900890,436406,464484,28593,607088,116512,38607,10695,4713,881774,64578,57220,121798,146252,63691,82561,422137,4351
12007,"Bradford County, Florida",26919,14875,12044,19656,19390,1624,516,111,33,23658,2165,1582,3747,4559,2034,2525,9174,52
12019,"Clay County, Florida",200346,98575,101771,28599,134708,22683,7631,1077,856,197148,12699,10728,23427,20243,9039,11204,89297,778
12067,"Lafayette County, Florida",8742,5015,3727,21955,6120,459,228,139,7,7075,1007,605,1612,1272,475,797,2440,10
12089,"Nassau County, Florida",77187,38139,39048,33337,55772,8847,3545,789,498,76329,5699,4470,10169,9702,4517,5185,32698,435
12103,"Pinellas County, Florida",939548,450712,488836,32120,712289,137065,50013,14909,8216,928648,68422,59895,128317,130727,58630,72097,424109,5379
12111,"St. Lucie County, Florida",293136,142999,150137,24940,209615,26727,11378,2382,1084,290892,26144,23962,50106,51945,23897,28048,114204,2006
12051,"Hendry County, Florida",38376,20347,18029,18426,23888,1413,595,92,83,37310,6443,4659,11102,9776,4949,4827,15075,727
12061,"Indian River County, Florida",145342,69798,75544,33122,110018,18195,8145,2293,1256,144013,11509,11029,22538,20302,9032,11270,52662,486
12099,"Palm Beach County, Florida",1398757,676486,722271,36303,1013381,217583,83531,31005,14344,1386355,118884,102426,221310,191207,84888,106319,626367,6917
12109,"St. Johns County, Florida",218362,106007,112355,39563,153706,41875,16449,4271,2691,216749,10289,10246,20535,19372,8380,10992,98195,1045
12086,"Miami-Dade County, Florida",2664418,1292784,1371634,25481,1869613,325566,113739,49501,21255,2637220,314628,293876,608504,522143,231132,291011,1214352,10549
12035,"Flagler County, Florida",102917,49410,53507,25741,77355,11626,4854,1052,509,102553,7530,7360,14890,13453,6199,7254,37318,265
12037,"Franklin County, Florida",11705,6675,5030,23524,8952,929,410,84,75,9961,998,903,1901,2060,849,1211,4189,113
12047,"Hamilton County, Florida",14362,8377,5985,16109,9842,728,203,63,10,10989,767,671,1438,2963,1231,1732,3819,59
12077,"Liberty County, Florida",8285,5224,3061,16937,5633,427,175,32,68,6816,933,475,1408,1147,685,462,2721,85
12119,"Sumter County, Florida",113589,57426,56163,33168,101207,17417,9827,1525,1408,104298,4201,4266,8467,10343,4293,6050,22115,1550
12039,"Gadsden County, Florida",46153,21862,24291,19252,31799,3505,1510,194,350,43298,3910,2921,6831,11042,5225,5817,16179,349
12059,"Holmes County, Florida",19569,10463,9106,18402,13910,1154,414,119,29,17697,1712,1429,3141,4571,2102,2469,6337,73
12071,"Lee County, Florida",680970,333403,347567,30233,504918,85031,34434,9823,5613,675352,61210,52824,114034,104219,47107,57112,269491,5054
12083,"Marion County, Florida",340341,163611,176730,23598,252140,30446,11293,3255,1357,332116,27141,23394,50535,60266,27572,32694,115659,1155
12021,"Collier County, Florida",348236,171049,177187,41239,260789,51687,23756,8863,4052,346338,34539,29826,64365,45375,21364,24011,141497,2015
12093,"Okeechobee County, Florida",39420,21306,18114,18611,26976,1985,661,182,65,36352,4176,3246,7422,9105,4243,4862,13250,87
12101,"Pasco County, Florida",488310,237641,250669,26624,353206,52150,21306,3662,2297,482447,34478,30375,64853,65101,29029,36072,191024,2493
12055,"Highlands County, Florida",98862,48031,50831,23020,74900,7959,3043,735,598,97787,7913,6908,14821,18889,9099,9790,31002,224
12121,"Suwannee County, Florida",43653,21469,22184,21565,30818,2701,836,66,107,42163,3854,2859,6713,9536,4321,5215,15692,243
12027,"DeSoto County, Florida",35134,19905,15229,17892,24454,1705,564,128,58,33288,5764,2349,8113,9920,5551,4369,12343,89
12013,"Calhoun County, Florida",14550,7936,6614,15927,10376,858,212,13,4,12510,1096,1308,2404,1623,710,913,4541,66
12023,"Columbia County, Florida",68198,35318,32880,22855,46923,4526,2110,612,217,63440,4396,4772,9168,12229,5360,6869,24864,103
12029,"Dixie County, Florida",16084,8779,7305,19342,12021,574,138,44,13,14559,1361,1213,2574,3109,1376,1733,4793,68
12107,"Putnam County, Florida",72304,35711,36593,18950,50941,4228,1547,429,255,71140,7303,6375,13678,19120,8545,10575,24539,191
12125,"Union County, Florida",15159,9842,5317,13485,11038,607,180,26,26,9990,598,656,1254,2232,942,1290,3887,61
12081,"Manatee County, Florida",353411,170779,182632,30477,259773,44564,19621,4926,3298,350571,27940,24603,52543,50094,22134,27960,143025,1149
12075,"Levy County, Florida",39707,19555,20152,21043,28729,2060,791,162,194,39329,3882,3287,7169,8652,4186,4466,13825,107
12003,"Baker County, Florida",27312,14280,13032,22440,17878,1616,441,101,124,24749,1571,1517,3088,4522,1998,2524,10048,76
12127,"Volusia County, Florida",510806,248681,262125,25871,374690,55056,19826,5157,3951,505366,43379,34399,77778,83660,38111,45549,202379,2497
12073,"Leon County, Florida",284788,135482,149306,28548,165868,42196,20972,6262,5613,281370,15676,12985,28661,58148,27252,30896,139426,1000
12079,"Madison County, Florida",18560,9750,8810,17192,13207,968,539,45,78,16532,1494,1314,2808,4703,2119,2584,5816,153
27141,"Sherburne County, Minnesota",91188,46610,44578,33048,58467,11239,3413,647,321,89223,1962,1417,3379,6382,2824,3558,47808,338
27159,"Wadena County, Minnesota",13755,6809,6946,24200,9363,831,256,90,40,13463,549,322,871,2081,884,1197,5865,47
27009,"Benton County, Minnesota",39457,19736,19721,27018,26541,4242,1200,282,170,38941,1393,1050,2443,5220,2207,3013,20014,147
27019,"Carver County, Minnesota",97143,48209,48934,44212,62455,20403,6588,1079,686,96883,2039,1510,3549,3957,1722,2235,53082,245
27047,"Freeborn County, Minnesota",30751,15350,15401,27603,21874,2636,729,223,77,30285,1220,898,2118,3383,1350,2033,14874,172
27061,"Itasca County, Minnesota",45356,22906,22450,27497,32508,4900,1744,406,185,44565,2002,1666,3668,5886,2728,3158,19696,171
27085,"McLeod County, Minnesota",35926,17807,18119,30145,24697,3082,868,165,161,35630,1238,851,2089,2885,1245,1640,18957,73
27121,"Pope County, Minnesota",10975,5543,5432,32454,7948,1285,383,99,19,10797,361,195,556,1026,414,612,5312,32
27123,"Ramsey County, Minnesota",531528,258733,272795,32544,349954,86357,37119,10914,9099,527242,22584,16830,39414,82252,37771,44481,265788,1486
27149,"Stevens County, Minnesota",9762,4884,4878,31419,5718,1158,208,83,161,9676,186,153,339,1637,773,864,5044,20
27151,"Swift County, Minnesota",9483,4775,4708,29470,6679,891,192,44,29,9350,302,180,482,1155,405,750,4779,52
27169,"Winona County, Minnesota",51145,25238,25907,27200,31030,5943,2188,377,577,50619,2311,1360,3671,6539,3210,3329,27932,144
27033,"Cottonwood County, Minnesota",11557,5669,5888,27206,7932,1189,280,65,46,11361,400,205,605,1802,832,970,5266,53
27139,"Scott County, Minnesota",139490,69528,69962,38322,89060,25268,7452,1159,718,138005,3898,3176,7074,7905,3269,4636,74975,472
27039,"Dodge County, Minnesota",20361,10198,10163,31417,13190,2418,548,131,47,20221,622,402,1024,1341,591,750,10913,63
27157,"Wabasha County, Minnesota",21327,10627,10700,32307,15048,2204,725,155,112,21148,627,446,1073,1399,590,809,11132,71
27117,"Pipestone County, Minnesota",9285,4533,4752,28706,6313,970,178,87,22,9129,399,233,632,1155,481,674,4402,11
37011,"Avery County, North Carolina",17633,9639,7994,21704,13135,1526,804,179,92,15633,1556,1276,2832,2509,1366,1143,6396,33
37021,"Buncombe County, North Carolina",250112,120043,130069,29590,181217,40737,18313,4265,2964,246270,17314,14931,32245,35996,16154,19842,116999,421
37025,"Cabarrus County, North Carolina",192296,93508,98788,29143,126364,24764,8586,1603,1207,190935,10246,9791,20037,22324,9662,12662,90790,478
37033,"Caswell County, North Carolina",23094,11640,11454,21692,16896,1568,457,141,63,22234,1413,1448,2861,4888,2234,2654,8948,48
37059,"Davie County, North Carolina",41568,20263,21305,29234,29431,4498,1726,471,242,41188,3071,2296,5367,5735,2785,2950,18349,316
37057,"Davidson County, North Carolina",164058,80049,84009,24231,114042,15053,4507,759,429,162188,10580,9452,20032,26221,11446,14775,69950,456
37061,"Duplin County, North Carolina",59121,28969,30152,18529,39458,2844,953,148,104,58551,6633,5642,12275,16106,7313,8793,24059,264
37063,"Durham County, North Carolina",294618,140813,153805,33151,198989,50313,26268,7671,9130,289003,21741,18481,40222,48907,22191,26716,146585,1069
37091,"Hertford County, North Carolina",24285,11991,12294,18383,16827,1658,605,134,119,22165,1423,1481,2904,5217,2135,3082,8725,86
37105,"Lee County, North Carolina",59540,29003,30537,23613,39503,5692,2073,233,227,58347,4978,4441,9419,10673,4462,6211,25486,99
37129,"New Hanover County, North Carolina",216430,104029,112401,31708,146747,36940,12865,3352,2498,213925,14549,11882,26431,37167,16154,21013,104263,1058
37141,"Pender County, North Carolina",56358,28042,28316,25997,39475,5942,2289,533,357,54928,4368,3997,8365,10304,4441,5863,23313,132
37191,"Wayne County, North Carolina",124447,61002,63445,23163,81949,10571,3544,616,564,120095,8901,8620,17521,26475,11601,14874,51725,338
37165,"Scotland County, North Carolina",35711,17684,18027,17103,23654,2193,906,203,172,33796,2376,2181,4557,10480,4384,6096,11106,36
37189,"Watauga County, North Carolina",52745,26315,26430,24545,29439,6690,2942,540,1284,52442,2762,2710,5472,14797,7663,7134,22859,108
37083,"Halifax County, North Carolina",52849,25436,27413,20406,36756,3333,1261,179,151,51454,3741,2788,6529,13782,6341,7441,19092,139
37001,"Alamance County, North Carolina",156372,74352,82020,25157,105035,15755,5251,1205,973,155264,10606,11418,22024,28123,12060,16063,71314,607
37177,"Tyrrell County, North Carolina",4128,2325,1803,17736,3118,134,104,10,9,3582,312,290,602,905,382,523,1391,0
38089,"Stark County, North Dakota",29837,15538,14299,37978,19510,3456,899,173,290,29408,1526,1331,2857,1961,815,1146,16485,97
38103,"Wells County, North Dakota",4179,2083,2096,33580,3137,542,98,10,17,4099,130,117,247,214,92,122,2004,18
38013,"Burke County, North Dakota",2239,1208,1031,35674,1519,228,84,2,3,2235,135,107,242,265,101,164,1101,5
38061,"Mountrail County, North Dakota",9675,5241,4434,40113,6137,1134,228,51,38,9580,1053,799,1852,1122,538,584,4709,39
38105,"Williams County, North Dakota",31643,17360,14283,44474,20494,3409,793,247,164,31262,1443,1526,2969,3033,1670,1363,16686,78
38007,"Billings County, North Dakota",936,533,403,44683,687,130,20,6,15,936,42,39,81,103,46,57,510,4
38043,"Kidder County, North Dakota",2419,1284,1135,34455,1782,289,54,5,3,2417,146,54,200,170,79,91,1337,16
38019,"Cavalier County, North Dakota",3867,1957,1910,43144,2822,431,67,8,21,3772,103,58,161,198,62,136,1907,10
38037,"Grant County, North Dakota",2369,1176,1193,33537,1816,248,54,21,5,2325,98,89,187,315,140,175,1167,15
38049,"McHenry County, North Dakota",5912,3079,2833,36874,4101,701,123,16,11,5825,246,167,413,583,257,326,2928,21
38091,"Steele County, North Dakota",1969,1028,941,40479,1451,291,42,0,3,1969,49,48,97,119,59,60,992,3
38005,"Benson County, North Dakota",6802,3492,3310,21658,3861,423,126,10,20,6789,707,454,1161,2270,1106,1164,2384,21
38045,"LaMoure County, North Dakota",4111,2112,1999,36653,2952,518,121,15,11,4042,174,74,248,384,158,226,1995,9
38059,"Morton County, North Dakota",29633,15295,14338,37335,20665,3868,932,267,161,29084,864,759,1623,2521,1432,1089,16717,31
38025,"Dunn County, North Dakota",4284,2266,2018,42438,2957,463,104,33,5,4230,431,354,785,490,229,261,2025,25
38051,"McIntosh County, North Dakota",2737,1367,1370,31133,2123,299,59,30,0,2630,52,43,95,253,86,167,1367,0
38063,"Nelson County, North Dakota",3032,1525,1507,33599,2312,378,63,5,3,2950,101,98,199,253,103,150,1506,71
38079,"Rolette County, North Dakota",14607,7215,7392,18075,8240,1474,296,42,41,14484,2410,1815,4225,4523,2042,2481,5156,17
38099,"Walsh County, North Dakota",10995,5638,5357,30693,7686,946,228,74,37,10804,478,333,811,1134,496,638,5468,9
38009,"Bottineau County, North Dakota",6650,3488,3162,35698,4653,764,162,32,32,6482,219,228,447,569,237,332,3281,17
38003,"Barnes County, North Dakota",11033,5427,5606,32517,7712,1390,289,50,97,10838,512,221,733,1025,451,574,5703,35
38035,"Grand Forks County, North Dakota",69793,36093,33700,30465,40330,8827,2996,725,799,67702,2862,2297,5159,11507,5385,6122,38663,244
38053,"McKenzie County, North Dakota",10718,5610,5108,38324,6485,1185,307,66,36,10642,991,926,1917,1361,654,707,5197,60
38055,"McLean County, North Dakota",9576,4917,4659,36953,6972,998,233,31,12,9403,383,362,745,923,395,528,4536,23
38069,"Pierce County, North Dakota",4373,2216,2157,26619,3169,319,95,30,0,4188,278,129,407,766,305,461,2045,2
38075,"Renville County, North Dakota",2573,1282,1291,30888,1722,231,53,7,5,2496,62,62,124,169,66,103,1280,0
38011,"Bowman County, North Dakota",3238,1571,1667,36318,2215,361,109,13,3,3176,113,115,228,242,88,154,1669,12
38015,"Burleigh County, North Dakota",90560,45126,45434,36483,60830,14754,4023,1230,813,88605,3243,2828,6071,6745,2983,3762,49723,137
38047,"Logan County, North Dakota",1939,986,953,31952,1456,176,21,0,4,1863,50,33,83,130,54,76,980,5
38065,"Oliver County, North Dakota",1768,931,837,38604,1282,176,24,19,4,1768,120,83,203,72,27,45,886,13
38093,"Stutsman County, North Dakota",21108,10801,10307,31182,14564,2869,494,151,59,20195,958,684,1642,2108,914,1194,10776,123
38071,"Ramsey County, North Dakota",11578,5891,5687,33884,7948,1305,246,124,64,11069,566,513,1079,1217,587,630,6218,100
38031,"Foster County, North Dakota",3345,1663,1682,32665,2390,404,98,3,12,3275,140,104,244,306,115,191,1731,12
38039,"Griggs County, North Dakota",2311,1165,1146,33416,1732,315,27,0,9,2214,71,81,152,161,75,86,1197,0
38083,"Sheridan County, North Dakota",1395,707,688,34172,1088,124,38,6,0,1395,54,42,96,235,79,156,613,0
38087,"Slope County, North Dakota",665,361,304,35118,508,132,14,3,0,665,33,18,51,67,35,32,320,3
39159,"Union County, Ohio",53955,25813,28142,33066,35863,7181,2353,544,355,50780,1825,1405,3230,3965,1777,2188,25432,44
39131,"Pike County, Ohio",28298,14069,14229,21983,19226,1333,883,99,45,27938,2089,1147,3236,5735,2714,3021,9818,22
39125,"Paulding County, Ohio",19057,9493,9564,24319,13115,1101,527,56,27,18955,799,713,1512,2083,1010,1073,8743,81
01025,"Clarke County, Alabama",24847,11738,13109,20765,17022,1317,551,110,88,24561,1539,1716,3255,6023,2517,3506,8011,211
01101,"Montgomery County, Alabama",227392,107740,119652,26712,150072,28639,13291,3287,1995,222470,14598,12332,26930,46982,20176,26806,100032,518
01067,"Henry County, Alabama",17187,8301,8886,23983,12221,1102,722,120,29,16936,1072,868,1940,2586,1203,1383,6958,221
01123,"Tallapoosa County, Alabama",40958,19395,21563,22430,28910,3372,1189,326,119,40412,2147,2191,4338,9431,3812,5619,14904,91
02016,"Aleutians West Census Area, Alaska",5714,3578,2136,35998,4153,479,147,10,16,5544,716,465,1181,426,246,180,4110,113
02188,"Northwest Arctic Borough, Alaska",7723,4181,3542,21879,4042,301,93,14,27,7696,1455,942,2397,1874,980,894,2472,490
02220,"Sitka City and Borough, Alaska",8921,4564,4357,36617,6296,1148,603,154,132,8762,933,697,1630,796,394,402,4682,115
02130,"Ketchikan Gateway Borough, Alaska",13715,7038,6677,33771,9428,1469,504,179,89,13404,1166,909,2075,1453,685,768,6774,133
02070,"Dillingham Census Area, Alaska",4980,2564,2416,24647,2824,307,133,33,23,4962,785,497,1282,815,404,411,1891,241
02110,"Juneau City and Borough, Alaska",32524,16648,15876,41904,22288,5631,2266,577,315,31933,2103,1814,3917,2365,1157,1208,17589,183
02290,"Yukon-Koyukuk Census Area, Alaska",5600,3026,2574,21057,3541,274,147,3,10,5570,1152,814,1966,1304,688,616,2024,367
02068,"Denali Borough, Alaska",2125,1142,983,33084,1503,449,99,18,13,2085,251,233,484,233,117,116,1321,17
02105,"Hoonah-Angoon Census Area, Alaska",2107,1084,1023,33704,1579,260,88,28,7,2102,258,288,546,260,109,151,1017,56
02275,"Wrangell City and Borough, Alaska",2401,1218,1183,29943,1767,247,102,6,3,2383,224,208,432,237,120,117,1033,36
04019,"Pima County, Arizona",1003338,493568,509770,27323,662883,117924,58810,14222,13216,984069,65235,55785,121020,186299,86015,100284,423598,5638
04009,"Graham County, Arizona",37529,20148,17381,17874,22996,1863,944,171,86,33491,2125,1675,3800,7419,3352,4067,11566,119
04003,"Cochise County, Arizona",128177,65281,62896,24896,88171,13036,5886,853,648,115890,5744,5910,11654,22184,9444,12740,46332,570
04001,"Apache County, Arizona",72346,35740,36606,13865,43657,3129,1416,145,138,71536,9038,7840,16878,25658,12634,13024,18056,127
04027,"Yuma County, Arizona",203292,104216,99076,20600,126271,11922,4789,1020,435,195819,18921,16253,35174,40330,18268,22062,74388,531
04017,"Navajo County, Arizona",108209,54271,53938,17685,68065,5990,2975,502,397,105980,9716,8044,17760,31575,14551,17024,31629,601
05021,"Clay County, Arkansas",15202,7490,7712,19171,10812,775,354,67,31,15070,947,838,1785,3340,1513,1827,6174,49
05043,"Drew County, Arkansas",18688,9034,9654,20300,11575,1572,571,55,99,18289,1415,911,2326,4851,2222,2629,7279,31
05121,"Randolph County, Arkansas",17584,8679,8905,20932,12276,1059,510,52,58,17241,1366,1005,2371,3357,1673,1684,6775,72
05009,"Boone County, Arkansas",37301,18285,19016,22288,26136,2542,1067,122,181,36886,2380,1843,4223,6409,2798,3611,14916,148
21077,"Gallatin County, Kentucky",8543,4288,4255,22508,5618,407,116,22,15,8434,480,461,941,1131,549,582,3551,26
22115,"Vernon Parish, Louisiana",52101,27428,24673,22583,31138,3973,1207,234,120,46796,3012,2430,5442,7286,3272,4014,22200,262
22085,"Sabine Parish, Louisiana",24144,12018,12126,22980,16392,1464,609,137,61,23745,2019,1782,3801,4612,1886,2726,8226,243
22053,"Jefferson Davis Parish, Louisiana",31399,15351,16048,23068,20659,1922,898,156,29,30881,1627,2038,3665,6020,2503,3517,12562,407
22125,"West Feliciana Parish, Louisiana",15384,9325,6059,23041,10595,1497,639,121,125,12343,622,770,1392,1923,765,1158,5099,10
22013,"Bienville Parish, Louisiana",13924,6712,7212,22701,9597,803,359,34,48,13598,1081,1012,2093,3406,1304,2102,5104,43
22023,"Cameron Parish, Louisiana",6739,3290,3449,29681,4554,572,175,16,8,6708,345,303,648,601,303,298,3219,84
22075,"Plaquemines Parish, Louisiana",23584,11585,11999,26177,15232,1694,578,88,48,22726,1553,1239,2792,3990,1491,2499,10462,154
22117,"Washington Parish, Louisiana",46367,22871,23496,18345,31312,2548,927,149,109,44576,3465,3721,7186,11756,5345,6411,15433,245
22001,"Acadia Parish, Louisiana",62372,30297,32075,21591,40069,3196,913,244,103,61470,4391,5209,9600,12579,4626,7953,24452,527
22103,"St. Tammany Parish, Louisiana",246269,119732,126537,33149,166729,34080,11518,4415,2151,243764,14481,13871,28352,27094,11561,15533,110944,1799
22017,"Caddo Parish, Louisiana",253125,120312,132813,25565,167830,25065,9788,3213,1879,248535,17690,18272,35962,55675,23867,31808,106110,776
22005,"Ascension Parish, Louisiana",117009,58083,58926,31520,74802,14164,4406,934,397,116152,6421,5533,11954,13320,5101,8219,55612,304
22045,"Iberia Parish, Louisiana",73799,36031,37768,23410,47452,4590,1285,366,281,72994,5613,5540,11153,14437,6001,8436,30547,431
22091,"St. Helena Parish, Louisiana",10714,5205,5509,21148,7183,370,282,84,25,10582,1251,934,2185,2895,1303,1592,3565,58
22031,"De Soto Parish, Louisiana",27047,13053,13994,23471,18273,1769,534,125,32,26871,1737,1815,3552,7097,3186,3911,10523,31
22063,"Livingston Parish, Louisiana",135925,66559,69366,27280,88415,11335,3038,539,472,134939,9414,8837,18251,19472,7831,11641,60383,432
22069,"Natchitoches Parish, Louisiana",39258,18654,20604,18219,23294,2588,1337,196,246,38546,2867,3285,6152,11401,4965,6436,13587,378
22025,"Catahoula Parish, Louisiana",10145,5415,4730,20717,6894,705,155,27,16,9190,1064,1162,2226,1875,810,1065,3592,47
22041,"Franklin Parish, Louisiana",20464,9963,10501,18786,13515,1084,466,29,28,19093,1889,1868,3757,6017,2431,3586,6801,170
22049,"Jackson Parish, Louisiana",15999,8165,7834,20109,11210,988,376,95,71,14833,1066,913,1979,4035,1783,2252,5279,88
22089,"St. Charles Parish, Louisiana",52708,25783,26925,30378,34706,5320,1623,104,122,52063,3453,3217,6670,6522,2638,3884,24021,309
22107,"Tensas Parish, Louisiana",4793,2335,2458,16194,3259,218,67,0,11,4774,772,571,1343,1615,773,842,1658,25
23017,"Oxford County, Maine",57299,28391,28908,22862,41822,4971,2149,309,162,56958,3301,2990,6291,9447,4072,5375,24346,80
05041,"Desha County, Arkansas",12234,5608,6626,18187,8010,726,299,15,16,12164,607,796,1403,3859,1537,2322,4375,82
05051,"Garland County, Arkansas",97119,46875,50244,25690,69592,9123,3757,820,652,95872,7547,6555,14102,19639,9032,10607,39036,158
05115,"Pope County, Arkansas",63107,31051,32056,21650,39650,5435,2225,433,366,62447,3669,3637,7306,11620,5418,6202,26984,366
05147,"Woodruff County, Arkansas",6873,3266,3607,19987,4845,395,87,7,6,6752,629,471,1100,1622,689,933,2435,21
05067,"Jackson County, Arkansas",17495,8579,8916,19458,12561,766,290,22,8,14277,1166,794,1960,3866,1818,2048,5362,42
05137,"Stone County, Arkansas",12503,6341,6162,19881,9144,727,395,199,0,12400,748,701,1449,2925,1318,1607,4257,107
05005,"Baxter County, Arkansas",40992,19848,21144,24737,31435,3869,1257,321,129,40535,2156,1579,3735,5600,2766,2834,15045,112
05055,"Greene County, Arkansas",43745,21558,22187,22094,29009,3262,1165,211,132,43269,2703,2420,5123,7621,3235,4386,17837,208
05107,"Phillips County, Arkansas",19929,9353,10576,17287,12645,891,400,102,82,19754,1646,1403,3049,6588,2909,3679,6564,81
05149,"Yell County, Arkansas",21716,10731,10985,20209,14543,1482,483,90,36,21406,1560,1133,2693,3738,1539,2199,8623,150
55011,"Buffalo County, Wisconsin",13256,6743,6513,28286,9515,1176,421,67,67,13174,532,352,884,1424,700,724,6725,71
55063,"La Crosse County, Wisconsin",117538,57392,60146,29495,74268,14950,6097,1625,1443,116220,3826,3061,6887,16675,6934,9741,61584,307
55073,"Marathon County, Wisconsin",135367,68051,67316,30151,92748,15028,5137,1552,486,134265,5568,3750,9318,14825,6724,8101,69291,376
55121,"Trempealeau County, Wisconsin",29521,14895,14626,26654,20199,2766,930,102,91,29108,1428,952,2380,2804,1139,1665,15027,143
55027,"Dodge County, Wisconsin",88404,46157,42247,27000,63022,7213,2209,570,252,83817,2374,1852,4226,7384,3180,4204,42945,242
55125,"Vilas County, Wisconsin",21373,10705,10668,29058,16560,2919,1083,273,165,21203,1186,694,1880,3098,1305,1793,8808,39
55071,"Manitowoc County, Wisconsin",80178,39917,40261,27777,57053,8090,2513,468,145,79660,2235,1733,3968,8143,3470,4673,40489,234
55013,"Burnett County, Wisconsin",15259,7803,7456,26308,11609,1497,520,75,58,15122,674,471,1145,2402,1159,1243,6342,50
55029,"Door County, Wisconsin",27669,13651,14018,34253,21443,4319,1724,402,272,27328,842,544,1386,2451,1145,1306,12917,84
55039,"Fond du Lac County, Wisconsin",101968,49884,52084,29431,70475,10721,3698,544,488,100278,3134,2662,5796,8497,3753,4744,51680,201
55091,"Pepin County, Wisconsin",7349,3716,3633,27901,5222,672,209,55,22,7241,315,318,633,965,445,520,3633,29
55103,"Richland County, Wisconsin",17642,8912,8730,24941,12308,1405,580,122,89,17504,877,615,1492,2373,1160,1213,8248,42
55137,"Waushara County, Wisconsin",24238,12720,11518,25838,18131,1782,784,108,61,23049,1153,902,2055,2646,1200,1446,10161,142
55065,"Lafayette County, Wisconsin",16793,8531,8262,27023,11340,1388,492,91,32,16698,845,728,1573,1863,845,1018,8584,63
55093,"Pierce County, Wisconsin",40881,20328,20553,31109,25571,4871,1769,227,246,40616,1379,1144,2523,4572,2019,2553,22469,83
55015,"Calumet County, Wisconsin",49653,24933,24720,32713,33227,7245,1830,303,159,49472,1021,696,1717,3129,1201,1928,26892,45
55059,"Kenosha County, Wisconsin",167896,82941,84955,28996,110495,17855,7327,1119,932,165962,8392,5993,14385,24708,11099,13609,80015,589
56019,"Johnson County, Wyoming",8572,4546,4026,32732,6052,1013,356,98,74,8521,653,534,1187,499,325,174,4168,89
56021,"Laramie County, Wyoming",96459,48755,47704,31554,64359,11375,4394,1150,878,93453,5058,4715,9773,9812,4125,5687,47876,616
56039,"Teton County, Wyoming",22623,11742,10881,49200,16920,6500,1987,391,223,22571,2224,1089,3313,1650,932,718,14008,250
48407,"San Jacinto County, Texas",27172,13260,13912,22308,18970,1405,342,82,69,27028,2405,2914,5319,4627,1772,2855,10256,229
48459,"Upshur County, Texas",40295,19908,20387,24088,27110,3047,1034,117,81,39765,3398,3367,6765,5367,2324,3043,16120,116
48473,"Waller County, Texas",47049,23520,23529,23888,25346,3423,1054,155,119,46796,4868,4956,9824,7986,3665,4321,19888,240
48493,"Wilson County, Texas",46444,23309,23135,29862,31068,4070,1509,167,249,45772,3288,3102,6390,4795,2096,2699,20516,80
48219,"Hockley County, Texas",23377,11525,11852,22673,14277,1504,450,86,60,23206,2396,2289,4685,3540,1473,2067,10304,50
48329,"Midland County, Texas",155817,77923,77894,38545,96774,18152,5134,1513,583,154621,15284,15245,30529,12148,4801,7347,77875,1073
48299,"Llano County, Texas",19624,9518,10106,35680,15551,2906,852,216,165,19372,1680,1777,3457,2672,1190,1482,7056,74
48147,"Fannin County, Texas",33757,17824,15933,23212,23710,2294,1070,71,271,30825,2841,2572,5413,5078,2474,2604,12875,124
48041,"Brazos County, Texas",209896,106391,103505,25337,107109,22975,11353,2392,5885,206103,15578,13464,29042,52652,25257,27395,98853,649
48165,"Gaines County, Texas",19485,9940,9545,22656,10771,770,302,44,12,19371,3188,3135,6323,2076,1073,1003,7923,23
48179,"Gray County, Texas",23028,12142,10886,23457,15367,1557,412,75,43,21442,1942,2093,4035,3359,1415,1944,9179,106
18067,"Howard County, Indiana",82728,40000,42728,26294,57226,7218,3142,636,191,81791,4216,4501,8717,13665,6198,7467,35578,467
21025,"Breathitt County, Kentucky",13476,6742,6734,16875,9401,565,455,116,11,13331,828,568,1396,4411,2051,2360,4001,182
21083,"Graves County, Kentucky",37379,18309,19070,22112,25331,2613,1255,254,135,36958,2077,1873,3950,6758,2999,3759,15196,181
21099,"Hart County, Kentucky",18510,9146,9364,19715,12537,812,544,71,4,18251,1415,1214,2629,4398,1988,2410,6805,109
21031,"Butler County, Kentucky",12828,6440,6388,21787,8995,484,352,51,48,12614,725,615,1340,3080,1375,1705,5111,92
21223,"Trimble County, Kentucky",8751,4338,4413,26542,6017,418,230,50,1,8739,662,489,1151,1539,751,788,3593,29
21097,"Harrison County, Kentucky",18629,9133,9496,22497,12805,1321,424,224,9,18420,1375,1060,2435,3476,1464,2012,7663,84
21105,"Hickman County, Kentucky",4691,2195,2496,19764,3304,135,83,32,40,4512,337,214,551,753,333,420,1697,19
21143,"Lyon County, Kentucky",8325,4643,3682,27098,6584,634,344,125,50,6962,364,260,624,1030,391,639,2721,26
21231,"Wayne County, Kentucky",20557,10227,10330,17627,14517,695,454,201,0,20268,1308,1027,2335,5138,2394,2744,6513,24
21135,"Lewis County, Kentucky",13646,6781,6865,19346,9500,579,409,78,34,13500,782,849,1631,3773,1720,2053,4361,88
21221,"Trigg County, Kentucky",14267,6993,7274,26224,10224,1040,683,63,55,14207,949,920,1869,2262,845,1417,5557,58
21239,"Woodford County, Kentucky",25591,12297,13294,31208,17668,3498,1391,489,253,25463,1198,834,2032,3636,1419,2217,12727,68
21131,"Leslie County, Kentucky",10869,5379,5490,15112,7658,456,177,76,33,10609,509,611,1120,3435,1589,1846,2508,8
21113,"Jessamine County, Kentucky",51015,24991,26024,28195,33007,5358,2775,762,572,50432,2631,2148,4779,9139,4008,5131,22840,103
21127,"Lawrence County, Kentucky",15870,7924,7946,18885,10899,621,512,94,21,15760,762,944,1706,3519,1514,2005,4887,170
21139,"Livingston County, Kentucky",9353,4637,4716,24464,6815,362,258,16,48,9293,341,264,605,1282,456,826,3855,17
21145,"McCracken County, Kentucky",65292,31043,34249,29881,46026,6390,2948,890,324,64129,3051,2601,5652,11342,4957,6385,28667,346
21211,"Shelby County, Kentucky",44967,21723,23244,30240,30362,4249,2311,438,243,43702,2743,2075,4818,5600,2842,2758,21050,165
21235,"Whitley County, Kentucky",35842,17637,18205,18463,22896,2341,1258,324,164,35232,2191,1585,3776,9191,4006,5185,12177,58
27035,"Crow Wing County, Minnesota",63321,31646,31675,30013,44683,7091,2648,687,383,62588,2527,1696,4223,6531,2970,3561,29319,181
27107,"Norman County, Minnesota",6638,3332,3306,27099,4652,606,87,21,15,6512,311,169,480,761,328,433,3033,15
27171,"Wright County, Minnesota",129922,65372,64550,32506,83193,16515,4207,913,628,129131,3095,2389,5484,7150,3149,4001,68539,713
27103,"Nicollet County, Minnesota",33226,16586,16640,29722,21497,4749,1319,330,537,33042,571,577,1148,3655,1859,1796,18073,41
27041,"Douglas County, Minnesota",36862,18388,18474,33336,26249,4839,1166,345,227,36463,961,760,1721,3141,1557,1584,18785,124
27051,"Grant County, Minnesota",5943,2972,2971,30359,4249,639,139,36,18,5890,160,166,326,676,254,422,2839,18
27079,"Le Sueur County, Minnesota",27650,14005,13645,31135,18871,2871,854,134,173,27480,790,657,1447,2339,1108,1231,14421,36
27025,"Chisago County, Minnesota",54041,27920,26121,32105,37112,5677,1875,422,202,52676,1716,1259,2975,3137,1417,1720,27057,200
27127,"Redwood County, Minnesota",15578,7830,7748,27543,10614,1447,330,74,43,15308,669,578,1247,1767,863,904,7487,44
27153,"Todd County, Minnesota",24335,12419,11916,24988,16589,1845,550,118,34,24150,1399,1266,2665,3253,1509,1744,11276,162
27007,"Beltrami County, Minnesota",45644,22773,22871,23748,27550,4834,1607,407,535,45130,2866,2272,5138,8247,3999,4248,20187,79
27055,"Houston County, Minnesota",18791,9390,9401,30150,13394,2177,587,129,129,18574,532,367,899,1910,886,1024,9773,126
27073,"Lac qui Parle County, Minnesota",6916,3453,3463,31427,5066,697,148,66,18,6791,182,115,297,574,230,344,3412,12
27111,"Otter Tail County, Minnesota",57694,28994,28700,29932,41119,6942,2060,532,358,56992,1975,1431,3406,5497,2493,3004,27337,201
27161,"Waseca County, Minnesota",19034,8996,10038,27383,13163,1962,509,58,85,17873,420,496,916,1387,666,721,9330,90
27003,"Anoka County, Minnesota",341249,170762,170487,34321,229933,46259,14593,2448,1600,338996,9954,7868,17822,24864,11326,13538,181815,834
27145,"Stearns County, Minnesota",153661,77355,76306,29148,94448,16838,5030,1535,1105,152512,4492,3218,7710,19983,9497,10486,81841,405
27081,"Lincoln County, Minnesota",5793,2914,2879,28382,4122,627,107,22,22,5628,208,159,367,652,268,384,2827,9
27083,"Lyon County, Minnesota",25670,12840,12830,30203,16448,3197,795,170,242,25371,1042,619,1661,3396,1418,1978,13701,30
27095,"Mille Lacs County, Minnesota",25788,12944,12844,25732,17729,1889,707,81,92,25325,1003,794,1797,2970,1223,1747,11736,151
27163,"Washington County, Minnesota",248745,123093,125652,41591,166376,45894,17006,4394,3085,245438,5767,4233,10000,12496,5236,7260,130048,497
27017,"Carlton County, Minnesota",35482,18491,16991,26900,24670,4034,1101,163,126,34644,1110,759,1869,4507,2389,2118,16626,89
27065,"Kanabec County, Minnesota",15918,8062,7856,26345,11255,937,439,126,46,15783,577,393,970,2130,995,1135,7225,90
30071,"Phillips County, Montana",4150,2086,2064,22369,2927,400,98,11,0,4109,494,371,865,664,296,368,1650,16
31009,"Blaine County, Nebraska",580,308,272,28503,391,64,17,12,5,580,68,45,113,94,54,40,290,9
31049,"Deuel County, Nebraska",1932,944,988,28225,1408,168,68,12,3,1912,166,116,282,198,62,136,1025,50
31113,"Logan County, Nebraska",830,417,413,24624,549,101,9,4,0,830,59,37,96,95,41,54,422,0
31169,"Thayer County, Nebraska",5163,2558,2605,31129,3742,538,144,15,36,5013,152,132,284,603,288,315,2442,4
31001,"Adams County, Nebraska",31536,16007,15529,28085,20312,2944,1258,224,157,31257,1766,1184,2950,3314,1410,1904,15523,73
31011,"Boone County, Nebraska",5353,2693,2660,28861,3705,449,162,15,28,5254,172,170,342,394,149,245,2751,14
31149,"Rock County, Nebraska",1407,688,719,33867,1047,153,24,4,2,1371,91,115,206,141,44,97,775,2
31163,"Sherman County, Nebraska",3090,1522,1568,27983,2245,236,108,12,0,3031,138,95,233,402,125,277,1509,0
31093,"Howard County, Nebraska",6365,3232,3133,26734,4457,715,138,43,9,6351,192,132,324,603,285,318,3245,29
31073,"Gosper County, Nebraska",1977,944,1033,31901,1392,222,55,12,2,1940,91,70,161,112,38,74,1088,11
31153,"Sarpy County, Nebraska",172460,86211,86249,33103,108936,27425,11557,1849,983,168330,5308,4737,10045,10597,4669,5928,92198,659
31015,"Boyd County, Nebraska",2006,1024,982,26413,1464,226,49,5,7,1979,128,96,224,246,109,137,977,5
31059,"Fillmore County, Nebraska",5676,2834,2842,30874,4097,572,174,17,36,5442,286,220,506,551,183,368,2851,25
31091,"Hooker County, Nebraska",669,316,353,27714,541,95,33,0,0,643,18,31,49,104,56,48,305,9
31159,"Seward County, Nebraska",17113,8696,8417,29398,10867,1969,648,158,179,16833,593,412,1005,1413,732,681,8475,25
31181,"Webster County, Nebraska",3665,1784,1881,26136,2586,350,161,22,4,3583,169,210,379,367,166,201,1663,2
31023,"Butler County, Nebraska",8205,4126,4079,27216,5663,722,215,40,11,8035,344,303,647,697,324,373,4088,33
31005,"Arthur County, Nebraska",437,210,227,21799,280,61,12,1,1,437,17,29,46,35,17,18,174,0
39061,"Hamilton County, Ohio",805965,387906,418059,32638,539750,116797,52669,13852,8809,798045,38396,27997,66393,140334,62937,77397,381996,2318
39049,"Franklin County, Ohio",1232118,600802,631316,31199,812175,197863,78418,20498,14714,1224220,70109,54787,124896,205186,93858,111328,619892,4860
39101,"Marion County, Ohio",65620,35004,30616,22579,46162,3558,1727,320,71,59587,2779,2170,4949,10299,4572,5727,25325,239
39157,"Tuscarawas County, Ohio",92579,45527,47052,25054,64053,6528,2573,325,169,91621,5493,4618,10111,12379,5626,6753,42142,310
39169,"Wayne County, Ohio",115747,57359,58388,25762,75672,10057,4503,890,795,114650,7855,7018,14873,14207,6067,8140,53984,601
39015,"Brown County, Ohio",44059,21855,22204,24525,30392,2607,976,96,101,43513,2692,1740,4432,7179,2962,4217,18689,125
39017,"Butler County, Ohio",373638,183146,190492,29745,237812,44722,18748,2431,3384,370330,15749,13238,28987,49134,21035,28099,175014,987
39067,"Harrison County, Ohio",15521,7678,7843,22965,11153,719,276,49,34,15265,747,819,1566,2756,1188,1568,6585,44
39083,"Knox County, Ohio",60878,29853,31025,24523,39526,5796,1879,267,711,60294,3404,3178,6582,8958,3992,4966,27285,279
39089,"Licking County, Ohio",169762,83232,86530,29093,113951,17279,6703,1465,1137,168423,7321,6454,13775,20814,8913,11901,80941,710
39139,"Richland County, Ohio",121888,61816,60072,23439,84981,9388,3554,675,316,115234,5876,5637,11513,18849,8280,10569,49371,264
39163,"Vinton County, Ohio",13128,6617,6511,19876,9018,557,235,40,30,13053,749,552,1301,2767,1105,1662,5111,12
39019,"Carroll County, Ohio",28108,14029,14079,26908,20017,1403,614,122,148,27828,1821,1410,3231,3873,1748,2125,12217,24
39063,"Hancock County, Ohio",75672,37160,38512,29608,51192,8523,3728,541,435,74856,2800,2548,5348,9877,4320,5557,36599,156
39025,"Clermont County, Ohio",201092,99198,101894,31812,136065,25022,10064,1617,876,199788,7931,6753,14684,20968,9214,11754,96917,508
39045,"Fairfield County, Ohio",150163,74713,75450,29582,100589,18030,6770,1135,631,147508,5527,4260,9787,15010,6532,8478,68717,300
39039,"Defiance County, Ohio",38488,19165,19323,26941,25881,2717,1104,139,117,38187,1943,1526,3469,5129,2258,2871,17912,72
39071,"Highland County, Ohio",43109,21245,21864,22079,29250,2043,1097,208,163,42690,2603,2239,4842,8822,3930,4892,16838,107
39069,"Henry County, Ohio",27890,13745,14145,27325,19062,1956,905,118,78,27492,1042,730,1772,2783,1150,1633,13193,80
39081,"Jefferson County, Ohio",67607,32771,34836,24028,47810,4770,1840,391,376,66863,2922,2465,5387,11208,4766,6442,27043,223
39133,"Portage County, Ohio",161796,79194,82602,27985,103493,17432,8208,982,1611,160730,6350,5680,12030,23293,9606,13687,78982,372
39137,"Putnam County, Ohio",34116,17025,17091,28568,22548,2711,1501,89,71,33851,632,722,1354,2648,1110,1538,17278,45
39013,"Belmont County, Ohio",69228,35300,33928,25326,50793,5304,2509,291,230,65433,3002,2560,5562,9839,4330,5509,29044,292
39027,"Clinton County, Ohio",41854,20761,21093,25238,27753,3012,1216,189,160,41537,2056,1504,3560,6169,2804,3365,18401,153
39047,"Fayette County, Ohio",28719,14101,14618,24013,19699,2199,524,89,46,28258,1581,1279,2860,5207,2433,2774,12224,37
39127,"Perry County, Ohio",35947,17953,17994,21557,24171,1978,752,109,52,35690,1713,1766,3479,7322,3262,4060,14079,59
39129,"Pickaway County, Ohio",56804,30071,26733,25460,38985,4337,1983,304,123,52461,2242,1733,3975,6324,2993,3331,24327,137
39097,"Madison County, Ohio",43537,23807,19730,27798,30727,3587,1115,204,118,38607,2032,1199,3231,4061,1850,2211,18011,152
39119,"Muskingum County, Ohio",85991,41858,44133,22877,58097,5687,2494,430,142,85127,4161,3294,7455,14564,6566,7998,37262,147
39143,"Sandusky County, Ohio",59870,29557,30313,25219,41173,4135,1606,245,114,59009,1971,2122,4093,7757,3292,4465,27814,119
39161,"Van Wert County, Ohio",28501,13966,14535,26130,19492,2019,1110,152,64,28221,1297,1004,2301,3449,1495,1954,13096,202
39167,"Washington County, Ohio",61154,30212,30942,26608,43337,5362,1927,328,361,60468,2941,2279,5220,9275,4258,5017,26256,168
39011,"Auglaize County, Ohio",45871,22865,23006,28340,30993,3633,1525,239,111,45361,1259,1235,2494,3973,1489,2484,22748,213
39037,"Darke County, Ohio",52185,25632,26553,24768,35498,2991,1463,128,66,51572,2143,1811,3954,6344,2775,3569,23683,156
39123,"Ottawa County, Ohio",40981,20201,20780,31574,30239,4008,1836,404,193,40574,1393,1438,2831,4464,1838,2626,18944,108
39065,"Hardin County, Ohio",31652,15787,15865,21099,19340,1565,942,123,155,31452,1584,1751,3335,4574,2238,2336,13545,159
39079,"Jackson County, Ohio",32717,15979,16738,21730,22233,2550,1110,82,11,32385,1762,1396,3158,7409,3225,4184,12832,61
39077,"Huron County, Ohio",58704,29041,29663,24193,39230,3527,1435,253,73,58184,3100,2332,5432,7467,3382,4085,26659,145
39009,"Athens County, Ohio",65103,32492,32611,20062,35638,4949,3510,395,1526,64403,2778,2148,4926,17301,8629,8672,26482,63
39001,"Adams County, Ohio",28111,13972,14139,20248,19106,1277,640,124,39,27848,1956,1570,3526,6770,2831,3939,10050,118
39103,"Medina County, Ohio",175543,86786,88757,34174,120879,25845,9471,1781,926,174446,5626,4694,10320,11532,5001,6531,88642,555
39095,"Lucas County, Ohio",434800,211033,223767,27111,290221,44900,19428,5199,3290,429550,21367,15323,36690,87717,40787,46930,192054,1514
39121,"Noble County, Ohio",14429,8821,5608,23119,10719,585,386,21,21,11845,480,373,853,1409,656,753,3894,0
39147,"Seneca County, Ohio",55711,27858,27853,25004,37039,3492,1638,181,138,54740,2076,1620,3696,8209,3775,4434,25032,141
39151,"Stark County, Ohio",374762,181928,192834,27401,258785,37497,15989,3105,1976,370006,15015,12284,27299,51534,22655,28879,173773,660
39031,"Coshocton County, Ohio",36665,18231,18434,21520,25192,2105,791,91,50,36273,2348,2337,4685,5058,2159,2899,15545,110
39041,"Delaware County, Ohio",188996,93421,95575,45116,122837,41266,16989,3849,2331,188101,4476,3325,7801,9034,4083,4951,95558,691
39055,"Geauga County, Ohio",94020,46372,47648,39513,63739,15428,6249,1289,789,93367,5545,4438,9983,6399,3045,3354,45678,252
39073,"Hocking County, Ohio",28690,14246,14444,23192,19914,1908,721,155,31,28056,1697,1305,3002,4655,1960,2695,11960,46
39085,"Lake County, Ohio",229266,111975,117291,32125,163400,28368,12405,2172,1238,227172,8332,6826,15158,19231,8984,10247,115685,294
39141,"Ross County, Ohio",77193,40501,36692,22714,54241,5302,2304,488,207,71506,3649,2739,6388,13419,5743,7676,29459,200
39035,"Cuyahoga County, Ohio",1258710,599319,659391,30441,871903,158303,74555,24522,11962,1243379,57597,44635,102232,227740,100599,127141,570474,3808
39075,"Holmes County, Ohio",43702,21854,21848,21143,24892,1278,491,111,43,42916,8504,8942,17446,5504,2542,2962,19008,490
39109,"Miami County, Ohio",103864,51232,52632,28051,71649,9739,4508,593,252,102984,4391,3727,8118,11374,4675,6699,49364,273
39111,"Monroe County, Ohio",14442,7220,7222,23154,10470,711,332,53,24,14288,784,688,1472,2679,1271,1408,5370,14
39155,"Trumbull County, Ohio",204908,99872,105036,25542,145249,18210,5848,1185,843,201249,11202,9198,20400,35115,15029,20086,86679,272
39173,"Wood County, Ohio",129418,63646,65772,30042,79630,14516,7846,1368,1499,128147,4229,3037,7266,16797,7596,9201,64252,322
39005,"Ashland County, Ohio",53343,26055,27288,24612,35233,4447,1814,196,462,52783,2937,2934,5871,7859,3664,4195,23772,128
40043,"Dewey County, Oklahoma",4862,2461,2401,25821,3219,547,139,5,18,4759,390,296,686,855,398,457,2055,4
40059,"Harper County, Oklahoma",3785,1869,1916,23536,2516,380,175,11,41,3774,301,258,559,522,234,288,1699,17
40083,"Logan County, Oklahoma",45171,22366,22805,28265,30101,5474,1836,391,291,44809,3237,2854,6091,5382,2407,2975,20570,170
05019,"Clark County, Arkansas",22684,10769,11915,20382,13141,2010,928,96,214,22352,1298,1185,2483,4762,1806,2956,9908,33
05095,"Monroe County, Arkansas",7542,3509,4033,20486,5247,357,101,14,3,7471,535,523,1058,2139,929,1210,2869,17
05103,"Ouachita County, Arkansas",24728,11647,13081,19780,17182,1808,897,101,49,24335,1269,1265,2534,5970,2120,3850,10048,43
05001,"Arkansas County, Arkansas",18569,8798,9771,23766,12745,1276,451,22,90,18335,980,768,1748,3587,1386,2201,7864,42
05015,"Carroll County, Arkansas",27690,13639,14051,21754,19478,2157,951,119,219,27466,2156,2399,4555,4789,2069,2720,11116,35
05119,"Pulaski County, Arkansas",391806,187819,203987,29855,263171,54619,20840,6773,4439,386040,24817,19957,44774,69467,31575,37892,180388,1069
06033,"Lake County, California",64076,31982,32094,23345,46222,4821,1810,528,309,63400,5223,4063,9286,15561,7738,7823,21401,83
06049,"Modoc County, California",9033,4637,4396,22052,6683,926,208,61,26,8786,734,527,1261,1483,722,761,3368,19
06027,"Inyo County, California",18326,9235,9091,30323,13233,1991,973,129,148,17879,917,927,1844,1905,841,1064,8087,34
06083,"Santa Barbara County, California",439395,220159,219236,32872,270363,51832,22062,7146,6101,432111,32822,26148,58970,66880,31737,35143,202069,1229
06025,"Imperial County, California",178807,91324,87483,17303,107679,10576,3627,680,146,168694,12918,12073,24991,40552,18244,22308,57190,876
06001,"Alameda County, California",1605217,786730,818487,41363,1113279,282754,141689,32639,31512,1594193,73903,59331,133234,189590,85682,103908,736979,8225
06055,"Napa County, California",140823,70010,70813,40632,97243,21345,6815,2523,1452,138899,6714,5995,12709,12086,5660,6426,68274,322
06075,"San Francisco County, California",850282,433226,417056,59508,668995,220335,95666,32831,17732,845883,33199,25520,58719,104180,49680,54500,479139,5660
24001,"Allegany County, Maryland",73060,38077,34983,22355,50793,4733,3378,478,535,67674,2707,1872,4579,11430,5531,5899,28727,179
24003,"Anne Arundel County, Maryland",559737,276842,282895,43258,382657,88157,46830,9325,6321,538865,18458,13790,32248,33168,13982,19186,293520,2166
24009,"Calvert County, Maryland",90527,44966,45561,41469,60627,10038,6028,1025,664,89333,3046,2281,5327,5400,2178,3222,44872,385
24031,"Montgomery County, Maryland",1026371,494612,531759,51162,703977,186973,134785,45074,42217,1017915,50085,44164,94249,69889,28788,41101,537814,3248
24037,"St. Mary's County, Maryland",110675,55176,55499,37528,72507,12584,7373,935,789,108002,3571,2956,6527,8440,3402,5038,55157,281
24019,"Dorchester County, Maryland",32451,15519,16932,28911,23113,2928,1416,295,161,32019,1114,968,2082,5435,2310,3125,14819,84
24015,"Cecil County, Maryland",102175,50603,51572,32542,69319,9415,4613,715,848,101030,3959,3148,7107,10729,5025,5704,48948,327
25001,"Barnstable County, Massachusetts",214703,102542,112161,40886,164809,39130,20786,4372,3442,212428,4233,3274,7507,17433,7650,9783,101171,790
25003,"Berkshire County, Massachusetts",128563,62125,66438,33245,92918,17122,9444,2263,1493,126319,2437,1401,3838,15136,6625,8511,62119,472
25023,"Plymouth County, Massachusetts",506657,246500,260157,39247,348844,78494,33129,6990,3544,499437,8338,6011,14349,39602,16768,22834,252517,1637
25021,"Norfolk County, Massachusetts",691218,331220,359998,49816,481812,135256,74648,21333,15489,682577,8253,6414,14667,45372,18102,27270,353547,1977
25019,"Nantucket County, Massachusetts",10694,5728,4966,47924,7785,1843,1102,244,82,10643,443,164,607,1083,652,431,6165,12
26115,"Monroe County, Michigan",149945,73941,76004,29245,103660,13266,5099,754,369,149065,5609,4471,10080,16078,7061,9017,67026,457
26059,"Hillsdale County, Michigan",46024,22964,23060,23831,31222,3321,1369,322,194,45622,2650,2245,4895,8261,3891,4370,18770,159
26127,"Oceana County, Michigan",26152,13234,12918,22185,17816,1971,800,172,95,25977,1662,1320,2982,5136,2480,2656,10069,79
26035,"Clare County, Michigan",30608,15126,15482,21198,22225,1644,759,89,35,30276,2161,1832,3993,7289,3248,4041,10470,101
26083,"Keweenaw County, Michigan",2195,1138,1057,28700,1710,247,101,66,11,2187,148,86,234,371,187,184,836,6
26139,"Ottawa County, Michigan",276583,136286,140297,29121,169697,36141,13587,2140,1761,275217,8409,6649,15058,26511,12015,14496,136402,646
26007,"Alpena County, Michigan",28929,14258,14671,24030,21150,2157,1058,244,89,28579,1532,1303,2835,4615,2014,2601,12208,77
26111,"Midland County, Michigan",83559,41100,42459,33013,57485,11270,5338,964,1332,82970,3324,2728,6052,10065,4616,5449,37303,235
26129,"Ogemaw County, Michigan",21103,10562,10541,22028,15655,1160,472,120,27,20814,1137,915,2052,4135,1859,2276,7532,105
26039,"Crawford County, Michigan",13840,6983,6857,22891,10325,1120,411,145,46,13648,528,561,1089,2326,1052,1274,5136,58
26057,"Gratiot County, Michigan",41676,22119,19557,20597,28260,2488,1201,143,196,37373,1680,1373,3053,6807,2907,3900,15560,112
26091,"Lenawee County, Michigan",98673,49994,48679,25649,67537,8828,3652,615,367,95524,4646,3437,8083,13434,6016,7418,42291,131
06011,"Colusa County, California",21361,11097,10264,25676,13392,1474,233,195,30,21174,1903,1393,3296,2859,1330,1529,8944,47
06031,"Kings County, California",150261,83207,67054,19835,91823,8378,2128,969,268,131033,9180,7522,16702,28661,13081,15580,54567,433
06019,"Fresno County, California",963160,480527,482633,22234,579136,76303,24116,8969,4887,951904,76567,58373,134940,254872,119535,135337,368119,5966
06059,"Orange County, California",3132211,1546687,1585524,37603,2100472,520755,195472,58548,32797,3114968,204917,179323,384240,385556,176600,208956,1501853,12403
06101,"Sutter County, California",95406,47486,47920,24849,61269,7623,2310,766,269,94171,6955,5443,12398,16535,7623,8912,37746,157
06077,"San Joaquin County, California",714860,355719,359141,24694,442112,55004,16993,5472,2828,706531,46997,35651,82648,124587,58002,66585,277798,2015
08007,"Archuleta County, Colorado",12355,6274,6081,29344,9115,2110,759,154,161,12252,1429,1059,2488,1369,612,757,5547,37
08055,"Huerfano County, Colorado",6521,3283,3238,25547,5148,807,416,70,45,6361,506,345,851,1086,579,507,2303,16
08015,"Chaffee County, Colorado",18507,9854,8653,28907,14370,2991,1338,459,157,17405,1348,930,2278,1673,743,930,8119,13
08045,"Garfield County, Colorado",57495,29406,28089,31483,37845,7176,2933,619,298,56799,7099,6243,13342,6274,3130,3144,29417,303
08079,"Mineral County, Colorado",793,414,379,33018,713,192,73,17,21,793,38,22,60,65,28,37,310,0
08115,"Sedgwick County, Colorado",2367,1121,1246,24666,1701,226,94,7,10,2338,173,107,280,342,147,195,988,10
08027,"Custer County, Colorado",4375,2146,2229,26032,3350,631,265,49,40,4359,387,342,729,772,373,399,1241,0
08001,"Adams County, Colorado",479977,241414,238563,27487,303509,46224,17121,2733,1810,476508,40963,33355,74318,61265,27138,34127,235043,1523
08065,"Lake County, Colorado",7401,4110,3291,28492,5098,1217,189,54,116,7339,686,532,1218,836,453,383,4191,47
08097,"Pitkin County, Colorado",17543,9208,8335,65800,13484,5803,1513,659,174,17498,1388,1008,2396,1507,659,848,10539,78
08017,"Cheyenne County, Colorado",2071,1057,1014,23698,1323,247,59,0,2,2029,194,166,360,229,105,124,963,19
08033,"Dolores County, Colorado",1789,946,843,23190,1336,192,73,6,0,1789,103,82,185,346,187,159,734,1
08069,"Larimer County, Colorado",325228,161828,163400,34087,210378,58408,25672,4457,6711,322804,15668,11930,27598,41640,19368,22272,165414,1130
08113,"San Miguel County, Colorado",7767,4118,3649,42015,5766,2237,680,174,84,7736,534,427,961,923,398,525,4557,161
40143,"Tulsa County, Oklahoma",629823,307129,322694,29797,410633,85476,28069,8311,4137,624912,51589,46415,98004,98682,43059,55623,300004,3331
40147,"Washington County, Oklahoma",51892,25164,26728,28913,35459,6416,2157,214,534,51498,3900,3878,7778,7325,3134,4191,22791,138
40057,"Harmon County, Oklahoma",2813,1395,1418,21620,1917,273,136,4,0,2709,279,135,414,433,163,270,1146,0
40061,"Haskell County, Oklahoma",12835,6388,6447,20009,8735,776,256,4,17,12770,1414,1368,2782,2574,1164,1410,4455,41
40111,"Okmulgee County, Oklahoma",39322,19447,19875,21436,25923,2861,955,147,69,38674,3484,3177,6661,7656,3259,4397,14622,116
40113,"Osage County, Oklahoma",47923,24031,23892,24195,33387,3902,1443,149,140,46530,3201,3215,6416,6948,2871,4077,19073,166
40067,"Jefferson County, Oklahoma",6280,3166,3114,19130,4282,415,117,30,8,6132,667,610,1277,1195,519,676,2318,5
40047,"Garfield County, Oklahoma",62481,30941,31540,25787,40732,5667,2240,578,214,60353,4267,3723,7990,7980,3623,4357,28368,225
40049,"Garvin County, Oklahoma",27570,13672,13898,22433,18421,1946,683,127,75,27337,2220,2200,4420,5070,2317,2753,10605,79
40121,"Pittsburg County, Oklahoma",44643,22693,21950,24408,31143,3265,1387,227,150,42781,4014,3660,7674,7450,3420,4030,17959,93
40123,"Pontotoc County, Oklahoma",38213,18664,19549,23862,24576,4166,1967,222,275,37782,3684,3169,6853,6661,3110,3551,17218,128
40129,"Roger Mills County, Oklahoma",3732,1823,1909,27797,2491,373,137,12,5,3709,178,245,423,473,196,277,1715,3
40153,"Woodward County, Oklahoma",21111,11153,9958,27413,13824,1956,776,109,44,20115,877,991,1868,2568,1045,1523,9396,103
40021,"Cherokee County, Oklahoma",48267,23872,24395,19799,29926,4409,2087,301,415,47758,5609,5731,11340,10380,4829,5551,19135,91
40041,"Delaware County, Oklahoma",41433,20505,20928,22175,29661,3317,1131,234,278,41050,3872,3756,7628,8086,3661,4425,15359,214
40045,"Ellis County, Oklahoma",4123,2002,2121,27272,2849,466,125,16,16,4088,259,203,462,627,288,339,1781,10
40051,"Grady County, Oklahoma",53955,26854,27101,27334,36156,4727,1270,236,198,53388,3883,3538,7421,6759,2914,3845,24096,220
40119,"Payne County, Oklahoma",79953,40872,39081,22785,42694,8643,4329,843,2012,78862,5431,4579,10010,18943,9317,9626,35327,268
40125,"Pottawatomie County, Oklahoma",71551,34082,37469,22284,46853,5769,1869,381,290,69230,5691,5427,11118,12334,5691,6643,28805,735
40037,"Creek County, Oklahoma",70931,35091,35840,24056,47999,5287,1609,372,222,70129,5329,4927,10256,10491,4591,5900,29743,103
40141,"Tillman County, Oklahoma",7611,3902,3709,21422,5137,614,154,36,24,7247,642,563,1205,1581,729,852,3085,17
40149,"Washita County, Oklahoma",11626,5797,5829,26409,7735,1212,346,48,53,11387,649,600,1249,1803,658,1145,4849,6
40033,"Cotton County, Oklahoma",6062,2988,3074,21887,4163,491,157,14,20,5933,508,515,1023,956,410,546,2498,17
40075,"Kiowa County, Oklahoma",9239,4611,4628,23076,6414,792,281,46,8,9045,691,850,1541,1938,842,1096,3938,32
40079,"Le Flore County, Oklahoma",49885,25002,24883,20264,33529,3119,1466,135,151,48741,5512,4832,10344,11061,4989,6072,18284,217
40089,"McCurtain County, Oklahoma",33071,16264,16807,19040,21731,2119,687,126,58,32662,3463,3603,7066,7705,3460,4245,12133,119
40093,"Major County, Oklahoma",7721,3861,3860,28294,5210,656,199,19,5,7642,461,484,945,1031,423,608,3371,91
40097,"Mayes County, Oklahoma",40923,20382,20541,22575,27504,2949,1079,114,71,40484,3743,3243,6986,8454,3826,4628,16629,98
40109,"Oklahoma County, Oklahoma",764698,374134,390564,29127,495713,98585,37315,11157,5647,751872,65182,58839,124021,132442,57485,74957,357338,2269
40039,"Custer County, Oklahoma",29248,14597,14651,24621,17003,3211,1259,83,166,28805,2480,2114,4594,4459,2031,2428,14053,23
40085,"Love County, Oklahoma",9768,4830,4938,20965,6456,616,226,16,10,9681,729,563,1292,1219,604,615,4051,59
40009,"Beckham County, Oklahoma",23290,12339,10951,23883,15315,1835,617,283,67,21719,1658,1595,3253,3030,1157,1873,9375,36
40023,"Choctaw County, Oklahoma",15051,7277,7774,19446,10267,941,308,55,26,14878,2060,1817,3877,4230,1880,2350,5004,61
40065,"Jackson County, Oklahoma",25864,12867,12997,22988,16474,2092,1077,109,118,24326,1641,1894,3535,4206,1668,2538,11641,85
40081,"Lincoln County, Oklahoma",34640,17194,17446,23911,23440,2397,739,127,96,34262,2577,2571,5148,5125,2297,2828,14281,170
40117,"Pawnee County, Oklahoma",16444,8212,8232,22965,11225,1287,410,96,58,16289,1363,1284,2647,2360,1075,1285,6537,63
40133,"Seminole County, Oklahoma",25403,12396,13007,19605,16627,1534,664,86,25,24951,2667,2647,5314,5615,2387,3228,9208,95
40025,"Cimarron County, Oklahoma",2269,1128,1141,28461,1598,251,49,1,15,2243,190,172,362,351,126,225,1056,24
40011,"Blaine County, Oklahoma",9777,5358,4419,22823,6965,864,265,32,21,8118,461,500,961,1144,478,666,3376,21
40029,"Coal County, Oklahoma",5755,2816,2939,24004,3880,401,194,28,35,5687,753,652,1405,1112,507,605,2182,11
40053,"Grant County, Oklahoma",4497,2276,2221,29002,3155,605,129,16,16,4422,181,187,368,401,171,230,2062,5
40073,"Kingfisher County, Oklahoma",15392,7692,7700,31885,10026,1501,515,81,111,15232,801,1137,1938,1279,634,645,7272,56
40087,"McClain County, Oklahoma",37222,18563,18659,28353,24583,4073,1113,281,174,36937,2504,2393,4897,3530,1703,1827,16736,84
40095,"Marshall County, Oklahoma",16079,8021,8058,22431,10999,991,381,104,18,15821,1323,1376,2699,2613,1141,1472,6142,85
40103,"Noble County, Oklahoma",11470,5662,5808,28054,7834,1292,363,87,39,11373,665,492,1157,1449,675,774,5175,27
40105,"Nowata County, Oklahoma",10510,5179,5331,21491,7228,663,188,29,28,10309,915,907,1822,1941,864,1077,4182,15
40131,"Rogers County, Oklahoma",89970,44799,45171,29824,59768,9954,2936,550,418,88947,5550,5201,10751,8297,3364,4933,42326,452
40135,"Sequoyah County, Oklahoma",41344,20456,20888,19253,28049,2789,794,226,145,40963,4721,4375,9096,10157,4977,5180,15372,196
40003,"Alfalfa County, Oklahoma",5784,3473,2311,28007,4286,650,213,10,23,4751,329,259,588,589,305,284,2177,27
40151,"Woods County, Oklahoma",9125,4922,4203,28322,5713,895,354,83,194,8489,616,404,1020,1059,518,541,4407,23
40027,"Cleveland County, Oklahoma",271818,135801,136017,29231,170573,33573,14242,2893,3483,266197,15077,13053,28130,32583,14974,17609,134672,1063
40107,"Okfuskee County, Oklahoma",12212,6542,5670,17656,8270,662,283,33,25,11330,1227,1222,2449,2957,1477,1480,3844,100
40005,"Atoka County, Oklahoma",13847,7266,6581,19439,9575,979,384,28,18,12268,1151,1386,2537,2690,1083,1607,4403,29
41061,"Union County, Oregon",25758,12706,13052,26586,17088,2649,838,290,197,25492,1490,1292,2782,4655,1954,2701,10940,73
41047,"Marion County, Oregon",326527,162353,164174,24791,212044,31364,11411,3040,1710,320437,21670,16399,38069,54411,24426,29985,138582,841
41019,"Douglas County, Oregon",107375,53026,54349,25002,78692,7867,3796,739,445,106713,5505,4826,10331,19701,8785,10916,38652,420
41031,"Jefferson County, Oregon",22305,11467,10838,22957,15059,1707,537,97,86,21582,1930,1521,3451,4355,2144,2211,7842,129
41053,"Polk County, Oregon",78470,38065,40405,25928,50046,8998,4474,835,583,78109,3590,3086,6676,11916,5490,6426,32916,214
41017,"Deschutes County, Oregon",170813,84267,86546,31575,122101,25564,10807,2854,1450,170198,11706,10532,22238,23622,11161,12461,76910,626
08039,"Elbert County, Colorado",24225,12223,12002,42522,16940,3923,1230,270,137,24126,973,817,1790,1221,562,659,12408,94
08125,"Yuma County, Colorado",10150,4968,5182,24789,6671,965,436,7,19,10011,806,710,1516,1459,712,747,4804,11
08117,"Summit County, Colorado",29269,16153,13116,37192,21914,7638,2502,390,409,29189,3228,2460,5688,3522,1682,1840,17764,83
08029,"Delta County, Colorado",30221,15127,15094,25546,21753,2807,1128,263,67,29195,2490,2171,4661,4890,2039,2851,10984,48
26097,"Mackinac County, Michigan",10998,5581,5417,26967,8394,995,471,91,47,10879,850,668,1518,1687,742,945,4433,99
26061,"Houghton County, Michigan",36565,19817,16748,21462,21430,4016,1553,327,739,36129,1898,1309,3207,7821,4611,3210,14400,84
26085,"Lake County, Michigan",11415,5841,5574,18199,8741,507,218,30,36,11076,719,548,1267,3001,1465,1536,3264,48
26141,"Presque Isle County, Michigan",12955,6459,6496,24793,10079,1059,481,107,32,12803,749,569,1318,1729,784,945,4409,62
26077,"Kalamazoo County, Michigan",258605,126410,132195,29258,160127,34182,17092,3204,3329,256652,11157,8528,19685,43657,20371,23286,124308,1336
26123,"Newaygo County, Michigan",47957,24143,23814,22735,33063,3215,1231,169,126,47444,2432,1922,4354,8596,3889,4707,18432,300
26025,"Calhoun County, Michigan",134691,65829,68862,24859,90994,12668,4913,765,536,133025,6079,5024,11103,22245,10082,12163,56724,261
26081,"Kent County, Michigan",629352,309450,319902,29433,408603,90518,34389,7576,5042,625162,30335,22540,52875,92049,42375,49674,306936,2280
26145,"Saginaw County, Michigan",195201,94684,100517,25348,131885,17972,6836,1760,767,191876,7674,7064,14738,33795,15061,18734,80086,266
26017,"Bay County, Michigan",106107,52254,53853,25462,74904,9256,3217,661,434,105145,4641,3160,7801,16515,8018,8497,45530,229
26041,"Delta County, Michigan",36570,18088,18482,25582,26485,3824,1160,321,145,36176,1838,1596,3434,5961,2782,3179,15371,140
27071,"Koochiching County, Minnesota",12930,6461,6469,26804,9516,1204,390,92,64,12767,523,359,882,2139,998,1141,5721,31
27097,"Morrison County, Minnesota",32850,16617,16233,28040,22679,2580,804,155,124,32508,1198,892,2090,3801,1627,2174,16390,141
27147,"Steele County, Minnesota",36541,18073,18468,29930,24392,4432,1252,280,82,36154,985,592,1577,3396,1266,2130,18405,72
27001,"Aitkin County, Minnesota",15722,8016,7706,26883,12182,1373,413,141,22,15535,545,390,935,1978,966,1012,6191,69
27101,"Murray County, Minnesota",8463,4197,4266,30553,6108,751,231,92,14,8350,237,276,513,761,315,446,4156,11
27067,"Kandiyohi County, Minnesota",42510,21312,21198,29375,28588,4293,1421,544,179,41885,1793,1077,2870,4732,2038,2694,21470,93
27133,"Rock County, Minnesota",9554,4668,4886,29000,6493,969,264,81,21,9326,317,377,694,998,416,582,4707,30
27155,"Traverse County, Minnesota",3397,1635,1762,30234,2486,326,89,31,5,3310,74,69,143,305,118,187,1597,9
27053,"Hennepin County, Minnesota",1209265,596243,613022,41794,831660,254187,98334,27863,15331,1200092,46374,34719,81093,141453,66258,75195,650345,3714
27023,"Chippewa County, Minnesota",12126,6006,6120,29354,8446,1043,298,41,10,11934,546,425,971,1285,489,796,6339,9
27029,"Clearwater County, Minnesota",8764,4440,4324,24515,5978,640,184,32,19,8667,532,420,952,1435,681,754,3547,34
27059,"Isanti County, Minnesota",38461,19431,19030,30145,26122,3267,1092,196,66,38149,1429,910,2339,2732,1379,1353,19285,182
27099,"Mower County, Minnesota",39248,19689,19559,28613,26194,3597,1073,296,274,38851,1899,1086,2985,5403,2544,2859,18632,255
27109,"Olmsted County, Minnesota",150104,73514,76590,37956,101189,24599,10015,4740,3138,148170,4840,3025,7865,13635,5936,7699,78857,403
09015,"Windham County, Connecticut",117078,58044,59034,29993,80577,11675,5883,792,873,115389,4253,3060,7313,12518,5239,7279,56779,341
09007,"Middlesex County, Connecticut",164438,80412,84026,43695,118519,26923,16395,3030,2160,162549,4703,3417,8120,11193,4885,6308,87312,726
12133,"Washington County, Florida",24627,13426,11201,18718,17617,1190,578,60,107,22100,1597,1387,2984,4532,2407,2125,8599,266
12009,"Brevard County, Florida",560683,273945,286738,29405,412117,70806,33608,5224,4636,555674,39287,33906,73193,77357,35249,42108,230437,3112
12069,"Lake County, Florida",317586,153595,163991,25991,232300,32771,13543,2773,1249,314138,22166,19493,41659,42342,19508,22834,122735,1002
12105,"Polk County, Florida",637691,312427,325264,22579,437227,57131,21028,3789,3140,628714,52437,46263,98700,110225,49693,60532,248619,2828
12043,"Glades County, Florida",13420,7269,6151,20476,9954,614,240,4,26,12094,1516,1320,2836,2500,1243,1257,3561,49
12063,"Jackson County, Florida",48721,27001,21720,18126,35443,2751,1514,338,249,41061,2687,2461,5148,9325,4500,4825,15778,208
12117,"Seminole County, Florida",442905,213833,229072,31363,307232,73902,26018,6438,3771,440221,31265,28440,59705,53025,24153,28872,213323,2349
12005,"Bay County, Florida",178361,88681,89680,26742,124142,18379,6980,1587,1028,174105,15012,12989,28001,27363,12090,15273,80604,615
12045,"Gulf County, Florida",15851,9220,6631,21085,12106,1437,367,139,80,13506,1214,867,2081,2068,938,1130,5526,121
12097,"Osceola County, Florida",311962,153499,158463,20165,203314,27036,8109,1638,1189,310093,32755,28337,61092,60243,27494,32749,135412,1061
12131,"Walton County, Florida",61528,31164,30364,30853,44776,8009,2581,765,425,59380,5864,4547,10411,10357,5220,5137,25891,607
12065,"Jefferson County, Florida",14082,7483,6599,22452,10797,1231,581,116,125,11586,580,576,1156,1825,734,1091,4718,0
12049,"Hardee County, Florida",27302,14728,12574,18643,17163,1192,370,56,35,25551,2887,2428,5315,6716,3047,3669,9372,210
12095,"Orange County, Florida",1256055,617633,638422,27394,825249,175902,62862,16732,7947,1244462,118252,104775,223027,212105,95644,116461,611025,6238
12041,"Gilchrist County, Florida",17033,8961,8072,21145,11397,927,392,56,32,15784,1531,1478,3009,3730,1769,1961,6159,43
12001,"Alachua County, Florida",256581,124004,132577,26431,153641,32800,16729,6619,7636,253897,17118,14087,31205,58387,28205,30182,115452,1050
12015,"Charlotte County, Florida",169642,82682,86960,29243,137850,18551,8227,2019,984,166246,12072,11201,23273,20511,9216,11295,55864,1013
12085,"Martin County, Florida",153592,75837,77755,38021,117748,23015,9231,3281,1606,150637,11981,8592,20573,17758,8369,9389,60938,800
12115,"Sarasota County, Florida",398011,189970,208041,37054,314565,62376,28451,8173,4989,394213,27269,23963,51232,43281,19526,23755,154510,1068
12017,"Citrus County, Florida",140453,67884,72569,25034,111198,13034,4708,1380,722,138504,8720,7854,16574,24409,10619,13790,42809,734
12113,"Santa Rosa County, Florida",163903,83912,79991,28908,112777,20301,7665,1295,1063,154231,9455,8586,18041,19331,8580,10751,70778,573
12011,"Broward County, Florida",1863780,906235,957545,30109,1304351,259844,98835,31505,14370,1852454,172573,160742,333315,265521,119083,146438,892638,10246
12087,"Monroe County, Florida",77150,40911,36239,39176,59901,11559,4574,1498,981,75302,8750,7029,15779,9815,4908,4907,39920,898
27069,"Kittson County, Minnesota",4436,2243,2193,30525,3169,497,111,35,12,4307,164,117,281,481,178,303,2171,10
27087,"Mahnomen County, Minnesota",5480,2765,2715,20720,3362,314,79,18,13,5444,392,434,826,1209,580,629,2201,13
27173,"Yellow Medicine County, Minnesota",10038,5115,4923,28182,7003,880,169,69,19,9863,432,326,758,1115,526,589,5001,36
27013,"Blue Earth County, Minnesota",65524,32979,32545,28283,37943,8065,2687,602,660,64944,1987,1277,3264,11323,5438,5885,35599,47
27077,"Lake of the Woods County, Minnesota",3901,2030,1871,24964,2910,408,85,1,0,3847,180,65,245,312,124,188,2014,0
72077,"Juncos Municipio, Puerto Rico",39942,19073,20869,9017,26404,4223,1155,81,119,39884,1561,642,2203,19558,8856,10702,10731,93
72001,"Adjuntas Municipio, Puerto Rico",18760,9161,9599,7117,12590,1956,288,27,71,18714,621,669,1290,11791,5437,6354,4061,32
72067,"Hormigueros Municipio, Puerto Rico",16678,7732,8946,11588,12081,2128,506,74,83,16563,548,458,1006,6013,2847,3166,4666,9
72105,"Naranjito Municipio, Puerto Rico",29467,14543,14924,8996,19749,2690,409,101,10,29413,859,414,1273,14032,6831,7201,7576,37
72013,"Arecibo Municipio, Puerto Rico",91096,43771,47325,9954,63121,10216,2148,438,667,89975,3431,1724,5155,43974,19911,24063,21990,8
72054,"Florida Municipio, Puerto Rico",12287,5896,6391,7837,8136,895,12,0,0,12278,195,134,329,6707,3010,3697,2933,70
72099,"Moca Municipio, Puerto Rico",38289,18759,19530,7881,25607,3648,790,184,130,38081,1074,610,1684,21529,9990,11539,8548,85
72123,"Salinas Municipio, Puerto Rico",29722,14417,15305,8738,19477,2477,777,26,129,29505,944,725,1669,15702,7674,8028,7393,13
72153,"Yauco Municipio, Puerto Rico",38519,18540,19979,8124,26746,4482,905,251,164,38275,1191,847,2038,19162,9136,10026,8827,38
72023,"Cabo Rojo Municipio, Puerto Rico",50096,23828,26268,9523,35034,6769,1284,158,544,49993,1607,986,2593,25055,11581,13474,12892,0
72083,"Las Marías Municipio, Puerto Rico",9093,4507,4586,7154,6125,679,141,6,1,9021,205,27,232,5309,2585,2724,2411,0
72149,"Villalba Municipio, Puerto Rico",24186,11806,12380,10449,15575,2332,389,159,11,23982,586,297,883,12185,5909,6276,6611,0
72003,"Aguada Municipio, Puerto Rico",40083,19637,20446,9001,27762,3865,1267,208,274,40041,1327,850,2177,21828,10489,11339,11480,50
72041,"Cidra Municipio, Puerto Rico",41782,20336,21446,10965,28195,4716,1411,226,156,41634,1346,730,2076,17471,8392,9079,12047,479
72089,"Luquillo Municipio, Puerto Rico",19237,9053,10184,10434,12980,1947,461,22,57,19143,853,498,1351,8450,3916,4534,5530,327
72107,"Orocovis Municipio, Puerto Rico",22258,11187,11071,7326,14471,1952,254,8,2,22157,350,168,518,12776,6076,6700,4527,45
72037,"Ceiba Municipio, Puerto Rico",12538,5905,6633,11840,8575,1095,367,5,18,12527,327,271,598,5611,2528,3083,3490,52
01037,"Coosa County, Alabama",10864,5355,5509,20342,7907,489,259,7,31,10524,719,602,1321,1610,650,960,3630,19
01045,"Dale County, Alabama",49607,24443,25164,23194,33363,3540,1445,292,84,46897,3204,2926,6130,9897,4311,5586,20525,293
01065,"Hale County, Alabama",15159,7121,8038,20269,10229,992,302,121,20,14922,856,793,1649,3858,1546,2312,4933,62
01055,"Etowah County, Alabama",103363,50007,53356,22278,71696,7513,3101,805,405,102507,6824,5541,12365,18713,8174,10539,40546,163
01049,"DeKalb County, Alabama",70937,35134,35803,20020,47440,3154,1630,371,237,70207,5846,5400,11246,13872,6092,7780,27645,196
01053,"Escambia County, Alabama",37875,19390,18485,18164,25762,1901,759,259,76,35409,2751,3493,6244,8894,3778,5116,11737,49
01075,"Lamar County, Alabama",14066,6813,7253,21152,9998,814,380,64,48,13922,830,938,1768,3322,1301,2021,5093,23
01111,"Randolph County, Alabama",22615,11025,11590,20983,15599,1555,723,60,61,22369,1363,1307,2670,4542,2093,2449,8266,54
01013,"Butler County, Alabama",20280,9522,10758,19004,13949,1328,674,136,105,19998,1107,1250,2357,5126,2099,3027,7691,49
01097,"Mobile County, Alabama",414291,198297,215994,24347,274893,41373,15122,3390,2000,405929,26880,26501,53381,78633,31981,46652,169768,1327
01105,"Perry County, Alabama",9856,4671,5185,13449,5941,475,307,13,66,9707,710,783,1493,3605,1846,1759,2477,95
01127,"Walker County, Alabama",65593,31944,33649,21217,45633,2805,1409,480,117,64876,4261,3945,8206,14174,6461,7713,23352,171
01029,"Cleburne County, Alabama",14991,7423,7568,20873,10366,651,340,138,66,14807,1056,993,2049,2889,1266,1623,5575,48
01035,"Conecuh County, Alabama",12697,6028,6669,16337,8808,434,281,39,9,12648,1121,1292,2413,4107,1805,2302,3753,3
01063,"Greene County, Alabama",8587,4092,4495,14197,5965,457,103,30,5,8534,718,481,1199,3233,1458,1775,2330,38
01005,"Barbour County, Alabama",26614,14239,12375,17561,18387,1431,736,124,75,23682,1752,1327,3079,6235,2673,3562,8783,134
01007,"Bibb County, Alabama",22572,12084,10488,20911,15750,971,763,56,100,20598,820,1039,1859,3390,1439,1951,8280,111
01011,"Bullock County, Alabama",10552,5719,4833,20856,7333,356,270,90,36,10170,1151,551,1702,2728,1215,1513,4165,112
01015,"Calhoun County, Alabama",115883,55742,60141,23638,78661,8247,4138,860,641,114387,6718,5697,12415,22135,9138,12997,45797,380
01017,"Chambers County, Alabama",34018,16299,17719,22002,23854,2086,624,203,65,33647,1922,2057,3979,6805,2953,3852,13846,44
01057,"Fayette County, Alabama",16783,8311,8472,21191,11806,1048,521,19,82,16591,779,621,1400,2863,1239,1624,6057,21
01095,"Marshall County, Alabama",94534,46597,47937,22710,63366,6877,2765,546,310,93661,7629,6760,14389,19138,8207,10931,37549,166
01009,"Blount County, Alabama",57704,28572,29132,22021,39472,3522,1261,239,129,57255,3457,2931,6388,9441,4461,4980,21350,74
01089,"Madison County, Alabama",349973,171085,178888,34232,236871,60122,28283,3884,4051,345445,18552,17185,35737,45287,20613,24674,165459,1743
01001,"Autauga County, Alabama",55049,26877,28172,27824,36466,5204,3041,480,243,54387,2279,2573,4852,6697,2764,3933,24302,275
01061,"Geneva County, Alabama",26765,13072,13693,21084,18805,1559,588,46,0,26412,2019,1864,3883,6011,2521,3490,10100,212
01131,"Wilcox County, Alabama",11119,5362,5757,15774,7441,545,184,81,31,10843,902,743,1645,3768,1676,2092,2961,21
02060,"Bristol Bay Borough, Alaska",942,536,406,42002,649,87,37,0,0,927,123,66,189,67,31,36,540,15
02150,"Kodiak Island Borough, Alaska",13918,7338,6580,32625,8998,1569,584,58,25,13244,1632,1370,3002,1247,714,533,7623,373
02050,"Bethel Census Area, Alaska",17885,9358,8527,18654,9503,671,290,81,43,17585,2664,1756,4420,4619,2303,2316,5791,1094
02185,"North Slope Borough, Alaska",9681,6114,3567,48777,6318,615,240,21,20,9597,1378,1015,2393,1070,537,533,5280,236
02090,"Fairbanks North Star Borough, Alaska",100150,53774,46376,35328,61221,12675,5576,1074,1106,93425,5889,4985,10874,7444,3325,4119,51580,620
02170,"Matanuska-Susitna Borough, Alaska",98679,51495,47184,30409,62756,8599,3207,711,403,96764,9018,7773,16791,9350,4505,4845,40829,2538
02180,"Nome Census Area, Alaska",9879,5317,4562,20952,5406,556,149,20,27,9677,1549,1049,2598,2593,1404,1189,3457,642
02100,"Haines Borough, Alaska",2528,1429,1099,35907,1847,513,143,66,25,2522,382,206,588,132,60,72,1288,68
02282,"Yakutat City and Borough, Alaska",646,346,300,32393,451,78,9,2,0,646,72,51,123,51,28,23,349,5
02164,"Lake and Peninsula Borough, Alaska",1411,720,691,23434,835,63,41,0,0,1411,288,191,479,263,137,126,589,183
02240,"Southeast Fairbanks Census Area, Alaska",6970,3876,3094,31051,4495,500,308,36,19,6845,858,631,1489,941,437,504,2927,28
02020,"Anchorage Municipality, Alaska",299321,152681,146640,38977,191431,41512,16889,4873,2383,288250,21850,20057,41907,23652,10726,12926,158110,3789
02013,"Aleutians East Borough, Alaska",3299,2145,1154,31254,2545,250,43,0,11,3294,1168,545,1713,510,252,258,2458,58
41043,"Linn County, Oregon",119862,59243,60619,24448,82255,10218,3428,758,508,119186,6252,5192,11444,20561,9375,11186,48485,465
41071,"Yamhill County, Oregon",102217,51023,51194,28540,67506,10739,4158,883,760,100045,5126,3862,8988,15255,6572,8683,44068,183
41001,"Baker County, Oregon",16030,8127,7903,25820,11808,1774,677,138,126,15520,796,847,1643,2339,1066,1273,6143,69
41035,"Klamath County, Oregon",65946,33005,32941,23793,45833,5293,2344,568,459,65412,3945,3667,7612,12117,5312,6805,25303,274
41041,"Lincoln County, Oregon",46685,22631,24054,25782,35587,4842,2290,636,433,46366,3287,3300,6587,8576,3954,4622,18671,140
41003,"Benton County, Oregon",87455,44079,43376,30873,52728,15360,8149,1690,3113,87187,3650,3125,6775,17665,9323,8342,39765,217
41013,"Crook County, Oregon",21334,10471,10863,24239,15879,1647,614,231,69,21255,1148,1080,2228,3757,1785,1972,8009,88
41055,"Sherman County, Oregon",1705,856,849,34226,1308,162,52,4,4,1705,165,130,295,301,130,171,730,1
41025,"Harney County, Oregon",7214,3645,3569,24398,5155,554,281,12,46,7110,283,351,634,1166,507,659,2816,41
41045,"Malheur County, Oregon",30474,16638,13836,17567,19837,1859,573,107,94,27105,2055,1885,3940,6651,2862,3789,10483,72
41063,"Wallowa County, Oregon",6836,3337,3499,26898,5316,759,374,127,77,6738,377,230,607,980,440,540,2803,27
41069,"Wheeler County, Oregon",1369,657,712,21268,1144,137,29,12,16,1363,33,75,108,272,124,148,507,9
41049,"Morrow County, Oregon",11207,5711,5496,21743,7030,527,159,0,14,11198,748,695,1443,1694,784,910,4731,47
41011,"Coos County, Oregon",62944,30893,32051,26007,46614,5112,2435,611,398,62096,4059,3679,7738,11213,5196,6017,23131,186
54055,"Mercer County, West Virginia",61476,29344,32132,21698,43366,5620,1970,568,283,61055,3005,2435,5440,12712,5403,7309,23123,205
54097,"Upshur County, West Virginia",24632,12356,12276,21279,16620,1892,937,143,113,24470,1538,1200,2738,4154,1957,2197,9760,213
54101,"Webster County, West Virginia",8820,4374,4446,20314,6404,318,216,25,29,8763,468,489,957,2383,1027,1356,2902,171
54003,"Berkeley County, West Virginia",110173,54159,56014,27658,74900,9696,4309,646,518,109711,5025,4638,9663,14436,6287,8149,49810,87
54019,"Fayette County, West Virginia",45192,22716,22476,20758,32444,2794,1134,212,130,43949,2827,2229,5056,8306,3744,4562,16058,591
55051,"Iron County, Wisconsin",5850,2970,2880,26689,4675,621,233,38,27,5743,295,211,506,726,332,394,2519,30
55019,"Clark County, Wisconsin",34486,17482,17004,23437,21713,1820,498,130,44,33992,4255,3672,7927,5060,2341,2719,15376,233
55109,"St. Croix County, Wisconsin",86726,43307,43419,36561,57837,13641,4151,875,650,85932,2690,2224,4914,4851,2133,2718,46098,259
55083,"Oconto County, Wisconsin",37475,19134,18341,28437,27219,2996,1119,216,77,37213,1300,893,2193,3334,1571,1763,18678,105
55069,"Lincoln County, Wisconsin",28171,14126,14045,28603,20650,2337,732,155,72,27600,991,780,1771,2616,1203,1413,14055,69
55135,"Waupaca County, Wisconsin",51974,26369,25605,29423,37188,4818,1353,275,123,50488,2080,1433,3513,5327,2501,2826,25411,243
55005,"Barron County, Wisconsin",45548,22945,22603,26935,32359,3839,1436,438,181,44968,1960,1520,3480,5467,2446,3021,21639,172
55113,"Sawyer County, Wisconsin",16438,8333,8105,29712,12099,1752,649,173,104,16142,991,736,1727,2623,1160,1463,6932,21
55047,"Green Lake County, Wisconsin",18881,9535,9346,26372,13366,1596,567,126,76,18689,1075,916,1991,2076,1033,1043,8777,114
55099,"Price County, Wisconsin",13707,6893,6814,27161,10604,1249,363,63,44,13514,411,426,837,1724,826,898,6448,32
55077,"Marquette County, Wisconsin",15082,7661,7421,26050,11241,1089,354,72,32,14889,699,489,1188,1730,789,941,6772,83
55075,"Marinette County, Wisconsin",41090,20622,20468,25778,30114,2946,1025,296,102,40568,1445,1157,2602,5254,2290,2964,18504,129
55079,"Milwaukee County, Wisconsin",955306,462020,493286,26933,622645,119607,47028,11340,7251,946031,53844,38232,92076,198227,89498,108729,442745,2194
55101,"Racine County, Wisconsin",194873,96388,98485,29582,132031,20883,8587,1267,914,190709,8791,6630,15421,23751,9952,13799,90557,689
55139,"Winnebago County, Wisconsin",169487,85414,84073,29763,113204,21612,6529,1402,894,164418,5589,4331,9920,19573,8217,11356,85824,294
55041,"Forest County, Wisconsin",9108,4589,4519,23936,6497,565,270,67,13,8916,602,603,1205,1520,725,795,3536,22
55045,"Green County, Wisconsin",37050,18347,18703,30208,25860,3985,1376,275,231,36692,1049,908,1957,3243,1464,1779,19670,81
55107,"Rusk County, Wisconsin",14272,7180,7092,23574,10277,1050,326,107,37,14136,861,613,1474,2225,1083,1142,6317,43
55115,"Shawano County, Wisconsin",41384,20689,20695,26627,29421,2980,1229,248,132,40807,1940,1677,3617,4594,2026,2568,19963,88
55067,"Langlade County, Wisconsin",19414,9763,9651,25142,14242,1496,579,188,23,19179,927,769,1696,3026,1541,1485,8777,79
55087,"Outagamie County, Wisconsin",181799,90637,91162,30858,121672,24326,7210,1483,788,180388,5991,4159,10150,16096,7392,8704,95958,545
55123,"Vernon County, Wisconsin",30442,15269,15173,25314,20448,2823,1125,219,171,30138,2599,2454,5053,4882,2176,2706,13210,177
55021,"Columbia County, Wisconsin",56650,28819,27831,31290,39844,6479,1861,450,245,55253,1946,1514,3460,4729,2032,2697,29367,170
55061,"Kewaunee County, Wisconsin",20459,10392,10067,28767,14473,1847,436,86,77,20325,552,351,903,1817,727,1090,10252,58
55009,"Brown County, Wisconsin",256621,127380,129241,29874,169787,34512,9924,2473,1045,253682,10256,7212,17468,29105,12745,16360,130506,1444
55035,"Eau Claire County, Wisconsin",101907,50071,51836,27780,63664,12748,4836,1022,971,101226,4690,3494,8184,14233,6605,7628,54404,299
55085,"Oneida County, Wisconsin",35604,17961,17643,30550,27130,4517,1890,452,262,35114,1382,945,2327,3294,1475,1819,16192,65
55095,"Polk County, Wisconsin",43483,21904,21579,27993,30903,4211,1395,345,106,43043,1983,1677,3660,4250,1938,2312,20861,175
55129,"Washburn County, Wisconsin",15685,7808,7877,28232,11776,1703,645,131,61,15497,695,462,1157,1976,868,1108,6871,50
55133,"Waukesha County, Wisconsin",395377,194157,201220,42094,276229,75600,28485,7358,3533,392911,8310,6969,15279,20167,8479,11688,207865,864
55127,"Walworth County, Wisconsin",103021,51470,51551,29192,67197,11794,5170,922,807,102290,5127,3596,8723,12885,5687,7198,51151,260
55023,"Crawford County, Wisconsin",16415,8525,7890,24391,11821,1266,500,59,32,15721,705,564,1269,2123,966,1157,7375,59
55057,"Juneau County, Wisconsin",26399,14023,12376,24376,19185,1769,510,107,93,24808,1209,739,1948,3244,1564,1680,11657,73
55111,"Sauk County, Wisconsin",63317,31647,31670,28331,43941,6708,2289,480,332,62596,2819,2434,5253,6933,3045,3888,32661,225
55131,"Washington County, Wisconsin",133422,66198,67224,36177,93022,19757,6026,1175,411,132557,3449,2792,6241,7486,3093,4393,71528,416
55017,"Chippewa County, Wisconsin",63355,32937,30418,27020,44241,6175,1694,342,318,61053,2417,1829,4246,6753,3315,3438,30790,267
55025,"Dane County, Wisconsin",516818,256341,260477,37193,336861,98516,43125,11401,12108,512893,15497,12495,27992,63673,29243,34430,287022,1070
55031,"Douglas County, Wisconsin",43705,21814,21891,27844,30710,4843,1676,312,164,43114,1846,1621,3467,6577,3060,3517,21151,233
55053,"Jackson County, Wisconsin",20566,10972,9594,24740,14390,1284,559,106,47,19469,1162,802,1964,2536,1151,1385,9102,73
55049,"Iowa County, Wisconsin",23751,11936,11815,31717,16599,2586,904,228,106,23572,876,547,1423,2277,1087,1190,12105,162
27137,"St. Louis County, Minnesota",200353,100702,99651,29197,136035,25281,8641,2254,1574,197022,6086,4485,10571,29875,14009,15866,94788,618
27037,"Dakota County, Minnesota",411402,202188,209214,38863,275344,77821,25573,5644,3092,409552,11657,9757,21414,29265,13140,16125,223600,1270
27089,"Marshall County, Minnesota",9406,4793,4613,28585,6556,1022,217,46,26,9335,363,287,650,698,302,396,4684,39
27129,"Renville County, Minnesota",14995,7603,7392,31215,10538,1216,246,55,38,14703,483,434,917,1533,616,917,7373,44
27031,"Cook County, Minnesota",5215,2606,2609,31831,4093,1001,421,140,58,5171,280,190,470,617,269,348,2653,10
72071,"Isabela Municipio, Puerto Rico",43919,21399,22520,8798,30444,4394,1480,91,126,43672,1474,1125,2599,23902,11581,12321,10298,13
72085,"Las Piedras Municipio, Puerto Rico",38466,18571,19895,10342,26111,3402,894,192,185,38423,1247,628,1875,18254,8165,10089,9879,211
72143,"Vega Alta Municipio, Puerto Rico",39018,18596,20422,10492,25906,3487,1187,173,186,38241,1320,713,2033,18572,8553,10019,9771,160
13291,"Union County, Georgia",22033,10784,11249,26755,17105,2089,1336,240,161,21553,1487,1184,2671,2822,1427,1395,7428,71
13311,"White County, Georgia",28140,13642,14498,23630,19738,2417,1254,275,158,27956,2074,1835,3909,5345,2411,2934,10990,6
13223,"Paulding County, Georgia",149830,72973,76857,26636,94847,15320,5956,1585,503,149128,9494,9162,18656,15974,6389,9585,69921,278
13245,"Richmond County, Georgia",201418,97454,103964,21464,129729,16896,6207,2501,1696,191611,14700,14480,29180,48495,21318,27177,81125,529
13019,"Berrien County, Georgia",18986,9394,9592,18064,12799,986,420,121,43,18696,2207,2048,4255,4811,2140,2671,6871,88
13013,"Barrow County, Georgia",73340,36165,37175,22978,47542,5567,1729,438,246,73194,6407,5919,12326,10548,4510,6038,31979,159
13065,"Clinch County, Georgia",6814,3418,3396,17145,4422,357,223,46,10,6701,665,725,1390,2368,1039,1329,2185,79
13131,"Grady County, Georgia",25145,12447,12698,20864,16758,1296,663,134,47,24957,2684,2568,5252,7337,3541,3796,9272,63
13313,"Whitfield County, Georgia",103653,51439,52214,22262,65576,5767,1910,1001,208,102871,11076,10555,21631,20126,9359,10767,44990,380
13193,"Macon County, Georgia",13846,7702,6144,15919,9578,525,224,14,54,11966,1340,1100,2440,3897,1695,2202,4226,157
13145,"Harris County, Georgia",32992,16487,16505,32373,22924,3667,1582,654,195,32534,2124,1548,3672,2722,1180,1542,14885,248
13321,"Worth County, Georgia",20988,10226,10762,20783,14295,981,393,43,43,20826,2039,1982,4021,3837,1806,2031,8580,34
13093,"Dooly County, Georgia",14089,7691,6398,16867,9953,773,245,75,28,12459,1146,1043,2189,3013,1246,1767,4970,176
13307,"Webster County, Georgia",2672,1364,1308,22206,1804,85,71,12,2,2667,107,230,337,596,218,378,1096,23
13125,"Glascock County, Georgia",3053,1491,1562,19815,2068,130,32,1,7,2962,237,243,480,450,226,224,1278,16
13051,"Chatham County, Georgia",282613,136383,146230,28765,186212,37771,16368,3985,3130,274555,22632,21577,44209,48550,19873,28677,130262,1183
48237,"Jack County, Texas",8866,5037,3829,25553,6105,474,158,17,9,7680,625,829,1454,1312,539,773,3118,4
48035,"Bosque County, Texas",17953,8845,9108,25763,12788,1599,535,73,54,17592,1869,1765,3634,2599,1153,1446,7058,52
48029,"Bexar County, Texas",1858699,915173,943526,26158,1171084,201468,80858,20598,12404,1828044,159943,148733,308676,313406,142070,171336,850829,6993
48023,"Baylor County, Texas",3639,1759,1880,30820,2625,546,123,14,15,3562,368,288,656,452,154,298,1423,17
48121,"Denton County, Texas",754650,371110,383540,37928,484647,140442,50188,7740,5994,750044,50537,49508,100045,64613,28257,36356,394108,3418
48167,"Galveston County, Texas",314485,155271,159214,33870,209066,39256,13771,4349,3103,309976,24641,22867,47508,41948,18648,23300,143505,1669
48393,"Roberts County, Texas",939,457,482,34555,619,150,41,3,1,939,53,65,118,17,11,6,402,0
48463,"Uvalde County, Texas",27055,13221,13834,19146,16580,1833,516,61,65,26672,3187,2799,5986,5484,2442,3042,11053,43
48037,"Bowie County, Texas",93483,47076,46407,24761,62830,7846,2771,823,350,88111,7349,7308,14657,17166,7480,9686,35977,433
48263,"Kent County, Texas",667,322,345,27515,498,82,30,7,0,617,48,24,72,72,30,42,315,5
48425,"Somervell County, Texas",8673,4265,4408,27095,5923,833,153,96,53,8476,864,786,1650,1485,530,955,3555,47
48199,"Hardin County, Texas",55624,27484,28140,29693,37262,4203,1396,176,217,55144,4958,4767,9725,6480,2757,3723,23983,236
48289,"Leon County, Texas",16923,8410,8513,27096,11819,1435,514,15,13,16821,1485,1573,3058,2694,1243,1451,6509,122
48351,"Newton County, Texas",14138,7082,7056,20800,9291,524,127,15,30,13929,1550,930,2480,2272,1003,1269,4384,171
48389,"Reeves County, Texas",14438,8676,5762,18992,9615,851,143,60,22,11611,1078,1189,2267,1697,892,805,4881,52
48453,"Travis County, Texas",1148176,578199,569977,38820,767787,227391,90355,22500,16365,1140612,99943,83890,183833,171023,79909,91114,612192,5319
48087,"Collingsworth County, Texas",3032,1537,1495,21356,2038,235,95,6,11,2964,357,270,627,582,203,379,1319,3
48143,"Erath County, Texas",40641,19969,20672,23511,23046,4448,1489,340,221,40139,4199,3906,8105,9500,3622,5878,19028,66
48345,"Motley County, Texas",1022,541,481,25908,707,103,12,0,8,1022,168,88,256,158,88,70,432,0
48083,"Coleman County, Texas",8476,4277,4199,26436,6067,586,158,62,56,8440,1042,1011,2053,1545,541,1004,3313,43
48325,"Medina County, Texas",47920,25100,22820,25572,31732,4166,1766,119,115,45561,3508,2918,6426,6340,2964,3376,20077,89
48213,"Henderson County, Texas",79213,38586,40627,24315,55294,6621,2624,276,148,78293,8135,7519,15654,14593,6431,8162,30124,168
48277,"Lamar County, Texas",49626,23988,25638,23625,33524,3819,1464,191,122,48984,4755,4850,9605,9691,4095,5596,20338,588
48267,"Kimble County, Texas",4453,2162,2291,26982,3457,415,118,54,0,4391,533,537,1070,831,386,445,2086,32
48477,"Washington County, Texas",34544,17235,17309,28517,23087,3640,1049,168,233,33862,3135,2080,5215,4645,1977,2668,14593,53
48429,"Stephens County, Texas",9787,5291,4496,23044,6566,770,293,30,18,9163,1015,1055,2070,2012,922,1090,3771,109
48003,"Andrews County, Texas",17215,8734,8481,29903,10197,754,228,20,83,17118,1306,1367,2673,1821,757,1064,7849,35
48177,"Gonzales County, Texas",20370,10296,10074,23635,13016,1287,358,46,98,20081,2192,2351,4543,3443,1505,1938,8681,83
48305,"Lynn County, Texas",5723,2891,2832,26758,3712,519,94,13,14,5700,756,609,1365,1128,476,652,2305,0
48505,"Zapata County, Texas",14335,7185,7150,17817,7970,426,214,23,0,14299,2161,2150,4311,4857,2407,2450,4989,18
48221,"Hood County, Texas",54217,26724,27493,32578,38953,6977,2388,428,244,53477,4287,4678,8965,6439,2471,3968,22129,193
48269,"King County, Texas",274,141,133,29918,211,33,6,0,10,274,53,12,65,9,5,4,164,0
48073,"Cherokee County, Texas",51257,26069,25188,21102,33344,4149,1207,233,199,48854,4853,4910,9763,10570,4754,5816,19619,148
48119,"Delta County, Texas",5226,2543,2683,22732,3631,462,185,0,27,5153,404,459,863,1110,464,646,1869,20
48253,"Jones County, Texas",19944,12822,7122,17960,14819,1304,265,51,4,12892,1062,1189,2251,2151,932,1219,5280,58
48249,"Jim Wells County, Texas",41486,20332,21154,20631,25755,2095,456,104,104,41072,4257,4363,8620,8471,3882,4589,16115,157
48111,"Dallam County, Texas",7052,3730,3322,25221,4106,413,72,0,1,7010,866,881,1747,1129,496,633,3408,36
48157,"Fort Bend County, Texas",683756,335925,347831,38382,434436,122699,52399,9182,9655,678500,45558,43563,89121,55523,24871,30652,319775,3244
48235,"Irion County, Texas",1631,838,793,32307,1079,111,35,4,19,1628,170,155,325,191,92,99,740,10
48489,"Willacy County, Texas",21944,11652,10292,13369,13669,945,192,36,9,19881,3037,2892,5929,7371,3428,3943,5992,9
48115,"Dawson County, Texas",13317,7478,5839,21360,8601,806,255,13,12,11465,1082,1307,2389,1866,630,1236,4741,38
18115,"Ohio County, Indiana",6003,3003,3000,27715,4384,382,161,45,19,5950,258,245,503,397,173,224,2851,30
18119,"Owen County, Indiana",21038,10665,10373,24220,14930,975,660,123,35,20879,1562,1096,2658,3074,1426,1648,9256,93
18121,"Parke County, Indiana",17033,8089,8944,21636,12024,981,382,36,18,15542,1296,1008,2304,2312,1026,1286,6621,54
18135,"Randolph County, Indiana",25403,12346,13057,23427,17429,1320,825,64,69,25042,1816,1655,3471,4319,1714,2605,11142,88
18183,"Whitley County, Indiana",33354,16660,16694,28073,22932,2628,1258,240,68,32979,1432,1354,2786,2876,1216,1660,16291,110
18007,"Benton County, Indiana",8709,4341,4368,23652,5832,753,188,42,12,8624,679,461,1140,1096,436,660,4042,28
18013,"Brown County, Indiana",14965,7470,7495,31365,11025,1238,1076,169,105,14833,996,740,1736,1882,851,1031,6853,8
18023,"Clinton County, Indiana",32692,16148,16544,23722,21431,2170,887,94,40,32067,1893,2015,3908,4052,1707,2345,14869,139
18133,"Putnam County, Indiana",37626,19799,17827,23842,24863,2129,971,223,415,34380,1958,1574,3532,3298,1248,2050,15739,31
18161,"Union County, Indiana",7251,3652,3599,22527,4974,576,250,40,57,7191,451,391,842,681,298,383,3304,8
18175,"Washington County, Indiana",27792,13783,14009,23223,18966,1399,865,76,70,27523,1840,1371,3211,4100,1843,2257,11708,69
18027,"Daviess County, Indiana",32583,16423,16160,21794,20085,1721,892,148,52,32117,3595,3648,7243,4329,2022,2307,14303,254
18029,"Dearborn County, Indiana",49552,24770,24782,30228,34006,4561,1816,352,60,49011,2115,2011,4126,4537,2075,2462,24371,181
18065,"Henry County, Indiana",48953,25487,23466,23293,34597,3645,1393,227,178,45714,3038,2543,5581,7349,3457,3892,19513,152
18083,"Knox County, Indiana",37956,19294,18662,23441,24770,2486,1095,117,76,37168,2048,2064,4112,4980,2358,2622,18053,196
18093,"Lawrence County, Indiana",45696,22624,23072,25036,31959,2972,1291,184,137,45047,2738,2717,5455,5771,2591,3180,20383,93
18095,"Madison County, Indiana",129862,64976,64886,23680,89705,10451,3966,684,501,124899,7955,6648,14603,20618,9519,11099,54723,643
18123,"Perry County, Indiana",19301,10316,8985,23003,13593,940,739,100,46,17585,807,789,1596,2561,1086,1475,8142,27
18125,"Pike County, Indiana",12554,6277,6277,25648,8810,737,356,14,4,12331,498,539,1037,1244,573,671,5840,36
18131,"Pulaski County, Indiana",12910,6544,6366,24445,8932,650,240,51,12,12767,755,636,1391,1710,680,1030,5726,107
18151,"Steuben County, Indiana",34279,17401,16878,26902,23294,3027,1234,206,179,34016,1943,1918,3861,3407,1469,1938,16288,126
18171,"Warren County, Indiana",8309,4119,4190,29312,5913,801,251,47,58,8222,249,260,509,639,233,406,3921,26
18179,"Wells County, Indiana",27836,13760,14076,25850,18735,2219,804,168,68,27243,1197,1238,2435,3421,1436,1985,13392,96
18031,"Decatur County, Indiana",26340,13033,13307,25548,17691,2106,858,196,56,26018,1430,1477,2907,3375,1436,1939,12691,73
18035,"Delaware County, Indiana",116463,56004,60459,23271,71040,9560,5104,750,1128,115036,7259,5590,12849,23995,10499,13496,50781,352
18077,"Jefferson County, Indiana",32482,15443,17039,25429,21973,2201,1237,143,164,30920,1573,1768,3341,4344,1873,2471,14101,121
18079,"Jennings County, Indiana",28023,14126,13897,22901,18740,1247,510,18,31,27779,1625,1536,3161,4217,2148,2069,12782,183
18103,"Miami County, Indiana",36093,19190,16903,22890,24750,1856,900,122,76,33875,1928,1473,3401,5416,2376,3040,14482,186
18109,"Morgan County, Indiana",69504,34395,35109,27402,47385,4957,1941,347,114,68702,3549,3319,6868,8547,3395,5152,32738,187
18111,"Newton County, Indiana",14022,7075,6947,24315,9835,717,247,45,28,13813,908,863,1771,1833,788,1045,6212,177
18141,"St. Joseph County, Indiana",267696,129850,137846,25893,173405,29937,13005,2851,3186,265189,15886,13801,29687,43926,19386,24540,121364,530
18085,"Kosciusko County, Indiana",78461,38893,39568,27884,51671,7043,3205,404,315,77740,4957,4701,9658,8423,3534,4889,37124,261
18155,"Switzerland County, Indiana",10484,5434,5050,21511,7070,421,131,16,17,10378,819,659,1478,2221,1098,1123,4353,58
18163,"Vanderburgh County, Indiana",181692,87909,93783,26917,122490,19679,8284,1474,1066,179266,10546,8567,19113,29710,12722,16988,85806,507
18015,"Carroll County, Indiana",20007,9959,10048,26589,13841,1595,624,146,47,19894,1267,1088,2355,2139,1017,1122,9217,81
18105,"Monroe County, Indiana",143292,71286,72006,26738,80706,18497,12266,1899,3772,142313,7571,6377,13948,32044,15293,16751,69028,281
18045,"Fountain County, Indiana",16741,8409,8332,25383,11569,1067,511,73,22,16552,981,571,1552,2081,949,1132,7264,47
18149,"Starke County, Indiana",23069,11361,11708,22153,15848,1282,430,74,54,23062,1097,1090,2187,3596,1529,2067,9395,71
18025,"Crawford County, Indiana",10582,5358,5224,19424,7413,437,221,57,11,10518,446,428,874,2034,925,1109,4281,44
18055,"Greene County, Indiana",32633,16217,16416,24744,22771,2079,954,191,43,32346,2228,1710,3938,4810,1903,2907,13974,140
18097,"Marion County, Indiana",932142,448928,483214,26284,608059,115366,42539,12050,6510,922012,69929,57858,127787,187586,84445,103141,437920,3444
19011,"Benton County, Iowa",25720,12853,12867,32356,17432,2807,794,157,34,25479,439,408,847,2324,1083,1241,12953,126
19061,"Dubuque County, Iowa",96359,47634,48725,30117,64082,12414,4624,1050,625,95117,2530,2017,4547,11616,4931,6685,50226,267
19071,"Fremont County, Iowa",7019,3508,3511,29813,4995,758,247,36,30,6899,318,180,498,713,357,356,3334,54
19151,"Pocahontas County, Iowa",7061,3504,3557,27553,4993,697,85,40,22,6905,282,175,457,885,376,509,3399,55
19173,"Taylor County, Iowa",6209,3129,3080,27344,4361,431,132,26,5,6110,394,284,678,802,349,453,2995,40
19177,"Van Buren County, Iowa",7380,3779,3601,24952,5170,483,167,4,4,7319,638,478,1116,1060,512,548,3301,58
19159,"Ringgold County, Iowa",5054,2463,2591,27621,3525,479,142,39,22,4864,229,251,480,533,208,325,2072,34
19003,"Adams County, Iowa",3822,1890,1932,27022,2748,326,108,19,6,3752,144,146,290,368,148,220,1904,14
19009,"Audubon County, Iowa",5793,2843,2950,31523,4208,377,110,39,27,5648,225,139,364,651,220,431,2901,8
19039,"Clarke County, Iowa",9273,4585,4688,25879,6210,730,182,44,0,9137,535,508,1043,1454,657,797,4607,19
19051,"Davis County, Iowa",8768,4325,4443,25747,5532,654,198,40,24,8657,1033,1084,2117,1617,696,921,3824,168
19093,"Ida County, Iowa",7041,3522,3519,30192,4933,782,109,33,15,6913,195,202,397,760,368,392,3473,24
19103,"Johnson County, Iowa",142006,70409,71597,33039,83193,23294,11324,4480,4522,140376,5334,4070,9404,23911,11491,12420,78847,663
19135,"Monroe County, Iowa",7964,4030,3934,25929,5421,633,143,21,36,7833,396,256,652,1032,419,613,3604,19
19179,"Wapello County, Iowa",35242,17353,17889,23413,24126,2764,1118,263,106,34879,1501,1199,2700,6033,2709,3324,15891,401
19167,"Sioux County, Iowa",34621,17444,17177,27339,20516,3881,1158,241,234,34213,1236,962,2198,2444,1022,1422,18552,55
19025,"Calhoun County, Iowa",9876,5101,4775,27370,7053,892,267,93,44,9214,252,214,466,1364,597,767,4341,67
19027,"Carroll County, Iowa",20555,10009,10546,29191,14015,2220,428,164,191,20204,319,338,657,1899,662,1237,10535,45
02261,"Valdez-Cordova Census Area, Alaska",9522,5065,4457,37935,6265,1355,473,29,28,9304,1095,848,1943,802,446,356,4505,147
02122,"Kenai Peninsula Borough, Alaska",57637,30103,27534,33336,39538,5805,2823,483,252,56486,6123,5263,11386,6175,2899,3276,24774,1733
02230,"Skagway Municipality, Alaska",1014,541,473,39376,807,217,47,0,8,1014,151,86,237,53,26,27,670,2
02198,"Prince of Wales-Hyder Census Area, Alaska",6374,3444,2930,26695,4325,426,184,35,38,6368,1182,802,1984,938,505,433,2611,160
02195,"Petersburg Borough, Alaska",3196,1712,1484,35044,2115,385,130,10,4,3181,263,234,497,294,145,149,1584,51
02158,"Kusilvak Census Area, Alaska",7993,4259,3734,11693,3773,110,68,1,2,7983,1325,750,2075,2862,1467,1395,2109,785
04013,"Maricopa County, Arizona",4088549,2021817,2066732,30186,2672410,527975,216435,52167,31038,4059129,305121,251219,556340,666513,309270,357243,1844233,22411
04007,"Gila County, Arizona",53179,26432,26747,22433,38557,4161,1987,331,360,52446,3787,3573,7360,11097,5018,6079,17506,283
04023,"Santa Cruz County, Arizona",46547,22284,24263,19482,28782,4333,1342,513,286,46228,3369,3776,7145,10083,4519,5564,17222,218
04012,"La Paz County, Arizona",20304,10366,9938,21707,15369,1021,433,37,113,20114,1227,1235,2462,4243,1987,2256,6263,38
04015,"Mohave County, Arizona",203629,102473,101156,23527,151909,11921,4326,1006,792,197267,14928,12633,27561,37884,17942,19942,65396,868
04005,"Coconino County, Arizona",138064,68229,69835,25722,80322,16006,7938,1640,1893,137298,12218,10291,22509,28193,13307,14886,63961,898
04025,"Yavapai County, Arizona",218586,106905,111681,27504,165655,25781,11918,2566,2046,217066,14415,13468,27883,31512,14837,16675,81006,618
04011,"Greenlee County, Arizona",9224,4905,4319,24935,5772,546,153,5,0,9184,521,531,1052,1216,588,628,3545,64
04021,"Pinal County, Arizona",397604,207471,190133,22944,269816,32073,13874,1809,2083,374716,23275,20206,43481,61430,28302,33128,138406,1562
05099,"Nevada County, Arkansas",8668,4489,4179,18644,6017,598,240,43,25,8480,694,561,1255,2615,1403,1212,3102,59
05037,"Cross County, Arkansas",17329,8379,8950,22894,11608,1047,520,103,42,17105,957,817,1774,3364,1338,2026,7002,115
05039,"Dallas County, Arkansas",7738,3748,3990,18309,5399,503,166,16,0,7161,392,429,821,1054,481,573,2914,16
05027,"Columbia County, Arkansas",24168,11514,12654,20296,15040,2240,939,49,68,23748,1235,1509,2744,5581,2363,3218,9930,60
05125,"Saline County, Arkansas",115577,56728,58849,28410,79783,12870,4957,994,750,114378,5664,4276,9940,9706,4613,5093,54369,362
05141,"Van Buren County, Arkansas",16892,8363,8529,20568,12417,1126,373,146,46,16699,1360,1207,2567,3084,1250,1834,5399,56
05065,"Izard County, Arkansas",13461,6980,6481,19737,10025,839,371,11,20,12627,808,840,1648,2775,1364,1411,4458,16
21005,"Anderson County, Kentucky",21867,10625,11242,24991,14970,1879,726,184,46,21759,900,647,1547,2453,1059,1394,10344,9
21027,"Breckinridge County, Kentucky",20000,10026,9974,20735,13867,790,614,53,0,19722,1307,940,2247,3350,1580,1770,7478,117
21071,"Floyd County, Kentucky",38144,18695,19449,18366,26544,1528,1225,260,110,37613,2691,1972,4663,11532,5629,5903,10862,27
21073,"Franklin County, Kentucky",49982,24386,25596,28001,34721,6065,2998,525,241,49183,2864,2018,4882,7054,3255,3799,22903,88
21117,"Kenton County, Kentucky",163393,80736,82657,30195,110045,20665,8312,2202,837,161869,7290,6418,13708,21805,9309,12496,80104,616
21147,"McCreary County, Kentucky",17850,9799,8051,11492,12283,483,371,81,11,16255,1077,582,1659,6906,3422,3484,4372,171
21151,"Madison County, Kentucky",87324,42491,44833,23733,53115,9272,4400,721,1071,86505,3911,3629,7540,17222,8035,9187,39409,585
21153,"Magoffin County, Kentucky",12887,6495,6392,17279,8842,433,247,213,4,12787,765,599,1364,3751,1817,1934,3497,13
21169,"Metcalfe County, Kentucky",9983,4882,5101,18449,6976,387,353,37,21,9887,812,671,1483,2250,883,1367,3766,24
21189,"Owsley County, Kentucky",4552,2037,2515,16582,3136,238,244,55,10,4474,153,286,439,1652,737,915,1264,44
21205,"Rowan County, Kentucky",24302,11766,12536,19032,13907,1366,1520,379,441,24080,1606,1233,2839,5510,2446,3064,9791,30
21213,"Simpson County, Kentucky",17856,8800,9056,22663,12174,1069,470,141,47,17509,1086,936,2022,3317,1412,1905,7683,90
21217,"Taylor County, Kentucky",25315,12390,12925,19885,16438,1492,912,287,153,24927,1633,1465,3098,6090,2611,3479,9845,137
21049,"Clark County, Kentucky",35706,17464,18242,26219,24981,3463,1312,195,144,35281,1750,1440,3190,5300,2105,3195,15773,211
21219,"Todd County, Kentucky",12465,6230,6235,19555,8082,538,288,95,28,12231,1092,1241,2333,2107,880,1227,4614,50
21039,"Carlisle County, Kentucky",4954,2408,2546,24015,3496,291,191,23,45,4885,359,268,627,798,330,468,2063,56
21041,"Carroll County, Kentucky",10776,5520,5256,22296,7196,489,296,78,39,10528,692,561,1253,2698,1159,1539,4397,19
21053,"Clinton County, Kentucky",10172,5087,5085,19325,6982,437,262,68,0,10020,803,414,1217,2245,1055,1190,3561,54
21065,"Estill County, Kentucky",14406,7062,7344,17728,10190,558,271,75,37,14281,924,692,1616,4326,1882,2444,4683,62
22083,"Richland Parish, Louisiana",20692,10072,10620,19975,13681,1220,477,139,45,19873,2793,2144,4937,4751,2122,2629,7615,92
22099,"St. Martin Parish, Louisiana",53385,26391,26994,23654,35313,3617,972,125,156,53131,3703,3549,7252,9103,3976,5127,23298,278
22127,"Winn Parish, Louisiana",14695,7735,6960,18417,10186,785,369,99,35,12959,1114,1121,2235,3319,1418,1901,5078,28
22033,"East Baton Rouge Parish, Louisiana",445337,213365,231972,30162,279129,60586,22403,6640,5839,442423,28272,24079,52351,85171,38045,47126,211782,1052
22003,"Allen Parish, Louisiana",25619,14808,10811,20103,17927,1200,666,191,72,21231,1451,1304,2755,3367,1501,1866,8373,227
22065,"Madison Parish, Louisiana",11803,5884,5919,15134,7756,576,282,39,35,10182,1434,1527,2961,3973,1760,2213,3785,65
22093,"St. James Parish, Louisiana",21581,10403,11178,25724,14516,1544,467,34,50,21366,1405,1365,2770,3496,1431,2065,8987,141
22043,"Grant Parish, Louisiana",22372,12543,9829,18509,15717,1028,344,50,45,18919,1183,1125,2308,3590,1489,2101,6966,162
22051,"Jefferson Parish, Louisiana",435204,211528,223676,28839,302942,50473,15723,6286,2697,431964,35743,28924,64667,69402,29275,40127,205709,2015
22011,"Beauregard Parish, Louisiana",36435,18600,17835,24551,24097,2801,850,188,97,35567,3212,2676,5888,6815,3073,3742,14360,486
22015,"Bossier Parish, Louisiana",124720,61707,63013,27235,81134,13396,5894,998,780,119149,6999,6803,13802,18867,8289,10578,59582,638
22037,"East Feliciana Parish, Louisiana",19756,10746,9010,21138,14229,1347,332,78,85,16829,928,953,1881,2885,1438,1447,6969,10
22095,"St. John the Baptist Parish, Louisiana",43888,21472,22416,23380,28685,3488,895,294,165,43206,3148,2501,5649,7851,3463,4388,18763,325
22073,"Ouachita Parish, Louisiana",156398,74967,81431,22538,99811,15723,6379,1310,724,150403,12265,12725,24990,35652,14120,21532,63077,369
22079,"Rapides Parish, Louisiana",132373,63960,68413,23486,86793,11037,4180,1228,786,129620,9231,8458,17689,25882,11560,14322,52733,866
22097,"St. Landry Parish, Louisiana",83699,40138,43561,19205,53830,4811,1688,421,160,82634,5603,6016,11619,23007,9893,13114,30208,233
22105,"Tangipahoa Parish, Louisiana",127115,61684,65431,23520,81365,11043,3621,815,626,126309,10126,9146,19272,27460,12106,15354,53527,1008
55089,"Ozaukee County, Wisconsin",87625,42971,44654,45820,60610,17900,6864,2613,906,87098,1789,1508,3297,4786,1891,2895,45356,75
55097,"Portage County, Wisconsin",70551,35384,35167,28363,44811,9245,2977,633,725,70241,2542,1606,4148,9454,4692,4762,36010,134
55105,"Rock County, Wisconsin",160986,79211,81775,26954,108352,14892,5920,1018,670,159593,7362,5480,12842,23215,10605,12610,75198,372
55119,"Taylor County, Wisconsin",20521,10498,10023,26290,14225,1318,479,87,31,20298,1287,855,2142,2511,1165,1346,9964,109
55001,"Adams County, Wisconsin",20294,10955,9339,24874,16147,1351,516,127,51,19127,901,567,1468,2420,1311,1109,7290,108
55007,"Bayfield County, Wisconsin",14987,7668,7319,28272,11440,2173,859,189,123,14880,734,582,1316,1693,764,929,6731,61
55081,"Monroe County, Wisconsin",45365,22874,22491,26724,30563,4006,1105,317,128,44491,2640,1833,4473,6192,2752,3440,21041,205
55141,"Wood County, Wisconsin",73621,36286,37335,29039,52074,6855,2438,893,428,72958,2502,1817,4319,7715,3263,4452,36106,174
55003,"Ashland County, Wisconsin",15936,8000,7936,22983,10791,1497,634,167,99,15708,686,641,1327,2347,1000,1347,7318,30
55037,"Florence County, Wisconsin",4474,2331,2143,28211,3520,460,119,25,12,4416,191,186,377,353,144,209,1911,18
55055,"Jefferson County, Wisconsin",84538,42212,42326,28819,57118,9388,3027,587,404,84082,3021,2189,5210,8350,3871,4479,43514,105
56005,"Campbell County, Wyoming",48473,25202,23271,33200,30492,4430,1012,249,122,48060,2656,2624,5280,3898,1746,2152,25596,499
56023,"Lincoln County, Wyoming",18543,9499,9044,29516,12259,1746,554,95,102,18431,1049,985,2034,1616,693,923,8846,38
56025,"Natrona County, Wyoming",80871,40903,39968,31900,54103,7721,3145,675,477,79755,6253,5447,11700,8333,3592,4741,41163,175
56009,"Converse County, Wyoming",14223,7121,7102,31948,9561,1050,331,39,65,14165,545,831,1376,1178,427,751,7179,20
56027,"Niobrara County, Wyoming",2498,1138,1360,23370,1764,284,29,13,9,2195,135,135,270,296,130,166,1077,12
56037,"Sweetwater County, Wyoming",44812,23381,21431,31700,28407,4205,1241,245,380,44531,3103,2758,5861,4868,2066,2802,22597,148
47177,"Warren County, Tennessee",40099,19775,20324,21339,27349,2095,1060,327,119,39588,3037,2002,5039,8158,3872,4286,16437,74
47179,"Washington County, Tennessee",126044,61224,64820,27334,85711,15482,7287,1680,2003,124245,7016,6740,13756,20810,9062,11748,57340,1004
47183,"Weakley County, Tennessee",34024,16549,17475,19699,21485,2898,1140,212,286,33592,1862,1287,3149,5962,2608,3354,13881,151
47005,"Benton County, Tennessee",16173,7958,8215,21282,11898,909,419,77,52,16021,1073,1079,2152,3614,1627,1987,5753,45
47007,"Bledsoe County, Tennessee",14073,7910,6163,21402,10223,651,427,59,14,12884,1067,787,1854,3050,1458,1592,4798,21
47013,"Campbell County, Tennessee",40008,19467,20541,21282,28628,1909,836,216,80,39509,2795,2246,5041,8821,3918,4903,14289,71
47015,"Cannon County, Tennessee",13855,6856,6999,24595,9873,873,292,78,40,13666,976,636,1612,2208,983,1225,5757,10
47083,"Houston County, Tennessee",8234,4120,4114,20819,5727,488,99,9,19,8037,524,479,1003,1672,846,826,2930,15
47119,"Maury County, Tennessee",85767,41287,44480,25872,58817,7696,2751,783,276,84594,4987,4413,9400,12413,5618,6795,38445,401
48373,"Polk County, Texas",46583,24995,21588,23023,33339,2886,874,121,108,42514,3986,4257,8243,7706,3321,4385,16425,524
48391,"Refugio County, Texas",7315,3599,3716,23959,4974,401,94,23,19,7145,590,605,1195,1124,529,595,3011,8
48467,"Van Zandt County, Texas",53070,26096,26974,25394,36590,4166,1461,172,165,52403,5379,5198,10577,8244,3733,4511,21953,79
48055,"Caldwell County, Texas",39848,20019,19829,23366,25450,2651,896,103,92,37894,4356,3562,7918,7014,3544,3470,17272,265
48487,"Wilbarger County, Texas",13061,6502,6559,21938,8704,1019,271,52,11,12898,1051,1154,2205,2086,1076,1010,6219,0
48317,"Martin County, Texas",5451,2783,2668,28560,3221,452,148,16,5,5382,558,642,1200,571,344,227,2461,37
48383,"Reagan County, Texas",3625,1933,1692,25273,2344,204,55,3,7,3590,616,489,1105,630,356,274,1704,16
48501,"Yoakum County, Texas",8316,4228,4088,23681,4872,614,205,37,12,8316,1009,973,1982,996,351,645,3564,0
48189,"Hale County, Texas",35007,18158,16849,19205,21158,2111,937,69,217,33206,3319,3422,6741,6740,2996,3744,14045,46
48419,"Shelby County, Texas",25705,12614,13091,20686,16393,1653,618,161,76,25514,3239,3099,6338,5792,2854,2938,9406,75
48387,"Red River County, Texas",12455,5917,6538,21177,8953,942,184,24,51,12241,1185,1059,2244,2020,876,1144,4761,69
48399,"Runnels County, Texas",10411,5181,5230,22190,7049,1014,193,38,33,10193,929,841,1770,1804,765,1039,4199,20
48435,"Sutton County, Texas",3936,2094,1842,31603,2535,351,60,16,0,3913,385,401,786,358,180,178,1711,23
48451,"Tom Green County, Texas",116264,57521,58743,27513,74147,11099,3891,913,730,111360,9458,9261,18719,15267,6463,8804,55019,778
48469,"Victoria County, Texas",90989,44622,46367,28181,58697,7764,2478,532,289,89879,8130,8001,16131,13166,5528,7638,42390,248
48481,"Wharton County, Texas",41377,20325,21052,25867,26867,2460,1224,124,95,41047,4109,3733,7842,7228,3167,4061,18107,44
48485,"Wichita County, Texas",132148,68567,63581,23263,84134,12481,4462,1189,524,117017,9071,10096,19167,21682,9035,12647,60583,685
48033,"Borden County, Texas",698,374,324,38923,460,117,46,5,0,698,13,14,27,18,6,12,281,0
48315,"Marion County, Texas",10191,5013,5178,25933,7758,618,299,14,54,10039,1055,770,1825,2161,933,1228,3618,45
48323,"Maverick County, Texas",56830,28129,28701,16658,31876,2643,744,310,28,56285,8403,9127,17530,13879,6150,7729,20614,216
48181,"Grayson County, Texas",124231,60695,63536,26535,83432,11028,4413,660,745,122860,11034,10412,21446,18877,8702,10175,54385,510
48297,"Live Oak County, Texas",11976,6566,5410,22847,8642,723,150,50,35,10385,998,1074,2072,1649,775,874,4225,62
48363,"Palo Pinto County, Texas",27922,13754,14168,24840,18947,2010,751,130,111,27636,3040,2989,6029,4916,2243,2673,11685,258
48255,"Karnes County, Texas",14984,8933,6051,27011,10311,942,206,79,37,12313,945,833,1778,2936,1261,1675,5266,19
48123,"DeWitt County, Texas",20660,10847,9813,28116,14529,1579,441,15,89,18868,1466,1328,2794,3038,1400,1638,7668,64
48059,"Callahan County, Texas",13596,6528,7068,22205,9508,967,329,80,23,13509,1515,1515,3030,2424,980,1444,5050,3
48067,"Cass County, Texas",30346,14694,15652,22145,21302,2180,762,117,18,29920,2426,2552,4978,5736,2383,3353,11839,369
48183,"Gregg County, Texas",123283,60416,62867,25144,78928,11172,3629,915,630,121233,12546,11735,24281,21785,9307,12478,54043,579
48313,"Madison County, Texas",13843,8758,5085,17436,9866,934,194,33,48,9490,859,951,1810,1561,711,850,4404,17
48303,"Lubbock County, Texas",294682,145467,149215,26196,172556,30155,12122,2852,3150,290327,23368,22943,46311,55027,25648,29379,140175,728
48257,"Kaufman County, Texas",111830,54970,56860,26631,71729,9478,3794,276,403,110814,9996,9326,19322,15160,6416,8744,50179,608
48259,"Kendall County, Texas",39010,18735,20275,39517,26868,7364,2147,637,420,38487,1859,1606,3465,2363,1077,1286,17120,253
48153,"Floyd County, Texas",6088,2961,3127,24347,3923,505,112,9,17,6041,764,625,1389,1330,572,758,2452,15
48017,"Bailey County, Texas",7131,3787,3344,18662,4317,333,90,9,32,6974,1070,985,2055,1322,520,802,3151,192
48051,"Burleson County, Texas",17417,8687,8730,27112,12083,1152,490,83,63,17239,1526,1905,3431,2329,1017,1312,7182,9
48355,"Nueces County, Texas",355667,175151,180516,26780,229139,30331,11624,2538,2370,350888,32526,31772,64298,59095,25591,33504,162087,1677
48379,"Rains County, Texas",11087,5653,5434,23976,8146,499,240,29,2,11021,1186,892,2078,1174,534,640,4348,35
48385,"Real County, Texas",3348,1611,1737,20873,2483,417,144,0,14,3254,380,470,850,599,282,317,1118,70
48431,"Sterling County, Texas",1233,651,582,25675,793,130,38,11,9,1193,169,125,294,184,93,91,584,32
48065,"Carson County, Texas",6027,2846,3181,31788,4007,662,338,9,50,5983,344,390,734,351,145,206,2822,0
48161,"Freestone County, Texas",19585,10246,9339,24060,13673,1156,344,47,27,17974,1553,1852,3405,2988,1273,1715,7467,43
19033,"Cerro Gordo County, Iowa",43303,21146,22157,31292,30829,4883,1299,377,180,42658,1542,1316,2858,5422,2069,3353,21882,139
19073,"Greene County, Iowa",9083,4442,4641,27968,6338,831,222,83,3,8968,246,238,484,950,375,575,4329,22
19083,"Hardin County, Iowa",17324,8648,8676,28445,12094,1748,518,148,52,16775,461,382,843,1328,525,803,8350,95
19117,"Lucas County, Iowa",8700,4370,4330,27234,6093,771,152,59,24,8566,304,297,601,910,444,466,4137,23
19119,"Lyon County, Iowa",11730,6010,5720,28356,7598,1208,268,67,73,11561,438,436,874,675,316,359,5863,9
22101,"St. Mary Parish, Louisiana",53053,26204,26849,22212,35182,2680,895,254,35,52200,4528,4027,8555,11227,4911,6316,20730,471
22123,"West Carroll Parish, Louisiana",11370,5750,5620,22857,7752,602,294,62,2,10633,1546,1564,3110,2551,1015,1536,3797,74
22111,"Union Parish, Louisiana",22460,11100,11360,20742,15527,1326,435,68,53,22009,1356,1726,3082,5438,2343,3095,8189,57
22021,"Caldwell Parish, Louisiana",9997,5287,4710,20961,6746,545,156,92,0,9522,1140,878,2018,2391,1140,1251,3711,91
22035,"East Carroll Parish, Louisiana",7419,4256,3163,14694,4597,403,77,9,29,5497,483,605,1088,2671,1025,1646,1836,2
22055,"Lafayette Parish, Louisiana",234963,114864,120099,30656,153993,33204,9855,2761,1742,232644,15514,15604,31118,37976,16279,21697,116412,1098
22039,"Evangeline Parish, Louisiana",33765,17283,16482,18655,21639,1837,549,174,19,31675,2409,2108,4517,8807,3935,4872,10989,100
22061,"Lincoln Parish, Louisiana",47480,23134,24346,21934,25500,5191,2647,399,781,46855,3759,3371,7130,13916,6304,7612,20612,136
22087,"St. Bernard Parish, Louisiana",44091,21801,22290,20431,28135,2884,583,160,94,43760,3034,2492,5526,8784,3775,5009,17518,246
22119,"Webster Parish, Louisiana",40335,19558,20777,19256,27591,2889,739,119,93,39416,3434,3146,6580,9693,4261,5432,14841,69
22121,"West Baton Rouge Parish, Louisiana",25017,12436,12581,28140,16661,2238,759,194,87,24331,1520,1054,2574,4933,2119,2814,11479,104
22047,"Iberville Parish, Louisiana",33159,16812,16347,22252,22836,2101,697,111,148,29615,2054,1549,3603,5465,2196,3269,12841,132
22081,"Red River Parish, Louisiana",8757,4230,4527,25154,5767,504,230,15,32,8635,714,668,1382,1953,831,1122,3258,134
22067,"Morehouse Parish, Louisiana",26739,12774,13965,18776,17919,1840,336,190,81,25966,2188,1952,4140,7441,3181,4260,9577,105
22071,"Orleans Parish, Louisiana",382922,182959,199963,29275,265166,54907,24396,11236,5391,377073,28794,24664,53458,97252,42376,54876,171776,1990
22109,"Terrebonne Parish, Louisiana",113099,55881,57218,24017,73521,7831,1911,626,152,111803,9785,8826,18611,22457,9871,12586,47783,1025
22019,"Calcasieu Parish, Louisiana",197233,96206,101027,26569,129071,17712,6378,1619,843,194872,14314,14038,28352,33266,13630,19636,86127,902
22027,"Claiborne Parish, Louisiana",16452,9408,7044,16384,11727,1034,379,72,36,14487,1310,950,2260,4367,2163,2204,5025,18
22009,"Avoyelles Parish, Louisiana",41252,20732,20520,20199,27923,1996,677,121,36,37646,3023,3178,6201,8671,3430,5241,14685,202
22007,"Assumption Parish, Louisiana",22973,11284,11689,25765,15542,1231,484,41,18,22772,1672,1467,3139,4186,1875,2311,9027,271
22077,"Pointe Coupee Parish, Louisiana",22366,10791,11575,27160,15406,1484,475,160,28,22241,1866,1580,3446,4182,1818,2364,8843,258
22113,"Vermilion Parish, Louisiana",59524,28756,30768,23608,38826,3561,958,122,141,59075,4113,3677,7790,10150,4176,5974,24528,390
22057,"Lafourche Parish, Louisiana",97688,47946,49742,26331,65045,7288,2223,498,501,96839,6552,6996,13548,14646,6215,8431,41984,1817
22029,"Concordia Parish, Louisiana",20288,10295,9993,17551,13544,1095,352,59,21,18203,2064,2746,4810,5794,2517,3277,6892,73
22059,"LaSalle Parish, Louisiana",14927,7767,7160,18836,10142,801,258,33,28,13599,1011,930,1941,3134,1340,1794,4970,127
30073,"Pondera County, Montana",6166,3100,3066,22866,4194,718,149,51,33,6095,517,383,900,1228,611,617,2559,7
30111,"Yellowstone County, Montana",155344,76301,79043,32296,105681,21546,6484,1896,964,153001,9571,8710,18281,15767,6585,9182,78556,480
30063,"Missoula County, Montana",113101,56928,56173,29681,74509,19180,7758,2451,1768,112445,7608,6206,13814,17671,8378,9293,58673,349
30081,"Ravalli County, Montana",41130,20385,20745,25151,30071,5055,2036,301,352,40885,3456,2987,6443,7173,3244,3929,16891,186
30105,"Valley County, Montana",7576,3805,3771,29096,5330,868,213,39,26,7462,505,338,843,711,367,344,3728,5
30013,"Cascade County, Montana",82049,41248,40801,28350,55400,9752,3535,878,206,78264,4632,4416,9048,11694,5094,6600,38785,198
30027,"Fergus County, Montana",11429,5750,5679,27491,8398,1890,390,72,50,11236,802,697,1499,1574,740,834,5279,63
30033,"Garfield County, Montana",1061,510,551,29896,758,80,25,6,0,1061,78,83,161,71,35,36,549,5
30061,"Mineral County, Montana",4223,2155,2068,22894,3119,278,65,22,30,4169,402,182,584,869,392,477,1550,9
30069,"Petroleum County, Montana",445,239,206,31549,357,43,27,4,2,445,41,61,102,69,38,31,246,2
30077,"Powell County, Montana",6928,4314,2614,23990,5335,588,315,15,44,5324,388,361,749,555,247,308,2583,22
30089,"Sanders County, Montana",11375,5837,5538,23020,8598,1072,240,36,60,11238,890,1180,2070,2493,1092,1401,3940,31
30109,"Wibaux County, Montana",1143,552,591,24662,834,151,13,2,2,1119,68,67,135,143,61,82,524,3
30031,"Gallatin County, Montana",97958,50509,47449,33181,61913,19538,6802,1600,1790,97611,5637,4308,9945,12716,6562,6154,53521,264
30059,"Meagher County, Montana",1960,937,1023,20095,1437,241,48,13,3,1933,170,160,330,295,107,188,917,10
30009,"Carbon County, Montana",10340,5171,5169,31697,7863,1539,522,121,111,10260,561,605,1166,1108,498,610,4965,98
30001,"Beaverhead County, Montana",9317,4649,4668,28420,6279,1299,367,135,137,9186,537,498,1035,1508,628,880,4429,48
30029,"Flathead County, Montana",94696,47281,47415,28379,66344,13146,3765,1458,821,94104,7105,6103,13208,12875,6079,6796,43478,311
30065,"Musselshell County, Montana",4778,2374,2404,23908,3413,309,137,47,5,4745,317,295,612,795,344,451,1858,0
31083,"Harlan County, Nebraska",3465,1824,1641,26375,2507,312,59,39,3,3413,176,196,372,542,254,288,1593,2
31185,"York County, Nebraska",13842,6799,7043,28298,9383,1891,539,130,100,13252,520,505,1025,1218,448,770,7067,25
31019,"Buffalo County, Nebraska",48402,24188,24214,28553,29339,6769,2143,416,493,47806,2185,1766,3951,6252,2814,3438,26885,165
31037,"Colfax County, Nebraska",10499,5449,5050,23393,6461,578,206,77,38,10411,700,516,1216,1227,630,597,5110,158
31087,"Hitchcock County, Nebraska",2866,1434,1432,25290,2078,197,94,5,10,2830,194,221,415,452,233,219,1312,0
31141,"Platte County, Nebraska",32703,16488,16215,28187,21282,3113,1000,274,166,32406,1555,1335,2890,2803,1286,1517,17167,58
31143,"Polk County, Nebraska",5242,2584,2658,32424,3655,575,175,25,11,5139,289,181,470,418,201,217,2726,15
31013,"Box Butte County, Nebraska",11279,5741,5538,28483,7528,836,291,56,0,11114,420,539,959,1544,592,952,5597,35
31017,"Brown County, Nebraska",3022,1439,1583,29664,2288,268,76,37,47,2978,157,205,362,512,231,281,1571,11
31161,"Sheridan County, Nebraska",5259,2586,2673,25817,3728,652,209,58,15,5176,416,357,773,870,418,452,2527,16
31109,"Lancaster County, Nebraska",301707,151180,150527,29901,186219,44728,16269,3956,4511,297490,15428,12216,27644,41105,18658,22447,161913,766
31129,"Nuckolls County, Nebraska",4352,2150,2202,24426,3196,358,114,35,24,4269,265,174,439,538,204,334,2221,4
31007,"Banner County, Nebraska",793,368,425,30736,569,65,11,12,9,793,29,52,81,95,24,71,422,0
31063,"Frontier County, Nebraska",2599,1303,1296,27900,1745,198,107,8,14,2590,126,141,267,269,90,179,1220,9
48071,"Chambers County, Texas",38072,18954,19118,31412,24206,3497,1400,98,121,37872,3119,3128,6247,4411,2063,2348,15729,352
48027,"Bell County, Texas",330859,165045,165814,25017,198709,30282,10889,3259,1747,308757,20472,19680,40152,47165,21421,25744,147488,1017
48061,"Cameron County, Texas",418785,202517,216268,16085,241653,28922,8241,2286,1086,416158,60464,66499,126963,136809,62680,74129,147810,2353
48117,"Deaf Smith County, Texas",19039,9478,9561,21209,11128,1190,303,58,30,18835,1839,1760,3599,3235,1382,1853,8348,26
48141,"El Paso County, Texas",833592,408310,425282,19950,499096,74860,25084,5120,3167,807800,92758,99160,191918,183925,80398,103527,345010,6105
48283,"La Salle County, Texas",7319,4240,3079,26268,4784,473,227,0,0,6382,846,776,1622,843,435,408,2238,0
48443,"Terrell County, Texas",778,376,402,21204,648,63,47,0,0,778,79,58,137,194,72,122,338,0
48457,"Tyler County, Texas",21371,11624,9747,21172,15013,1293,341,30,36,18648,1482,1518,3000,2903,1280,1623,6660,196
48483,"Wheeler County, Texas",5642,2866,2776,25809,3796,415,95,20,6,5573,624,530,1154,951,425,526,2584,37
48009,"Archer County, Texas",8750,4344,4406,31103,6090,1017,259,45,7,8677,571,515,1086,704,307,397,4259,44
48043,"Brewster County, Texas",9188,4363,4825,26073,6541,1365,760,73,156,9104,849,805,1654,1023,414,609,4261,45
48215,"Hidalgo County, Texas",828334,404079,424255,15883,457280,56372,17006,4425,1843,820004,128913,141076,269989,267812,121918,145894,296433,12263
48423,"Smith County, Texas",219745,106129,113616,26270,142257,24358,7555,1889,1293,217347,20595,19915,40510,36474,16506,19968,95273,1790
48105,"Crockett County, Texas",3836,1894,1942,23296,2508,201,58,7,11,3753,365,442,807,851,332,519,1752,0
48207,"Haskell County, Texas",5812,3236,2576,21120,4319,417,98,56,11,4869,525,418,943,1000,332,668,2204,21
48227,"Howard County, Texas",36423,20654,15769,22994,24500,2273,597,169,54,31343,2706,2660,5366,4646,1761,2885,14139,98
48333,"Mills County, Texas",4871,2332,2539,24858,3307,495,145,60,53,4699,259,394,653,678,251,427,1864,11
48337,"Montague County, Texas",19384,9485,9899,26278,13579,1469,429,87,20,19069,1976,2139,4115,3066,1218,1848,7998,47
48365,"Panola County, Texas",23771,11688,12083,26205,15929,1577,491,62,131,23558,2123,2035,4158,3372,1266,2106,10044,52
48403,"Sabine County, Texas",10367,5131,5236,20876,7512,589,375,0,8,10279,1220,1053,2273,2385,1164,1221,2774,35
48421,"Sherman County, Texas",3069,1609,1460,25358,2081,353,78,0,18,3028,439,280,719,413,143,270,1575,35
48437,"Swisher County, Texas",7639,3964,3675,18878,5041,548,181,18,0,7006,590,590,1180,1639,658,981,2633,0
48231,"Hunt County, Texas",89068,43952,45116,23942,58766,6501,2803,324,555,88217,8582,8209,16791,16281,7413,8868,35702,255
48063,"Camp County, Texas",12631,6191,6440,21069,8178,826,306,85,9,12565,1076,1137,2213,2422,1058,1364,5159,55
48195,"Hansford County, Texas",5552,2757,2795,21989,3454,569,133,3,13,5477,536,499,1035,1096,512,584,2530,35
48187,"Guadalupe County, Texas",147313,72752,74561,29300,95359,16388,7482,843,602,145117,10427,10567,20994,15190,6768,8422,68535,507
48077,"Clay County, Texas",10367,5177,5190,27593,7406,885,272,22,30,10289,785,875,1660,1575,791,784,4430,45
48205,"Hartley County, Texas",5966,3596,2370,20676,4405,643,170,36,36,4446,298,301,599,326,129,197,2127,9
48217,"Hill County, Texas",34901,17216,17685,23342,23759,2549,980,171,112,34223,3243,3491,6734,6457,2892,3565,14042,195
48293,"Limestone County, Texas",23469,12023,11446,21093,15761,1655,440,119,139,22523,3104,2292,5396,4976,2570,2406,8725,106
48347,"Nacogdoches County, Texas",65556,31292,34264,22589,37254,5654,2488,560,702,64749,6561,7077,13638,14631,6387,8244,27410,183
48369,"Parmer County, Texas",9921,5097,4824,21876,6005,659,247,19,37,9832,1223,909,2132,1637,718,919,4502,108
48367,"Parker County, Texas",123601,61585,62016,33367,82867,15543,5109,809,934,121523,8957,9590,18547,11377,4504,6873,56871,441
48377,"Presidio County, Texas",7144,3508,3636,15329,4652,630,396,138,0,7144,1214,1348,2562,1749,792,957,2378,25
48465,"Val Verde County, Texas",48862,24804,24058,20160,29121,3635,1047,175,229,46366,4977,5572,10549,9811,4368,5443,19160,564
48109,"Culberson County, Texas",2259,1168,1091,16763,1515,84,20,1,11,2248,269,185,454,535,229,306,1033,39
48135,"Ector County, Texas",153177,77333,75844,27728,90546,9817,2857,741,307,151759,17214,18094,35308,18777,8003,10774,70346,218
48169,"Garza County, Texas",6614,4213,2401,20635,4782,330,69,15,6,4650,497,486,983,624,301,323,2181,40
48173,"Glasscock County, Texas",1253,670,583,32885,821,171,31,3,2,1253,165,105,270,66,25,41,533,0
48185,"Grimes County, Texas",27140,14936,12204,23585,18708,1642,673,90,59,23784,1902,2233,4135,4819,2172,2647,10136,52
48085,"Collin County, Texas",886633,435186,451447,41609,574718,185636,80151,13923,8861,883650,54120,50410,104530,62651,28576,34075,452343,4217
48005,"Angelina County, Texas",87657,42765,44892,21974,56749,5877,2308,487,215,85415,8203,7965,16168,16688,7316,9372,34747,293
48101,"Cottle County, Texas",1560,763,797,20566,1088,125,39,9,3,1560,169,128,297,388,156,232,638,24
48209,"Hays County, Texas",185686,92221,93465,29253,109111,26571,9877,1327,1852,183896,14973,11861,26834,28863,12895,15968,91811,1191
48039,"Brazoria County, Texas",338419,171456,166963,32343,218876,40289,15788,3745,3048,327859,24860,24639,49499,34248,15269,18979,155872,1156
48129,"Donley County, Texas",3506,1785,1721,23212,2300,259,115,4,2,3448,406,217,623,481,201,280,1471,3
48013,"Atascosa County, Texas",47710,23760,23950,23973,30060,2788,1213,228,61,47223,4385,4302,8687,7208,2980,4228,19500,15
48353,"Nolan County, Texas",15017,7593,7424,23686,9791,888,285,48,18,14826,1367,1279,2646,2572,1155,1417,6381,100
48229,"Hudspeth County, Texas",3481,1745,1736,12543,2286,137,30,0,4,2981,301,530,831,1131,461,670,1101,29
48475,"Ward County, Texas",11396,5668,5728,26860,7178,686,283,26,17,11270,865,1094,1959,1873,839,1034,4711,84
48203,"Harrison County, Texas",66431,32573,33858,25123,43416,5549,1570,295,264,65764,6234,5618,11852,11499,5095,6404,27379,478
48327,"Menard County, Texas",2163,1150,1013,23613,1544,121,112,0,0,2109,389,247,636,282,111,171,833,4
48149,"Fayette County, Texas",24909,12292,12617,30405,17803,2277,544,132,90,24469,1543,1959,3502,2630,1054,1576,11259,126
48491,"Williamson County, Texas",490619,241189,249430,34575,319162,85385,31480,5163,3732,486835,28149,25985,54134,35045,15266,19779,240741,1584
48233,"Hutchinson County, Texas",21782,10853,10929,25154,14158,1540,395,118,111,21646,1725,1838,3563,3561,1343,2218,9265,27
48343,"Morris County, Texas",12653,6069,6584,22803,8836,1007,366,83,0,12501,962,1128,2090,2316,1020,1296,4620,62
48361,"Orange County, Texas",83751,41429,42322,27938,55812,6217,1888,249,115,83013,6648,6288,12936,12590,5451,7139,35404,403
48495,"Winkler County, Texas",7723,3959,3764,23483,4616,369,91,14,2,7626,797,989,1786,1319,501,818,3166,48
48201,"Harris County, Texas",4434257,2205342,2228915,30856,2792590,538089,208416,56242,37160,4413550,511082,467739,978821,763456,342085,421371,2092412,28875
48053,"Burnet County, Texas",44584,22025,22559,29247,31066,4851,1828,240,227,44235,3531,3478,7009,6346,3091,3255,18961,129
48171,"Gillespie County, Texas",25732,12550,13182,32557,18862,4505,1282,477,177,25321,2488,2110,4598,2725,1445,1280,11099,170
12033,"Escambia County, Florida",309574,153860,155714,25666,204939,34088,12240,2872,1795,292994,20598,16902,37500,42672,19894,22778,139093,997
12053,"Hernando County, Florida",176797,85023,91774,23495,131317,14414,5500,862,765,174905,13222,11062,24284,27175,12527,14648,59343,624
12057,"Hillsborough County, Florida",1323059,644746,678313,29806,888930,178230,70305,19070,11815,1311145,107014,90419,197433,213566,97274,116292,623337,5500
12091,"Okaloosa County, Florida",195798,99177,96621,30775,133072,23974,11759,1812,1633,183652,13024,11667,24691,22821,10137,12684,92694,1793
12123,"Taylor County, Florida",22582,12572,10010,16979,16320,991,518,63,32,18655,1388,1209,2597,2746,1208,1538,6928,76
12129,"Wakulla County, Florida",31314,17476,13838,22846,22313,2590,976,112,35,27721,1860,1444,3304,3970,1575,2395,13248,74
13187,"Lumpkin County, Georgia",31094,15371,15723,23364,19281,3133,1397,354,319,30787,2447,2024,4471,6426,3145,3281,14168,24
13189,"McDuffie County, Georgia",21558,10084,11474,20436,14220,1355,405,180,77,21193,1635,1889,3524,5537,2349,3188,8306,192
13201,"Miller County, Georgia",5911,2839,3072,21002,4078,330,90,21,24,5751,475,464,939,1441,564,877,2300,45
13211,"Morgan County, Georgia",17943,8612,9331,28830,12277,1598,638,259,55,17768,1162,1212,2374,2354,906,1448,7632,46
13149,"Heard County, Georgia",11571,5739,5832,20946,7846,452,251,83,38,11425,781,854,1635,1930,830,1100,4555,37
13219,"Oconee County, Georgia",35071,17207,17864,38639,22922,5046,3440,1019,1167,34874,1578,1480,3058,2485,1164,1321,16666,66
13095,"Dougherty County, Georgia",92326,42785,49541,20292,58156,6898,2945,1080,572,90428,8967,8705,17672,26982,11375,15607,33985,226
13111,"Fannin County, Georgia",24017,11646,12371,24845,18198,2009,730,362,124,23860,1762,1891,3653,4262,1531,2731,8760,172
13151,"Henry County, Georgia",214171,102486,111685,26924,136110,24060,9810,2231,1300,212951,13389,14424,27813,25657,11450,14207,92536,796
13153,"Houston County, Georgia",149137,72545,76592,26305,96336,13933,7431,1281,508,145953,10009,9371,19380,26411,11142,15269,65160,453
13175,"Laurens County, Georgia",47802,22691,25111,20687,31817,2541,1617,502,188,46786,3180,3266,6446,12972,5778,7194,16626,119
13183,"Long County, Georgia",17243,8627,8616,20321,10290,1136,392,17,23,16281,1657,1143,2800,2765,1383,1382,6403,256
13255,"Spalding County, Georgia",64006,31064,32942,21675,42819,4211,1479,482,418,62927,5910,4698,10608,14798,6122,8676,23516,144
13257,"Stephens County, Georgia",25584,12114,13470,21657,17097,1552,994,392,75,25577,2131,1940,4071,4995,2443,2552,9955,35
13271,"Telfair County, Georgia",16405,9452,6953,13594,12296,647,355,71,49,12591,1097,996,2093,3611,1298,2313,4383,81
13293,"Upson County, Georgia",26394,12595,13799,19624,17921,1375,728,203,87,25839,1844,2332,4176,5910,2764,3146,9463,120
13303,"Washington County, Georgia",20680,10436,10244,19238,14146,1217,430,80,13,18992,1298,1415,2713,4996,1905,3091,7490,124
13225,"Peach County, Georgia",26907,13007,13900,22388,16724,2006,1059,151,154,26774,2390,2394,4784,5206,2156,3050,10966,54
13229,"Pierce County, Georgia",19030,9564,9466,23754,12828,892,444,174,145,18883,1932,1621,3553,3764,1964,1800,7266,122
13231,"Pike County, Georgia",17843,8753,9090,25176,11962,1181,345,191,114,17580,1441,1482,2923,2120,1033,1087,7344,11
13251,"Screven County, Georgia",14114,6910,7204,20255,9604,940,300,94,47,13708,1337,1243,2580,3425,1526,1899,5390,65
13267,"Tattnall County, Georgia",25260,14743,10517,16279,17578,1271,492,191,44,19083,1477,1493,2970,5290,1939,3351,7196,286
13295,"Walker County, Georgia",68143,33874,34269,22564,47314,4816,1585,438,267,66802,4665,5571,10236,12273,5753,6520,27716,123
13135,"Gwinnett County, Georgia",874242,427930,446312,27945,551242,128282,48139,8864,7262,869082,81425,77722,159147,112999,51833,61166,416125,3391
13049,"Charlton County, Georgia",12968,6695,6273,19102,9123,427,265,66,62,11838,1171,1269,2440,2420,1306,1114,4601,86
13015,"Bartow County, Georgia",101942,50533,51409,24931,67331,8260,3185,781,240,101031,8027,7692,15719,14899,6461,8438,44727,682
13097,"Douglas County, Georgia",138283,66287,71996,25449,88440,14633,6537,1420,535,137173,10692,10754,21446,20805,9029,11776,63154,800
13161,"Jeff Davis County, Georgia",14953,7192,7761,18550,9527,528,288,158,50,14859,1275,1427,2702,3079,1109,1970,5450,21
13141,"Hancock County, Georgia",8747,4939,3808,15454,6529,362,227,113,9,6746,392,553,945,2111,907,1204,2166,3
13037,"Calhoun County, Georgia",6443,3882,2561,13865,4751,311,144,15,19,4606,416,490,906,1489,694,795,1645,1
13285,"Troup County, Georgia",69314,33253,36061,22091,44457,5002,2297,666,374,67874,4623,4783,9406,14388,5497,8891,28546,367
13021,"Bibb County, Georgia",154194,72823,81371,23426,99419,14679,6343,2062,1363,150680,11911,11385,23296,41075,17002,24073,59054,1128
13197,"Marion County, Georgia",8646,4246,4400,20154,6040,380,217,63,9,8549,841,552,1393,2151,846,1305,2954,121
13249,"Schley County, Georgia",5089,2513,2576,19761,3310,300,153,12,27,5089,510,481,991,1113,414,699,1961,3
13023,"Bleckley County, Georgia",12835,5911,6924,20667,7938,779,405,92,131,12474,799,648,1447,2593,1152,1441,4089,15
13109,"Evans County, Georgia",10733,5037,5696,20736,7134,739,218,40,80,10212,774,962,1736,2673,1090,1583,4161,287
13119,"Franklin County, Georgia",22188,10857,11331,19663,15156,1212,449,186,68,21987,2117,1930,4047,5426,2413,3013,7801,88
13103,"Effingham County, Georgia",55852,27755,28097,26765,35904,4422,1611,472,58,55252,3117,3361,6478,5985,2394,3591,25611,333
13171,"Lamar County, Georgia",18195,8767,9428,20458,11639,1422,365,54,156,17941,1544,1699,3243,3746,1864,1882,6685,100
13107,"Emanuel County, Georgia",22723,11166,11557,17944,14837,936,482,200,120,22047,2792,2129,4921,6465,3108,3357,7839,204
13239,"Quitman County, Georgia",2095,1045,1050,18921,1577,97,27,11,0,2095,217,156,373,538,215,323,646,6
13159,"Jasper County, Georgia",13571,6604,6967,19784,9206,541,296,61,56,13475,1122,972,2094,2685,1057,1628,5493,74
13173,"Lanier County, Georgia",10382,5247,5135,17739,6876,698,287,57,17,9840,1083,1044,2127,2827,1255,1572,3698,42
13179,"Liberty County, Georgia",63949,32636,31313,20966,35858,4583,1706,251,237,57948,4263,3756,8019,10443,4540,5903,27878,316
13205,"Mitchell County, Georgia",22778,11847,10931,16088,15341,1225,545,2,68,20550,2002,2395,4397,6085,2464,3621,7474,71
13253,"Seminole County, Georgia",8696,4140,4556,21257,6067,561,225,71,48,8594,781,808,1589,1639,678,961,2870,43
13289,"Twiggs County, Georgia",8363,4159,4204,17485,5884,379,248,58,0,8277,689,547,1236,2504,1149,1355,2443,9
13233,"Polk County, Georgia",41263,20107,21156,22314,27025,2043,1041,347,78,40989,3991,2753,6744,8229,3540,4689,16374,193
31055,"Douglas County, Nebraska",543253,267547,275706,32023,351559,86834,30721,9589,5064,536932,30900,26494,57394,75422,33432,41990,276802,2036
31147,"Richardson County, Nebraska",8149,4026,4123,28109,5931,867,205,40,21,7998,317,233,550,1439,679,760,3931,29
31089,"Holt County, Nebraska",10360,5145,5215,27858,7209,1092,311,83,40,10192,384,358,742,990,463,527,5500,54
31065,"Furnas County, Nebraska",4850,2363,2487,24522,3420,461,76,20,16,4768,243,202,445,739,283,456,2277,16
31151,"Saline County, Nebraska",14356,7231,7125,22324,8778,789,355,99,36,14066,847,722,1569,1586,673,913,6882,39
31173,"Thurston County, Nebraska",6989,3457,3532,19380,3799,405,136,46,16,6935,1097,993,2090,2168,1011,1157,2425,33
31177,"Washington County, Nebraska",20338,10064,10274,33136,13668,3098,796,182,104,20152,502,630,1132,1834,601,1233,10636,35
31031,"Cherry County, Nebraska",5781,2844,2937,27891,4205,578,139,22,63,5721,336,222,558,458,137,321,3328,38
31053,"Dodge County, Nebraska",36679,17969,18710,27162,24724,3267,1067,246,96,36114,2117,2104,4221,4192,1883,2309,18122,127
31069,"Garden County, Nebraska",1930,927,1003,35602,1492,246,45,33,3,1879,104,93,197,218,86,132,922,8
31123,"Morrill County, Nebraska",4843,2428,2415,25120,3339,489,131,11,3,4678,364,243,607,576,247,329,2379,25
31127,"Nemaha County, Nebraska",7101,3491,3610,28572,4606,955,295,32,45,6989,237,176,413,713,387,326,3482,4
31171,"Thomas County, Nebraska",675,357,318,29243,467,85,14,12,0,675,34,16,50,65,33,32,369,0
31043,"Dakota County, Nebraska",20697,10072,10625,22463,12661,1130,410,53,51,20487,1480,1631,3111,3273,1434,1839,10108,46
31003,"Antelope County, Nebraska",6421,3217,3204,28091,4492,599,199,20,16,6326,284,262,546,748,342,406,3086,44
31029,"Chase County, Nebraska",4061,1983,2078,33708,2796,413,75,6,23,3993,272,301,573,387,163,224,1974,54
31035,"Clay County, Nebraska",6313,3224,3089,27275,4333,604,155,29,20,6212,342,356,698,615,267,348,3075,31
31041,"Custer County, Nebraska",10784,5331,5453,32605,7519,1086,366,48,112,10659,620,521,1141,1152,452,700,5535,63
31061,"Franklin County, Nebraska",3076,1541,1535,28635,2276,327,67,30,3,3013,98,104,202,392,168,224,1526,5
31081,"Hamilton County, Nebraska",9118,4560,4558,31989,6201,1093,372,72,30,8972,248,204,452,804,339,465,4647,37
31095,"Jefferson County, Nebraska",7354,3580,3774,26859,5276,580,157,27,20,7241,280,218,498,846,323,523,3625,10
31101,"Keith County, Nebraska",8103,4090,4013,27890,5923,921,223,70,68,8041,518,491,1009,1023,543,480,3892,113
31115,"Loup County, Nebraska",542,258,284,29248,402,68,16,4,0,542,31,19,50,54,21,33,272,2
31135,"Perkins County, Nebraska",2911,1468,1443,30923,2063,284,133,50,10,2871,81,81,162,194,50,144,1440,5
31155,"Saunders County, Nebraska",20946,10530,10416,31163,14169,2412,1050,122,116,20665,607,456,1063,1897,781,1116,10654,85
31157,"Scotts Bluff County, Nebraska",36599,17667,18932,26532,24466,3424,1260,329,218,35999,2562,2384,4946,4791,2093,2698,17723,117
31103,"Keya Paha County, Nebraska",736,387,349,28981,549,70,15,12,6,736,26,25,51,77,37,40,424,0
31105,"Kimball County, Nebraska",3713,1869,1844,24011,2672,297,112,4,4,3652,265,288,553,377,154,223,1667,7
31111,"Lincoln County, Nebraska",35777,17588,18189,29687,24326,3670,1191,230,183,35369,1830,1883,3713,4200,1627,2573,17508,79
31139,"Pierce County, Nebraska",7179,3614,3565,28766,4878,801,208,28,6,7043,194,149,343,460,200,260,3624,35
31165,"Sioux County, Nebraska",1274,636,638,26852,898,205,50,6,0,1274,63,72,135,140,62,78,665,2
31021,"Burt County, Nebraska",6594,3241,3353,26421,4712,621,173,37,9,6492,260,313,573,647,266,381,2955,21
31025,"Cass County, Nebraska",25463,12760,12703,32509,17377,2957,1055,170,151,25002,696,770,1466,1764,865,899,12905,74
31039,"Cuming County, Nebraska",9055,4578,4477,28762,6095,909,222,65,20,8904,489,303,792,1102,372,730,4650,17
31051,"Dixon County, Nebraska",5809,2921,2888,26094,3918,501,208,9,25,5728,278,247,525,675,295,380,2879,8
31057,"Dundy County, Nebraska",1823,912,911,26949,1326,176,63,17,3,1785,115,100,215,151,74,77,845,14
31075,"Grant County, Nebraska",647,341,306,22693,460,77,23,1,0,647,52,26,78,103,45,58,329,6
31077,"Greeley County, Nebraska",2447,1220,1227,25544,1705,197,73,10,3,2419,74,87,161,211,78,133,1147,4
31079,"Hall County, Nebraska",61105,30720,30385,26419,39111,5139,1608,486,189,60335,4776,4176,8952,8894,4023,4871,31094,120
31085,"Hayes County, Nebraska",1013,558,455,27183,758,122,32,2,0,1013,105,87,192,80,42,38,511,3
31131,"Otoe County, Nebraska",15890,7809,8081,28567,10846,1649,477,68,54,15616,696,598,1294,1676,771,905,7947,74
31145,"Red Willow County, Nebraska",10884,5533,5351,25006,7299,893,290,112,34,10637,673,353,1026,1234,683,551,5414,114
31027,"Cedar County, Nebraska",8657,4396,4261,29694,5882,744,222,43,26,8508,265,225,490,881,396,485,4490,58
31045,"Dawes County, Nebraska",9082,4476,4606,24811,5468,1118,443,133,202,9004,624,632,1256,1272,516,756,4634,22
31097,"Johnson County, Nebraska",5167,3085,2082,22398,3737,437,126,12,24,4045,170,208,378,505,218,287,2054,10
31033,"Cheyenne County, Nebraska",10090,4956,5134,32995,7005,1288,338,55,31,9989,371,285,656,996,381,615,5473,12
31047,"Dawson County, Nebraska",23924,12122,11802,24912,15259,1541,551,152,78,23656,1574,1692,3266,3585,1602,1983,12066,56
31071,"Garfield County, Nebraska",1968,982,986,25856,1411,176,58,23,4,1928,99,70,169,140,57,83,997,10
31117,"McPherson County, Nebraska",425,219,206,27241,322,59,18,0,2,425,3,6,9,78,35,43,210,11
31125,"Nance County, Nebraska",3607,1781,1826,26852,2549,278,125,29,10,3510,171,158,329,436,223,213,1798,15
31167,"Stanton County, Nebraska",6022,3022,3000,29517,4023,620,114,22,16,5996,278,322,600,570,254,316,3099,15
31175,"Valley County, Nebraska",4240,2128,2112,27271,3025,463,120,25,16,4196,239,177,416,533,233,300,2212,0
32001,"Churchill County, Nevada",24148,12285,11863,25211,16346,1918,680,84,29,23277,1858,1832,3690,3851,1822,2029,9717,75
32005,"Douglas County, Nevada",47426,23909,23517,35727,35742,6067,2450,589,302,47119,3074,2610,5684,5148,2479,2669,20115,105
32027,"Pershing County, Nevada",6690,4364,2326,19201,5013,323,178,43,8,4670,428,387,815,767,311,456,2040,0
32011,"Eureka County, Nevada",1730,845,885,35606,1319,152,47,0,20,1725,173,114,287,186,95,91,897,0
32013,"Humboldt County, Nevada",17091,8899,8192,29215,10793,893,419,133,61,16864,1218,1579,2797,1997,879,1118,8246,82
32033,"White Pine County, Nevada",9893,5759,4134,25350,6966,613,350,12,3,8449,552,706,1258,1068,495,573,3424,63
32007,"Elko County, Nevada",52029,27082,24947,32498,32601,3904,1656,268,79,51382,3197,3177,6374,5401,2629,2772,26092,201
48113,"Dallas County, Texas",2513054,1238199,1274855,29810,1590088,301964,121728,33892,14405,2492805,306970,271043,578013,461045,205849,255196,1199288,21186
48311,"McMullen County, Texas",671,365,306,33472,474,42,24,11,0,671,74,18,92,59,34,25,254,10
48503,"Young County, Texas",18275,8997,9278,25661,12468,1569,602,127,20,17981,1906,1906,3812,2759,1167,1592,8526,128
48251,"Johnson County, Texas",157544,78506,79038,26574,102285,13109,3619,832,590,154914,15465,14447,29912,18706,8380,10326,69925,559
48223,"Hopkins County, Texas",35844,17592,18252,24236,23904,2623,1177,196,82,35387,3781,3753,7534,6880,2975,3905,14986,73
48357,"Ochiltree County, Texas",10577,5398,5179,24157,6174,773,188,19,31,10515,1342,1159,2501,1322,571,751,4746,57
48275,"Knox County, Texas",3807,1938,1869,21046,2504,347,105,4,3,3666,335,310,645,536,169,367,1450,5
48309,"McLennan County, Texas",243394,118704,124690,24273,146233,21012,7828,1452,2202,238968,19557,19896,39453,46681,20636,26045,107988,600
48095,"Concho County, Texas",4142,2851,1291,17513,3107,251,79,14,13,2756,220,235,455,293,97,196,1048,0
48137,"Edwards County, Texas",2028,935,1093,28968,1452,309,19,0,20,2015,174,166,340,156,100,56,924,29
48133,"Eastland County, Texas",18252,9045,9207,20433,12327,1286,425,58,28,17978,2217,1686,3903,3054,1467,1587,6786,43
48243,"Jeff Davis County, Texas",2221,1054,1167,25167,1744,354,231,7,78,2155,145,278,423,172,86,86,937,0
48247,"Jim Hogg County, Texas",5218,2605,2613,17761,3274,258,94,10,0,5194,679,456,1135,1088,535,553,1532,0
48339,"Montgomery County, Texas",518849,256808,262041,38012,336470,73435,26992,6035,4444,515754,40530,38240,78770,56804,25697,31107,234350,1845
48127,"Dimmit County, Texas",10842,5243,5599,17939,6563,402,249,39,0,10741,1736,1337,3073,2504,951,1553,3893,32
48479,"Webb County, Texas",266006,129588,136418,16316,144764,17812,5810,910,735,263804,38592,41027,79619,84134,37904,46230,97579,879
48011,"Armstrong County, Texas",1913,973,940,31219,1359,213,88,5,8,1845,88,38,126,177,73,104,915,2
48069,"Castro County, Texas",7875,4002,3873,22292,4702,429,137,32,19,7780,1340,1061,2401,1256,574,682,3170,40
48273,"Kleberg County, Texas",31877,16476,15401,19806,17682,2996,1202,34,236,31240,3548,2920,6468,7110,3366,3744,14101,91
48097,"Cooke County, Texas",38878,19299,19579,29067,25977,3776,1395,349,91,38363,3086,3113,6199,5726,2511,3215,17677,120
48107,"Crosby County, Texas",5987,2908,3079,20057,3835,376,73,10,4,5893,557,719,1276,1177,499,678,2427,75
48151,"Fisher County, Texas",3847,1807,2040,27750,2717,374,111,13,3,3822,364,349,713,752,295,457,1676,15
48131,"Duval County, Texas",11510,5882,5628,19085,7509,430,217,11,9,11003,1379,1668,3047,2675,1126,1549,3979,39
48031,"Blanco County, Texas",10918,5501,5417,31249,8123,1458,576,193,110,10805,910,1048,1958,1045,498,547,4661,51
48241,"Jasper County, Texas",35640,17406,18234,21402,24074,1775,552,88,143,34711,3116,3396,6512,5650,2357,3293,12435,287
48245,"Jefferson County, Texas",252993,129384,123609,25370,167128,21953,6960,1496,965,239093,25171,26122,51293,47369,19928,27441,102742,1016
48271,"Kinney County, Texas",3578,2111,1467,21395,2565,280,46,7,6,3202,412,319,731,654,314,340,1175,45
48359,"Oldham County, Texas",2069,1082,987,25461,1192,232,62,6,9,1624,104,96,200,215,71,144,734,9
48279,"Lamb County, Texas",13561,6873,6688,21760,8545,1087,326,61,17,13352,1423,1377,2800,2763,1255,1508,5652,121
48295,"Lipscomb County, Texas",3507,1898,1609,29995,2281,323,65,8,8,3458,306,317,623,358,156,202,1601,10
48307,"McCulloch County, Texas",8242,4182,4060,23398,5825,615,263,39,19,8105,823,835,1658,1484,560,924,3358,0
48319,"Mason County, Texas",4064,2095,1969,24519,3099,540,154,25,14,4052,525,366,891,604,307,297,2111,0
48125,"Dickens County, Texas",2237,1160,1077,24171,1629,159,60,0,14,2067,187,251,438,391,156,235,733,39
48287,"Lee County, Texas",16754,8456,8298,26740,11285,1331,465,83,43,16253,1032,1339,2371,2402,1003,1399,7530,72
48439,"Tarrant County, Texas",1947529,953334,994195,30857,1235550,255467,95008,16720,12547,1931815,182155,169602,351757,275899,124939,150960,934029,8402
48001,"Anderson County, Texas",57772,35381,22391,17466,41841,3152,1353,115,304,44462,3377,3611,6988,7561,3435,4126,19239,95
48139,"Ellis County, Texas",160225,79024,81201,28612,101769,15912,5045,786,592,158933,13730,12715,26445,17458,7966,9492,74611,328
48239,"Jackson County, Texas",14678,7199,7479,26809,9797,1215,356,65,54,14429,955,1195,2150,1863,727,1136,6408,0
48265,"Kerr County, Texas",50505,24368,26137,28484,36459,5942,2489,709,413,49538,4249,4321,8570,8158,3611,4547,20408,98
48331,"Milam County, Texas",24372,12126,12246,22911,16346,1794,585,128,54,23896,1924,1550,3474,3692,1589,2103,9088,22
48093,"Comanche County, Texas",13506,6708,6798,22751,9350,1135,333,51,71,13298,1499,1618,3117,2825,1305,1520,5286,58
48145,"Falls County, Texas",17265,8234,9031,17755,11869,1050,280,40,38,15473,1713,1207,2920,3756,1903,1853,5828,106
48047,"Brooks County, Texas",7217,3706,3511,13549,4218,409,189,0,16,6800,846,755,1601,2358,1200,1158,2477,2
48015,"Austin County, Texas",29107,14358,14749,30101,19665,2901,987,117,123,28847,2215,2534,4749,4163,1520,2643,13278,177
48261,"Kenedy County, Texas",558,297,261,13705,349,20,13,7,0,558,106,76,182,127,60,67,179,0
48089,"Colorado County, Texas",20792,10306,10486,26689,14303,1978,441,115,96,20446,1749,1631,3380,2854,1290,1564,9010,5
48409,"San Patricio County, Texas",66706,33444,33262,24613,42209,4333,1316,279,174,65906,6702,6177,12879,9397,4156,5241,28917,226
48381,"Randall County, Texas",128603,63181,65422,32922,83799,17114,6232,1218,933,127746,7882,8227,16109,13245,5621,7624,65782,271
48411,"San Saba County, Texas",5881,3076,2805,22481,4172,439,101,36,31,5203,616,404,1020,930,391,539,2279,25
48413,"Schleicher County, Texas",3171,1615,1556,28112,1961,259,116,0,0,3171,348,359,707,417,171,246,1497,31
48507,"Zavala County, Texas",12107,6087,6020,13105,6922,459,140,17,16,11858,1354,1215,2569,4248,1581,2667,4225,151
48057,"Calhoun County, Texas",21805,11039,10766,26909,14466,1443,628,109,50,21608,1739,1834,3573,3914,1826,2088,9574,90
48155,"Foard County, Texas",1320,642,678,26034,954,114,39,0,0,1284,86,100,186,89,52,37,533,0
48175,"Goliad County, Texas",7463,3754,3709,30075,5240,544,234,34,26,7359,383,436,819,1246,636,610,2874,0
48193,"Hamilton County, Texas",8232,4015,4217,26522,5912,918,305,21,26,7986,882,507,1389,1174,572,602,3425,2
48335,"Mitchell County, Texas",8995,5553,3442,19741,6156,542,104,1,36,6521,705,487,1192,654,270,384,2976,3
48449,"Titus County, Texas",32592,16017,16575,21090,19669,1878,735,230,137,32319,3450,3465,6915,6654,2944,3710,13749,291
48285,"Lavaca County, Texas",19654,9520,10134,29946,13622,1599,494,48,64,19201,1415,1291,2706,1995,777,1218,8752,55
48445,"Terry County, Texas",12724,6764,5960,21938,8062,652,258,68,0,11611,1744,1548,3292,1581,668,913,4567,103
48497,"Wise County, Texas",62089,31097,30992,27447,41319,5374,1308,157,147,61057,5295,5698,10993,7599,2991,4608,26602,94
48321,"Matagorda County, Texas",36719,18133,18586,23294,23821,2640,703,158,131,36310,3813,3997,7810,7877,3400,4477,15646,69
13269,"Taylor County, Georgia",8354,4028,4326,18482,5724,473,147,17,11,8137,898,726,1624,2310,1019,1291,2809,58
13275,"Thomas County, Georgia",44977,21310,23667,24047,30456,3305,1638,499,506,44305,3802,3706,7508,9377,4323,5054,16945,201
13279,"Toombs County, Georgia",27160,12685,14475,21309,17410,1877,790,204,92,26893,3123,2905,6028,7117,3152,3965,10196,258
13209,"Montgomery County, Georgia",9005,4610,4395,20114,5999,557,277,51,48,8603,666,711,1377,1879,856,1023,3469,90
13221,"Oglethorpe County, Georgia",14743,7397,7346,21858,10448,1011,566,83,76,14602,1095,973,2068,2612,1073,1539,6245,97
13247,"Rockdale County, Georgia",87569,41424,46145,24254,56812,10093,3420,662,574,86809,7140,7978,15118,14863,6665,8198,37121,151
13305,"Wayne County, Georgia",30006,15334,14672,19188,20107,1560,776,226,117,27799,2639,2936,5575,5684,2308,3376,9882,235
13309,"Wheeler County, Georgia",7932,5145,2787,11192,5691,213,59,9,0,5092,397,647,1044,1383,493,890,1541,21
13009,"Baldwin County, Georgia",45808,22995,22813,20114,27875,2715,1674,370,376,43707,3083,2618,5701,12503,5566,6937,16485,225
31067,"Gage County, Nebraska",21778,10807,10971,27424,15422,2320,541,131,111,21485,698,599,1297,2235,987,1248,10876,70
31099,"Kearney County, Nebraska",6548,3228,3320,31234,4513,754,262,49,12,6469,267,255,522,443,182,261,3397,0
31119,"Madison County, Nebraska",35125,17405,17720,26093,22768,3167,938,279,91,34492,1879,1695,3574,5071,2153,2918,18049,299
31137,"Phelps County, Nebraska",9236,4632,4604,30166,6301,1125,222,66,54,9013,284,274,558,740,240,500,4616,13
31179,"Wayne County, Nebraska",9414,4813,4601,27292,5254,1415,321,91,82,9375,262,313,575,990,642,348,4913,18
31107,"Knox County, Nebraska",8551,4175,4376,27283,5922,873,247,50,25,8321,439,479,918,1036,395,641,4180,19
31121,"Merrick County, Nebraska",7793,3854,3939,27223,5439,676,145,33,14,7678,345,341,686,753,352,401,3911,3
31133,"Pawnee County, Nebraska",2695,1339,1356,27196,1948,219,67,21,8,2654,261,170,431,538,247,291,1206,4
31183,"Wheeler County, Nebraska",805,411,394,28257,616,74,25,3,0,805,20,20,40,41,18,23,464,7
32015,"Lander County, Nevada",5907,3255,2652,30256,3751,274,192,25,38,5866,392,453,845,757,401,356,2702,24
32009,"Esmeralda County, Nevada",1069,500,569,23755,785,111,10,3,8,1064,98,117,215,126,26,100,417,0
32021,"Mineral County, Nevada",4519,2276,2243,22791,3368,251,131,0,15,4440,348,328,676,941,401,540,1823,0
32017,"Lincoln County, Nevada",5155,2821,2334,27218,3535,577,215,0,12,4681,350,244,594,595,360,235,1766,0
32031,"Washoe County, Nevada",439914,221166,218748,31879,299065,54621,21366,5936,4752,437176,33890,27910,61800,65024,30678,34346,209468,2238
32510,"Carson City, Nevada",54412,27785,26627,28044,38540,4925,2167,594,398,52488,4081,3213,7294,8744,4021,4723,23440,102
33013,"Merrimack County, New Hampshire",147715,72732,74983,34475,103791,22150,10458,2313,1349,144313,6060,4993,11053,12150,5164,6986,75456,646
33001,"Belknap County, New Hampshire",60392,29571,30821,33849,44280,8507,3582,1044,357,59647,3378,2996,6374,6124,2790,3334,30319,502
33017,"Strafford County, New Hampshire",125913,61524,64389,32540,81175,17584,8138,925,1613,124504,5996,5550,11546,11875,4930,6945,64349,685
34025,"Monmouth County, New Jersey",627532,305359,322173,46736,434984,113820,54097,13366,7002,623449,28309,23046,51355,47318,20047,27271,303317,1901
34037,"Sussex County, New Jersey",144694,71759,72935,41272,101456,23609,8268,1499,863,143484,5850,4456,10306,8358,3929,4429,73922,495
34013,"Essex County, New Jersey",792586,380718,411868,35133,526945,105847,47508,14474,7794,781004,63007,53939,116946,132940,57301,75639,353854,2986
34015,"Gloucester County, New Jersey",291286,141585,149701,36205,197574,40076,13994,3060,2019,289960,10462,8195,18657,23257,10096,13161,141661,1137
34031,"Passaic County, New Jersey",507204,246848,260356,29393,332386,58809,22383,5016,2574,503399,41870,34063,75933,83738,37060,46678,229862,3241
34003,"Bergen County, New Jersey",930310,450329,479981,46601,653207,194268,82657,22694,11096,924248,49760,43608,93368,69119,29556,39563,456128,4823
34041,"Warren County, New Jersey",107095,52215,54880,37001,74882,15158,5955,1116,565,106152,4726,3944,8670,8334,3650,4684,52857,211
34005,"Burlington County, New Jersey",450236,221808,228428,39528,312858,74124,29087,6798,3757,435857,14560,11043,25603,28440,12359,16081,220922,1246
35029,"Luna County, New Mexico",24627,12225,12402,16622,15743,1135,752,27,59,24252,2285,1766,4051,7153,3083,4070,7860,64
35055,"Taos County, New Mexico",32961,16084,16877,23229,24193,3909,2035,376,465,32777,2548,2148,4696,7168,3397,3771,13848,159
35007,"Colfax County, New Mexico",12716,6431,6285,21785,9362,1429,486,54,103,12230,742,635,1377,2620,1266,1354,4629,0
35021,"Harding County, New Mexico",565,290,275,30782,454,98,14,0,5,565,14,23,37,81,32,49,202,2
35037,"Quay County, New Mexico",8555,4260,4295,18220,5943,510,325,46,21,8514,466,192,658,1638,728,910,2976,18
28103,"Noxubee County, Mississippi",11098,5256,5842,16591,7266,672,352,14,17,10900,1005,735,1740,3510,1524,1986,4009,36
28137,"Tate County, Mississippi",28338,13846,14492,21671,18225,1920,712,238,77,27871,2342,1779,4121,4158,1841,2317,10905,110
28107,"Panola County, Mississippi",34319,16579,17740,20191,22250,2324,923,163,59,34122,2933,2406,5339,7630,3438,4192,12695,99
28161,"Yalobusha County, Mississippi",12380,5937,6443,20037,8434,693,367,17,71,12196,1002,606,1608,2630,1128,1502,4950,14
28029,"Copiah County, Mississippi",28780,13820,14960,18756,18770,1770,477,65,103,28632,2654,2449,5103,7844,3398,4446,9718,45
28049,"Hinds County, Mississippi",244596,114238,130358,22397,154494,25244,11951,3656,2450,242056,19081,17391,36472,60356,25684,34672,103400,1120
28145,"Union County, Mississippi",27989,13672,14317,19518,18531,1592,965,212,107,27741,2242,1891,4133,5277,1926,3351,11052,42
28139,"Tippah County, Mississippi",22061,10819,11242,19780,14491,1270,602,50,56,21958,1331,1360,2691,5103,2265,2838,8584,82
28035,"Forrest County, Mississippi",76274,36332,39942,20783,46623,6695,3724,764,786,75598,6830,5417,12247,19870,8782,11088,31891,1979
28071,"Lafayette County, Mississippi",52193,25377,26816,25719,29500,6752,2743,780,1451,51636,3158,2207,5365,11902,5728,6174,23002,159
28087,"Lowndes County, Mississippi",59785,28561,31224,23141,39356,5574,2447,510,286,57964,3991,4316,8307,12783,5198,7585,25103,274
28157,"Wilkinson County, Mississippi",9233,4888,4345,12722,6379,589,192,51,0,8188,778,582,1360,2913,1262,1651,2524,8
28065,"Jefferson Davis County, Mississippi",11771,5705,6066,17035,8174,767,366,19,39,11660,1117,1135,2252,4005,1658,2347,3958,53
28123,"Scott County, Mississippi",28268,13707,14561,20520,18170,1506,470,66,100,27998,2709,2440,5149,7412,3350,4062,10713,113
28163,"Yazoo County, Mississippi",27719,15297,12422,16927,18571,1481,687,89,130,23809,2364,1625,3989,8180,3657,4523,8049,56
05063,"Independence County, Arkansas",37030,17995,19035,23056,25007,2815,1136,249,206,36530,2456,2304,4760,6891,2868,4023,15376,179
05079,"Lincoln County, Arkansas",13935,8622,5313,13142,10073,570,153,24,39,9248,542,630,1172,2158,934,1224,3140,29
05083,"Logan County, Arkansas",21935,10961,10974,19708,15278,1519,406,41,22,21672,1016,1175,2191,4071,1873,2198,8337,62
05053,"Grant County, Arkansas",18046,8867,9179,25814,12376,1619,677,71,88,17886,824,799,1623,2318,1041,1277,7621,72
05035,"Crittenden County, Arkansas",49511,23382,26129,20721,31056,3688,1347,250,116,48967,2676,2956,5632,11991,4975,7016,19914,413
05047,"Franklin County, Arkansas",17799,8795,9004,19988,12041,1125,312,88,42,17472,912,798,1710,3684,1784,1900,6382,18
05045,"Faulkner County, Arkansas",120417,59053,61364,25240,72992,13492,5737,869,1153,119053,7420,6471,13891,18590,8274,10316,56370,462
05109,"Pike County, Arkansas",11017,5412,5605,20180,7692,653,410,42,37,10872,853,770,1623,1997,916,1081,4452,97
05069,"Jefferson County, Arkansas",72385,35626,36759,20371,48054,5384,1999,439,342,68132,3354,3801,7155,16959,7468,9491,26757,629
05089,"Marion County, Arkansas",16404,8105,8299,19200,12503,1253,573,61,28,16261,923,887,1810,3220,1392,1828,5337,0
05097,"Montgomery County, Arkansas",9100,4529,4571,21480,6746,495,278,40,31,8959,744,569,1313,1677,755,922,3264,2
05127,"Scott County, Arkansas",10661,5397,5264,18077,7144,406,225,90,35,10592,607,497,1104,2204,1078,1126,4071,47
05129,"Searcy County, Arkansas",7938,3974,3964,21475,5871,528,284,25,11,7847,577,470,1047,1619,801,818,2964,57
05131,"Sebastian County, Arkansas",127351,62214,65137,23916,83893,10756,3354,993,660,126307,8597,8648,17245,27745,12465,15280,54324,318
05033,"Crawford County, Arkansas",61927,30446,31481,22104,41418,3906,1180,266,260,61391,4086,3761,7847,11491,5578,5913,25208,36
05007,"Benton County, Arkansas",245231,121493,123738,30611,158777,32516,12489,2548,1228,243727,14477,13504,27981,27562,12673,14889,114069,559
05017,"Chicot County, Arkansas",11189,5452,5737,20560,7728,718,220,58,19,10515,645,698,1343,3252,1320,1932,3660,94
05059,"Hot Spring County, Arkansas",33440,17232,16208,20868,23482,2021,992,90,63,31449,1774,1924,3698,5347,2268,3079,13107,89
05071,"Johnson County, Arkansas",26025,12928,13097,18757,17050,1813,687,126,92,25840,1881,1459,3340,5418,2471,2947,10120,163
05077,"Lee County, Arkansas",9781,5575,4206,15610,6939,368,181,10,7,8175,746,424,1170,2447,1051,1396,2717,27
05087,"Madison County, Arkansas",15761,7918,7843,23203,10820,809,202,106,109,15678,1179,1161,2340,2823,1179,1644,6622,81
05049,"Fulton County, Arkansas",12186,6031,6155,19674,8909,605,360,8,10,12018,855,519,1374,2769,1319,1450,4275,40
05061,"Howard County, Arkansas",13487,6493,6994,23627,9063,945,416,62,4,13311,970,1054,2024,2605,991,1614,5356,65
05093,"Mississippi County, Arkansas",44199,21480,22719,20378,28100,2223,1001,120,207,43396,3023,2957,5980,11057,4678,6379,16709,330
05117,"Prairie County, Arkansas",8334,4093,4241,22653,5997,555,166,51,9,8201,517,476,993,1617,713,904,3326,46
05139,"Union County, Arkansas",40334,19599,20735,23463,27433,3875,1036,258,106,39945,2664,2555,5219,8220,3472,4748,16000,46
05023,"Cleburne County, Arkansas",25587,12731,12856,26189,18821,1817,690,242,146,25237,1877,1596,3473,3901,1728,2173,9625,135
05025,"Cleveland County, Arkansas",8421,4216,4205,23171,5760,594,250,52,11,8331,363,432,795,1671,752,919,3152,64
05057,"Hempstead County, Arkansas",22208,10653,11555,18817,14775,1173,614,31,46,21968,1548,1656,3204,5861,2623,3238,8480,98
05135,"Sharp County, Arkansas",17027,8345,8682,20078,12290,767,348,65,60,16849,1353,1114,2467,3711,1510,2201,5799,93
05143,"Washington County, Arkansas",219930,109797,110133,26371,131905,23824,10905,3603,2792,218127,16238,13283,29521,40272,18790,21482,103030,377
05003,"Ashley County, Arkansas",20989,10185,10804,20703,14337,1330,475,70,73,20822,1224,1312,2536,4131,1946,2185,7856,179
05031,"Craighead County, Arkansas",102884,50128,52756,25594,65447,10543,4154,973,948,101881,7715,6191,13906,18682,8451,10231,46201,344
32023,"Nye County, Nevada",43198,21547,21651,23740,32804,2776,1032,101,68,42783,3241,2804,6045,7346,3440,3906,14097,142
32029,"Storey County, Nevada",3941,1887,2054,36388,3217,508,115,57,64,3918,330,156,486,284,138,146,1804,0
32003,"Clark County, Nevada",2070153,1035722,1034431,27719,1391680,212135,73276,21699,10525,2046634,182956,163845,346801,307146,142299,164847,939569,12115
32019,"Lyon County, Nevada",51897,26220,25677,25063,36600,3531,1471,158,143,51580,4164,3570,7734,7876,3661,4215,19814,148
33005,"Cheshire County, New Hampshire",76320,37271,39049,32072,52514,10059,4595,970,886,75531,4286,2979,7265,7813,3436,4377,39237,304
33009,"Grafton County, New Hampshire",89164,43911,45253,35255,61876,12125,6987,2462,2471,88248,4673,4210,8883,9687,4272,5415,44106,632
33015,"Rockingham County, New Hampshire",300365,148646,151719,43474,215076,53790,24751,4054,2582,298124,10169,9104,19273,15240,6972,8268,165135,1131
33019,"Sullivan County, New Hampshire",43051,21130,21921,31301,31440,5424,2251,428,320,42577,2274,1773,4047,3812,1753,2059,20949,299
33011,"Hillsborough County, New Hampshire",404948,200979,203969,37622,281112,65589,28905,4130,3280,400673,18289,14433,32722,34231,15475,18756,213524,981
33007,"Coos County, New Hampshire",32219,17090,15129,25895,24695,2895,1131,211,148,30369,1925,1574,3499,4042,1967,2075,14548,157
33003,"Carroll County, New Hampshire",47416,23653,23763,35646,36385,7938,3245,667,362,46963,3456,2534,5990,4716,2037,2679,22372,197
34021,"Mercer County, New Jersey",371101,181642,189459,40064,247879,51947,32532,6467,9291,364680,20423,15071,35494,39606,17513,22093,175094,1583
34011,"Cumberland County, New Jersey",155744,79905,75839,23012,104849,10614,3094,881,374,143910,10024,8019,18043,26448,12004,14444,60412,1198
34035,"Somerset County, New Jersey",331686,161900,169786,51923,228768,66798,38376,8456,7538,328828,12589,10868,23457,16924,7618,9306,168915,1286
34029,"Ocean County, New Jersey",586166,282068,304098,33312,404208,74063,29022,5397,2602,580846,25075,21568,46643,64770,28989,35781,243336,2008
34001,"Atlantic County, New Jersey",274026,132741,141285,29941,187290,33037,10859,3174,1416,271249,17917,14961,32878,41469,18563,22906,124514,2426
34023,"Middlesex County, New Jersey",831852,409221,422631,36558,566559,140178,72092,12618,10055,822360,45976,38692,84668,71749,32022,39727,395050,6319
34033,"Salem County, New Jersey",64504,31407,33097,31681,44731,6265,2286,260,255,63330,3143,2483,5626,8692,3928,4764,28641,313
34009,"Cape May County, New Jersey",95404,46594,48810,36256,70266,14237,5407,1263,526,93279,4081,2960,7041,9695,4329,5366,42674,460
34007,"Camden County, New Jersey",511145,247229,263916,32931,347104,68238,26451,7935,3743,505436,28437,21209,49646,66882,28405,38477,239141,2148
34039,"Union County, New Jersey",550436,268169,282267,38163,371007,75296,34525,9031,5042,545797,41917,35406,77323,58464,24391,34073,264913,12913
34017,"Hudson County, New Jersey",668526,332210,336316,35910,470945,113760,50631,11201,5968,664616,64676,54738,119414,115156,50479,64677,338986,3734
34019,"Hunterdon County, New Jersey",125708,62725,62983,54200,88335,25921,12556,3019,2330,121613,2882,1976,4858,5499,2400,3099,64524,249
34027,"Morris County, New Jersey",498215,244099,254116,53491,346314,105914,53665,12956,7126,494402,17829,15208,33037,22483,9877,12606,254869,1158
35023,"Hidalgo County, New Mexico",4531,2227,2304,18338,3069,292,165,14,3,4421,301,332,633,1075,427,648,1745,15
35031,"McKinley County, New Mexico",74346,35924,38422,14077,43490,2854,1442,305,183,73990,10642,9421,20063,28089,13419,14670,22608,243
35043,"Sandoval County, New Mexico",138117,67822,70295,27406,92821,15962,8628,1396,1628,137348,8217,7279,15496,19739,9272,10467,58130,617
35017,"Grant County, New Mexico",28879,14257,14622,23898,20511,2847,1977,299,496,28483,975,930,1905,6086,2686,3400,10448,29
35009,"Curry County, New Mexico",50544,26213,24331,22628,30721,3684,2084,217,77,48070,4075,2923,6998,10676,4584,6092,22006,450
35015,"Eddy County, New Mexico",56369,28463,27906,28419,36493,3657,2114,189,233,55782,3385,3391,6776,7638,3204,4434,26214,139
35033,"Mora County, New Mexico",4598,2374,2224,16019,3012,286,66,0,45,4598,391,267,658,1036,592,444,1128,0
35045,"San Juan County, New Mexico",122537,60845,61692,22665,78121,7051,3812,791,431,121183,12785,10248,23033,24871,11777,13094,49278,300
28009,"Benton County, Mississippi",8378,4159,4219,18599,5730,375,201,57,23,8300,730,797,1527,1882,940,942,2934,60
28037,"Franklin County, Mississippi",7818,3811,4007,24864,5329,583,257,21,28,7736,656,582,1238,1442,702,740,2889,43
28027,"Coahoma County, Mississippi",24804,11476,13328,16699,15186,1816,608,155,37,24515,2028,1930,3958,8541,3659,4882,8324,75
28061,"Jasper County, Mississippi",16538,8038,8500,20619,11265,987,453,71,28,16454,1111,1082,2193,3641,1686,1955,6096,171
28067,"Jones County, Mississippi",68313,33207,35106,20958,44779,4665,2854,663,207,67566,4164,4443,8607,15859,6419,9440,26536,360
28147,"Walthall County, Mississippi",14812,7253,7559,20155,9826,566,347,42,2,14676,1223,1605,2828,3724,1663,2061,5158,148
28095,"Monroe County, Mississippi",36029,17184,18845,21643,24560,2726,907,101,91,35597,2164,2380,4544,7308,3134,4174,14027,19
28115,"Pontotoc County, Mississippi",30862,15393,15469,20421,19928,2059,694,89,94,30616,3278,2364,5642,5517,2618,2899,13007,201
28051,"Holmes County, Mississippi",18547,8830,9717,12394,11171,889,311,74,24,18401,1871,1654,3525,8046,3479,4567,5085,64
28005,"Amite County, Mississippi",12692,6302,6390,19665,9245,663,405,18,41,12585,881,947,1828,3519,1576,1943,4439,38
28089,"Madison County, Mississippi",101791,48681,53110,36627,66923,17618,8224,3136,1580,100675,4345,3769,8114,12720,5006,7714,48992,550
28013,"Calhoun County, Mississippi",14724,7018,7706,17837,9900,603,397,26,56,14554,1043,1091,2134,3791,1630,2161,5303,72
28091,"Marion County, Mississippi",25810,12554,13256,19610,17402,1416,578,126,98,25059,1973,2409,4382,6840,3060,3780,9161,398
28141,"Tishomingo County, Mississippi",19503,9461,10042,19379,13650,1002,345,82,55,19247,1326,1356,2682,3581,1555,2026,7815,83
28153,"Wayne County, Mississippi",20517,9871,10646,21515,13553,936,556,52,22,20398,1647,1200,2847,5144,2440,2704,7380,307
28041,"Greene County, Mississippi",13941,8190,5751,18002,9956,558,189,33,0,10622,954,1014,1968,1914,787,1127,3776,87
28093,"Marshall County, Mississippi",36196,17809,18387,19775,24478,2206,769,76,143,34915,2876,2826,5702,6230,2808,3422,14048,106
28119,"Quitman County, Mississippi",7634,3670,3964,15189,5029,470,144,36,0,7467,830,828,1658,2799,1178,1621,2187,4
28109,"Pearl River County, Mississippi",55167,27310,27857,22136,37048,3770,1250,94,143,54214,4443,4165,8608,10886,4830,6056,20214,299
28079,"Leake County, Mississippi",23011,11492,11519,18825,14471,1253,364,115,41,22235,1974,1832,3806,6013,2522,3491,8096,71
28099,"Neshoba County, Mississippi",29474,14131,15343,19243,18645,1884,578,105,111,29065,2415,2087,4502,6463,2659,3804,11951,168
28121,"Rankin County, Mississippi",147930,71428,76502,29055,100309,19007,7580,1947,1140,142384,8018,6907,14925,13568,5145,8423,69338,240
28151,"Washington County, Mississippi",48824,22920,25904,19247,31122,3790,1316,329,329,48395,4733,5065,9798,16831,7302,9529,16843,107
28077,"Lawrence County, Mississippi",12603,6176,6427,21826,8429,777,270,46,54,12593,984,1058,2042,2736,1253,1483,4704,65
28111,"Perry County, Mississippi",12174,5925,6249,19308,8295,549,139,51,8,12090,1217,973,2190,2375,904,1471,3940,183
28017,"Chickasaw County, Mississippi",17357,8437,8920,19609,11339,941,194,81,32,17056,1421,1156,2577,4623,1940,2683,6450,124
48371,"Pecos County, Texas",15826,9075,6751,19088,10590,672,304,29,11,13755,1323,1234,2557,1334,589,745,6155,59
48397,"Rockwall County, Texas",88010,43084,44926,38933,56673,14290,5366,1095,757,87235,5167,5060,10227,5380,2407,2973,42009,684
48441,"Taylor County, Texas",135234,66259,68975,25419,81927,13533,4435,1008,783,130152,10028,10395,20423,22653,9888,12765,63916,427
48447,"Throckmorton County, Texas",1520,709,811,27732,1127,180,34,1,9,1509,125,133,258,199,85,114,660,2
48471,"Walker County, Texas",69926,40883,29043,17194,45130,6204,1903,226,468,53304,3792,3697,7489,12072,5082,6990,22557,192
48499,"Wood County, Texas",43198,21423,21775,25955,31212,3727,1289,208,125,42336,3460,3613,7073,5556,2581,2975,15264,100
48007,"Aransas County, Texas",24729,12246,12483,29999,18302,2337,919,283,156,24313,2247,2082,4329,4124,1986,2138,9356,43
48079,"Cochran County, Texas",2955,1512,1443,19195,1845,99,50,26,0,2914,441,370,811,569,252,317,1180,8
48081,"Coke County, Texas",3228,1682,1546,24623,2382,361,99,10,18,3115,264,238,502,534,260,274,1465,17
48099,"Coryell County, Texas",75710,37638,38072,21171,46747,5032,1681,301,67,58144,2870,3062,5932,8697,3472,5225,30741,397
48211,"Hemphill County, Texas",4151,1985,2166,29470,2499,486,80,5,9,4099,480,598,1078,484,202,282,1884,6
48341,"Moore County, Texas",22186,11429,10757,21372,12804,1322,357,49,0,21988,2200,2088,4288,3908,1845,2063,10395,121
48375,"Potter County, Texas",121883,62660,59223,21941,76661,7772,2286,625,486,115136,13147,13001,26148,25187,11058,14129,52840,349
48405,"San Augustine County, Texas",8556,4174,4382,21066,6239,497,172,40,9,8324,906,869,1775,2213,1145,1068,2204,24
48417,"Shackelford County, Texas",3323,1655,1668,24296,2234,462,89,7,4,3306,312,274,586,609,336,273,1485,46
48427,"Starr County, Texas",63008,30589,32419,13167,34711,2257,869,23,71,62428,10811,11130,21941,23445,10272,13173,20402,121
48461,"Upton County, Texas",3475,1688,1787,25290,2152,126,60,27,0,3418,362,410,772,695,325,370,1347,15
48049,"Brown County, Texas",37935,18756,19179,24040,25646,3334,1018,236,163,36856,3015,2419,5434,6390,2829,3561,14782,69
48191,"Hall County, Texas",3162,1585,1577,20022,2073,178,52,20,10,3099,326,437,763,889,416,473,1135,12
48159,"Franklin County, Texas",10571,5369,5202,23642,7258,953,357,25,43,10460,1196,990,2186,1759,920,839,4231,39
48163,"Frio County, Texas",18542,10950,7592,16833,11103,655,153,0,0,15660,1772,2074,3846,3333,1562,1771,6648,42
48281,"Lampasas County, Texas",20357,9972,10385,26405,13907,1859,779,107,112,19844,1757,1457,3214,2751,1256,1495,8452,221
50019,"Orleans County, Vermont",27076,13573,13503,25392,19573,2843,1187,187,117,26433,979,710,1689,3831,1756,2075,11994,140
50013,"Grand Isle County, Vermont",6945,3455,3490,38635,5142,1042,508,153,91,6945,158,126,284,519,234,285,3666,19
50007,"Chittenden County, Vermont",160510,78529,81981,36384,104504,30655,14267,4030,2671,159261,3882,2479,6361,17335,7861,9474,88022,446
50015,"Lamoille County, Vermont",25136,12471,12665,31390,17329,4049,1677,400,175,25052,1144,816,1960,3148,1391,1757,13150,185
50011,"Franklin County, Vermont",48625,24147,24478,30624,33590,5236,1911,416,316,48126,1522,955,2477,4147,1805,2342,24536,120
50005,"Caledonia County, Vermont",30859,15385,15474,25896,21616,3563,1731,406,281,30473,1031,598,1629,3686,1554,2132,14330,112
50025,"Windham County, Vermont",43609,21419,22190,29819,31870,6403,3525,725,586,43168,1658,1025,2683,5906,2604,3302,21562,227
50003,"Bennington County, Vermont",36503,17838,18665,31313,25937,5472,2271,588,382,36040,1087,631,1718,4692,2294,2398,17301,244
50001,"Addison County, Vermont",36926,18312,18614,31051,25239,5286,2610,574,559,36690,1192,731,1923,2955,1394,1561,19279,69
50009,"Essex County, Vermont",6173,3119,3054,23022,4658,476,201,46,16,6173,285,146,431,912,412,500,2645,11
50023,"Washington County, Vermont",58963,29131,29832,32137,41932,9807,5271,1139,749,58466,1672,1085,2757,6487,2816,3671,31123,287
49027,"Millard County, Utah",12604,6389,6215,23283,7634,1122,313,54,23,12461,939,850,1789,1288,491,797,5311,20
49045,"Tooele County, Utah",61986,31323,30663,24069,35306,5574,1355,257,148,61538,2937,2441,5378,4429,1896,2533,26613,251
49053,"Washington County, Utah",151959,74981,76978,25415,95175,16227,6908,1775,1348,150485,11852,11383,23235,22151,10703,11448,58861,458
49025,"Kane County, Utah",7216,3574,3642,24836,4998,775,417,62,12,7131,818,438,1256,642,271,371,3075,30
49043,"Summit County, Utah",39009,19914,19095,52671,25688,8072,3404,1260,652,38880,2154,1935,4089,3084,1404,1680,20742,204
49019,"Grand County, Utah",9428,4814,4614,25662,6711,1249,444,87,42,9362,895,1058,1953,1579,820,759,4560,25
49031,"Piute County, Utah",1859,995,864,17455,1342,216,35,7,20,1822,203,132,335,304,151,153,597,11
49033,"Rich County, Utah",2284,1086,1198,19512,1382,213,45,0,24,2279,117,246,363,359,112,247,710,8
49051,"Wasatch County, Utah",27895,14176,13719,30086,16567,4109,1315,520,176,27724,1686,1911,3597,2441,1223,1218,12935,112
49001,"Beaver County, Utah",6437,3291,3146,21128,3741,580,162,27,30,6360,433,531,964,743,371,372,2751,17
49003,"Box Elder County, Utah",51528,25937,25591,22808,30115,4581,1506,203,149,51123,2184,2063,4247,5250,2430,2820,21459,73
49021,"Iron County, Utah",47751,23735,24016,19791,26157,5092,1764,266,272,47337,3853,3670,7523,10107,5111,4996,19758,92
49039,"Sanpete County, Utah",28551,15074,13477,17426,16267,2154,748,90,175,25989,2010,1922,3932,4265,1695,2570,10361,48
49041,"Sevier County, Utah",20913,10688,10225,21196,12845,1334,661,75,50,20566,1492,1448,2940,2973,1241,1732,8446,64
49057,"Weber County, Utah",241328,121181,120147,25275,147300,23458,8526,1238,1101,238430,14774,13865,28639,29410,13863,15547,111359,847
49037,"San Juan County, Utah",15540,7789,7751,17385,8809,957,501,37,45,15279,1874,1757,3631,4171,1952,2219,5104,3
49035,"Salt Lake County, Utah",1092518,548834,543684,30134,676004,141684,54578,14391,11081,1084951,78591,67552,146143,122608,56805,65803,542042,3674
49009,"Daggett County, Utah",751,434,317,28533,530,53,24,0,0,629,11,14,25,30,5,25,279,5
49055,"Wayne County, Utah",2716,1388,1328,22195,1789,347,118,7,49,2692,261,218,479,366,192,174,1223,4
49007,"Carbon County, Utah",20733,10315,10418,22536,13164,1494,388,100,56,20517,1450,1186,2636,3128,1441,1687,8807,18
49029,"Morgan County, Utah",10645,5404,5241,30457,5950,1533,545,128,57,10645,385,491,876,434,204,230,4358,12
49005,"Cache County, Utah",118824,59450,59374,21752,59367,14418,4828,707,1611,118122,5818,5406,11224,17367,8181,9186,55055,354
49023,"Juab County, Utah",10507,5465,5042,20457,5830,714,223,39,9,10368,721,621,1342,1470,685,785,4201,8
51095,"James City County, Virginia",71900,34876,37024,42047,51936,13855,8059,1442,1453,70246,2855,2461,5316,5595,2604,2991,32169,202
51167,"Russell County, Virginia",27973,13693,14280,21673,20317,1793,741,55,76,27748,1977,1561,3538,4710,1938,2772,10413,15
51173,"Smyth County, Virginia",31513,15623,15890,22319,22711,2033,1072,128,126,30958,1819,1654,3473,5477,2624,2853,12605,133
51540,"Charlottesville city, Virginia",45538,22057,23481,32860,28530,6736,4189,1808,1543,45130,2178,2358,4536,11153,5208,5945,23932,285
48197,"Hardeman County, Texas",3952,1934,2018,21517,2790,306,60,7,3,3938,448,365,813,606,256,350,1584,41
48045,"Briscoe County, Texas",1672,849,823,23199,1150,208,44,7,5,1672,181,176,357,239,113,126,739,5
48291,"Liberty County, Texas",78598,38970,39628,22153,51374,3769,1108,175,105,71930,7796,7325,15121,12448,5366,7082,27704,194
48301,"Loving County, Texas",76,40,36,35530,67,2,0,0,0,76,5,10,15,12,5,7,39,0
48395,"Robertson County, Texas",16537,8214,8323,23337,11091,1346,452,35,92,16332,1645,1479,3124,2460,1205,1255,6981,58
48401,"Rusk County, Texas",53197,27866,25331,23521,36050,3653,1380,162,108,48414,5005,5087,10092,7945,3372,4573,20417,82
48455,"Trinity County, Texas",14360,6844,7516,20369,10493,951,271,25,31,14261,1413,1395,2808,2206,1028,1178,4644,69
48019,"Bandera County, Texas",21015,10420,10595,29177,15999,2504,867,159,316,20818,1601,1504,3105,3409,1727,1682,8473,45
48075,"Childress County, Texas",7059,3954,3105,18694,4771,495,242,0,5,5880,499,406,905,1342,567,775,2456,0
48091,"Comal County, Texas",124234,61175,63059,35841,86147,19803,7665,1177,1088,123157,8896,8165,17061,11356,4790,6566,55913,635
48225,"Houston County, Texas",22802,12225,10577,17884,16633,1787,459,92,75,19733,1578,1544,3122,4801,1857,2944,7900,97
48349,"Navarro County, Texas",48177,23714,24463,22152,31446,3301,1285,266,95,47408,4650,5175,9825,9418,4100,5318,19475,79
48415,"Scurry County, Texas",17314,9353,7961,24140,11161,1254,399,39,30,15811,1123,1215,2338,1261,494,767,7113,26
48433,"Stonewall County, Texas",1233,619,614,28063,886,82,34,0,4,1177,88,95,183,221,116,105,488,0
48021,"Bastrop County, Texas",78286,39861,38425,25172,51873,6482,1991,465,587,76165,7312,7337,14649,10350,4690,5660,31923,201
48025,"Bee County, Texas",32706,19761,12945,17504,22211,1194,484,128,172,25172,2587,3139,5726,5121,2326,2795,10092,104
48103,"Crane County, Texas",4823,2462,2361,24582,2936,261,91,26,0,4724,356,449,805,550,236,314,1986,21
50021,"Rutland County, Vermont",60133,29550,30583,28443,43294,7830,3492,809,509,59518,2111,1342,3453,7122,3242,3880,29426,160
50017,"Orange County, Vermont",28897,14381,14516,29651,20886,3753,1750,450,353,28815,1080,688,1768,3477,1606,1871,14857,147
50027,"Windsor County, Vermont",55894,27401,28493,34264,41734,8408,4323,975,975,55056,2211,1465,3676,5456,2472,2984,27593,93
49049,"Utah County, Utah",564177,284413,279764,23207,273764,72005,22923,4422,5057,560627,29427,28259,57686,69019,32424,36595,245975,1904
49013,"Duchesne County, Utah",20078,10166,9912,23323,11447,1165,334,73,44,19736,1377,1466,2843,2381,1001,1380,7759,41
49047,"Uintah County, Utah",36308,18533,17775,25001,20676,2307,537,160,78,35960,2761,2444,5205,3406,1649,1757,15264,52
49011,"Davis County, Utah",329292,165706,163586,28293,188855,46287,15990,3036,1557,326213,13671,12269,25940,23498,10298,13200,151810,1200
49015,"Emery County, Utah",10570,5359,5211,21465,6394,680,104,57,19,10516,584,532,1116,1258,479,779,3903,17
49017,"Garfield County, Utah",5020,2641,2379,23228,3296,487,156,4,15,4796,509,405,914,647,284,363,2062,22
51093,"Isle of Wight County, Virginia",36027,17600,18427,33172,25624,4314,2043,438,218,35549,1411,1219,2630,3901,1715,2186,17202,32
51620,"Franklin city, Virginia",8413,3699,4714,24820,5766,813,400,60,18,8283,526,531,1057,1383,774,609,3433,13
51678,"Lexington city, Virginia",7036,3979,3057,16668,2533,596,303,122,116,5595,221,192,413,653,149,504,2105,0
51089,"Henry County, Virginia",52209,25094,27115,21473,37910,2828,1080,151,324,51630,3280,3198,6478,9776,4027,5749,20267,164
51101,"King William County, Virginia",16156,8003,8153,31192,11247,1493,495,71,34,16100,646,668,1314,1953,879,1074,7963,96
51109,"Louisa County, Virginia",34350,16874,17476,30237,24702,3329,1553,284,250,34252,2648,2325,4973,4086,1759,2327,15603,196
51147,"Prince Edward County, Virginia",23077,11532,11545,19751,12968,1504,916,287,302,22233,1331,1198,2529,3355,1311,2044,8947,512
51165,"Rockingham County, Virginia",78427,38501,39926,28884,53298,7900,3684,608,899,78063,4918,4249,9167,8888,3982,4906,37267,360
51181,"Surry County, Virginia",6731,3317,3414,27162,4956,803,255,47,26,6731,476,415,891,804,408,396,3079,47
51043,"Clarke County, Virginia",14307,7087,7220,38658,10161,1715,968,178,186,14118,932,1059,1991,1587,678,909,6912,14
51117,"Mecklenburg County, Virginia",31209,15133,16076,22970,22993,2515,1158,188,78,30071,2044,1853,3897,5328,2380,2948,12224,289
51015,"Augusta County, Virginia",74330,37572,36758,30088,53700,8256,3110,577,580,70836,3943,3453,7396,6550,2542,4008,34026,233
51075,"Goochland County, Virginia",21979,10791,11188,47610,16290,3733,1281,615,247,20746,563,596,1159,1033,387,646,10171,69
51113,"Madison County, Virginia",13122,6410,6712,29705,9304,1471,674,105,136,12946,1130,864,1994,1510,664,846,5851,52
51161,"Roanoke County, Virginia",93655,44946,48709,33717,66984,15057,4840,1851,1088,92050,3534,2502,6036,7270,3144,4126,44840,207
51025,"Brunswick County, Virginia",16573,8668,7905,20278,11932,870,492,66,50,14924,1102,753,1855,3184,1378,1806,6424,168
51131,"Northampton County, Virginia",12118,5772,6346,24835,8831,1221,526,84,66,11799,996,968,1964,2568,1009,1559,4682,24
51163,"Rockbridge County, Virginia",22450,11150,11300,31534,16817,2135,1178,515,397,22273,1514,1069,2583,3274,1526,1748,9917,95
51720,"Norton city, Virginia",3978,1763,2215,19297,2800,339,128,9,9,3921,233,180,413,1040,498,542,1632,0
51570,"Colonial Heights city, Virginia",17554,8068,9486,27608,12254,1703,754,61,161,17388,904,906,1810,2241,950,1291,7745,179
51021,"Bland County, Virginia",6612,3733,2879,23505,5082,651,127,21,23,5733,219,329,548,555,309,246,2548,15
19189,"Winnebago County, Iowa",10580,5157,5423,26558,7372,1248,273,52,16,10359,255,191,446,1023,472,551,5079,26
19147,"Palo Alto County, Iowa",9155,4567,4588,27902,6288,1070,263,31,24,8956,284,159,443,797,343,454,4641,38
19165,"Shelby County, Iowa",11944,5852,6092,30799,8436,1357,332,65,25,11727,466,369,835,1174,534,640,6004,42
19007,"Appanoose County, Iowa",12602,6265,6337,25543,8950,1215,276,93,38,12478,614,562,1176,1998,963,1035,5565,22
19087,"Henry County, Iowa",19941,10147,9794,26340,13629,1931,510,84,43,18781,576,459,1035,2508,1253,1255,8848,211
19095,"Iowa County, Iowa",16326,8101,8225,29881,11335,1375,568,93,76,16082,546,388,934,1575,717,858,8564,40
19099,"Jasper County, Iowa",36715,18811,17904,27214,25786,3651,756,144,67,35077,1187,972,2159,3227,1486,1741,17166,61
19145,"Page County, Iowa",15552,8036,7516,25739,11096,1708,537,129,54,14648,737,476,1213,2193,1089,1104,7065,82
19191,"Winneshiek County, Iowa",20789,10393,10396,29052,13571,2335,919,134,355,20514,475,328,803,1472,641,831,11918,87
19157,"Poweshiek County, Iowa",18622,8900,9722,27679,12034,1618,653,202,279,18326,650,658,1308,1687,688,999,9446,59
19155,"Pottawattamie County, Iowa",93198,46015,47183,29085,62717,9167,2886,601,302,92073,4244,3262,7506,10668,4626,6042,46098,315
19127,"Marshall County, Iowa",40735,20641,20094,25693,27001,3786,1079,193,215,39882,1745,1332,3077,4267,2213,2054,19016,135
19043,"Clayton County, Iowa",17735,8875,8860,27719,12594,1402,396,93,37,17505,672,657,1329,1841,825,1016,8792,66
19015,"Boone County, Iowa",26411,13295,13116,30190,18380,2846,872,192,215,25794,999,610,1609,2659,1104,1555,13443,32
19017,"Bremer County, Iowa",24663,12171,12492,32105,16174,3254,938,157,156,24320,530,293,823,1677,665,1012,12782,45
19021,"Buena Vista County, Iowa",20445,10363,10082,26345,12846,1653,442,156,151,20177,1393,1021,2414,2575,1135,1440,10423,40
19089,"Howard County, Iowa",9430,4689,4741,27906,6415,585,205,50,8,9249,321,386,707,1063,425,638,4551,72
19063,"Emmet County, Iowa",9820,4828,4992,29396,6711,892,224,33,24,9556,475,341,816,1223,439,784,4792,2
19077,"Guthrie County, Iowa",10691,5354,5337,30646,7574,1085,293,126,52,10565,417,275,692,1116,461,655,5234,48
19081,"Hancock County, Iowa",11006,5555,5451,29147,7771,1121,343,67,18,10852,290,241,531,1026,457,569,5527,47
19121,"Madison County, Iowa",15661,7830,7831,31449,10603,1875,432,60,14,15475,447,412,859,1054,499,555,7802,15
19125,"Marion County, Iowa",33197,16457,16740,27815,21618,3809,1271,134,285,32954,662,429,1091,3108,1348,1760,16820,97
19197,"Wright County, Iowa",12891,6428,6463,28200,8968,1091,309,83,41,12713,566,429,995,1625,719,906,5705,30
19029,"Cass County, Iowa",13433,6633,6800,26427,9470,1404,333,96,45,13173,458,240,698,1985,919,1066,6538,28
19047,"Crawford County, Iowa",17147,8720,8427,27270,11027,1014,187,77,7,16951,1030,767,1797,3681,1800,1881,8048,336
19065,"Fayette County, Iowa",20391,10269,10122,27020,13924,1866,583,163,114,20047,805,723,1528,2581,1201,1380,9723,64
19085,"Harrison County, Iowa",14335,7101,7234,29332,10029,1328,315,74,32,14090,646,458,1104,1474,609,865,7172,41
19129,"Mills County, Iowa",14841,7534,7307,31309,10174,1775,539,61,58,14625,517,315,832,1203,612,591,7203,63
19133,"Monona County, Iowa",9013,4451,4562,26829,6572,740,271,36,45,8796,316,293,609,1273,561,712,4189,35
19143,"Osceola County, Iowa",6154,3105,3049,26776,4317,544,142,26,5,6055,246,233,479,631,264,367,3231,31
19187,"Webster County, Iowa",37050,19089,17961,24629,24837,3760,992,234,133,35335,1389,1090,2479,5362,2111,3251,16366,98
19169,"Story County, Iowa",94834,49349,45485,27392,48629,13631,6650,998,3158,94134,2412,1645,4057,19039,10153,8886,49847,117
19013,"Black Hawk County, Iowa",132821,65049,67772,27669,83290,14843,5148,1208,1274,131568,4638,4059,8697,19605,8640,10965,66637,517
19075,"Grundy County, Iowa",12373,6076,6297,35662,8625,1629,432,92,15,12226,246,191,437,722,283,439,6119,17
19105,"Jones County, Iowa",20481,10580,9901,29653,14593,1747,560,79,56,19241,516,454,970,2034,861,1173,9323,49
19131,"Mitchell County, Iowa",10757,5351,5406,27407,7316,853,260,26,6,10541,540,455,995,970,485,485,5110,53
19137,"Montgomery County, Iowa",10380,4965,5415,25005,7350,848,243,32,18,10194,494,333,827,1529,624,905,4620,54
19161,"Sac County, Iowa",10034,4925,5109,29502,7114,1017,270,56,33,9840,344,287,631,997,418,579,4907,30
19123,"Mahaska County, Iowa",22324,11323,11001,26575,15056,2546,815,155,83,22097,774,394,1168,3010,1393,1617,10805,91
19019,"Buchanan County, Iowa",21031,10453,10578,30974,13951,1957,440,104,10,20773,897,751,1648,1905,852,1053,10119,191
19045,"Clinton County, Iowa",47972,23508,24464,28091,33105,4476,1473,259,204,47495,1321,1103,2424,6405,2724,3681,22306,149
19053,"Decatur County, Iowa",8210,4108,4102,21110,4978,648,266,31,56,8102,465,575,1040,1552,762,790,3598,26
19101,"Jefferson County, Iowa",17662,9395,8267,26630,12433,2306,1389,196,226,17511,861,470,1331,2504,1486,1018,7933,47
19005,"Allamakee County, Iowa",14001,7106,6895,27377,9854,1205,319,105,49,13693,578,578,1156,1388,527,861,6815,101
19113,"Linn County, Iowa",218076,107727,110349,32786,145121,31995,10922,2367,1489,216100,6138,4877,11015,19912,8866,11046,114085,607
19049,"Dallas County, Iowa",78074,38507,39567,42417,50916,17176,4772,1413,783,77546,1830,1415,3245,4424,1812,2612,42116,182
19141,"O'Brien County, Iowa",14055,7044,7011,32051,9768,1482,285,147,39,13848,372,388,760,1278,511,767,7117,36
20187,"Stanton County, Kansas",2115,994,1121,21062,1415,267,69,0,15,2085,141,150,291,153,60,93,1098,20
20119,"Meade County, Kansas",4310,2177,2133,25173,2801,462,134,14,6,4184,254,205,459,591,222,369,2081,29
20125,"Montgomery County, Kansas",33765,16677,17088,22823,22644,2641,1077,171,94,33227,2064,2031,4095,6225,2955,3270,14247,135
20151,"Pratt County, Kansas",9729,4858,4871,27063,6328,1153,368,56,34,9511,480,490,970,1226,530,696,4451,78
20153,"Rawlins County, Kansas",2557,1293,1264,27615,1902,340,91,21,2,2518,70,80,150,204,82,122,1177,12
20003,"Anderson County, Kansas",7858,3899,3959,21887,5357,547,310,156,14,7754,488,466,954,1171,568,603,3606,62
20053,"Ellsworth County, Kansas",6375,3624,2751,24102,4631,676,152,62,22,5481,171,156,327,460,179,281,2686,49
20061,"Geary County, Kansas",36818,19465,17353,21583,19630,2730,1018,109,155,31396,1840,1519,3359,4482,1902,2580,17360,375
20057,"Ford County, Kansas",34492,17844,16648,22053,20281,2469,883,152,107,33995,2923,2717,5640,5871,2925,2946,16147,346
05073,"Lafayette County, Arkansas",7127,3498,3629,25140,5074,551,83,40,20,6995,508,447,955,1830,777,1053,2433,32
05105,"Perry County, Arkansas",10246,5104,5142,21781,7171,529,186,25,22,10126,520,532,1052,1804,716,1088,3930,12
05111,"Poinsett County, Arkansas",24131,11833,12298,18361,16322,1069,363,72,59,23816,1693,1619,3312,5238,2365,2873,9060,83
05133,"Sevier County, Arkansas",17193,8586,8607,18388,10638,615,324,37,22,17030,1636,1538,3174,3804,1755,2049,7101,40
05013,"Calhoun County, Arkansas",5210,2679,2531,22866,3704,312,102,10,21,5152,319,312,631,969,458,511,2158,22
05011,"Bradley County, Arkansas",11096,5485,5611,21575,7582,798,221,38,22,11005,788,789,1577,3163,1328,1835,3934,93
05075,"Lawrence County, Arkansas",16915,8310,8605,19422,11438,969,471,32,62,16606,1086,1026,2112,3840,1799,2041,6313,75
05113,"Polk County, Arkansas",20290,9887,10403,18735,14094,1119,479,61,70,20153,1393,1629,3022,5069,2427,2642,7101,40
05029,"Conway County, Arkansas",21060,10306,10754,22365,14516,1641,633,76,106,20904,1100,1173,2273,4482,2073,2409,8222,83
05101,"Newton County, Arkansas",7988,4013,3975,18053,5893,543,264,28,39,7927,555,507,1062,1713,722,991,2940,47
05081,"Little River County, Arkansas",12616,6266,6350,23412,8921,672,170,18,7,12453,893,733,1626,2384,1062,1322,4590,41
05085,"Lonoke County, Arkansas",71279,35076,36203,25184,46472,6390,2210,362,103,69752,3643,3420,7063,8535,3491,5044,32760,182
05091,"Miller County, Arkansas",43666,21577,22089,22227,29461,2885,1099,173,114,42496,3258,3358,6616,8749,3551,5198,17920,130
05123,"St. Francis County, Arkansas",27023,14625,12398,16518,18555,1156,625,103,45,23540,1994,1469,3463,5761,2525,3236,8884,190
05145,"White County, Arkansas",78823,38642,40181,23120,50487,5529,2974,418,844,78229,5307,4314,9621,13201,5859,7342,32003,80
06047,"Merced County, California",265001,133782,131219,20120,154008,13682,4956,1238,1165,261996,19864,14235,34099,62661,29744,32917,93760,2865
06043,"Mariposa County, California",17645,8881,8764,28241,13540,1879,839,210,137,17475,711,556,1267,2849,1507,1342,6966,21
06115,"Yuba County, California",73897,37471,36426,22814,45723,4885,1693,432,99,71472,4769,3981,8750,15080,6977,8103,27106,172
06013,"Contra Costa County, California",1107925,540671,567254,42898,752880,192616,73252,22496,14818,1102457,51057,42563,93620,111922,49151,62771,506484,5639
06035,"Lassen County, California",31945,21191,10754,20974,22818,1749,728,281,103,22153,945,864,1809,3558,1863,1695,8760,38
06099,"Stanislaus County, California",530561,262151,268410,24007,331349,36783,11983,4428,1544,527228,34244,26472,60716,95739,42967,52772,206066,1681
06097,"Sonoma County, California",497776,243919,253857,37767,350617,74393,26826,10000,4723,493344,27304,22588,49892,55095,25512,29583,238691,1611
06103,"Tehama County, California",63015,31379,31636,22631,42822,3939,1353,441,179,62487,3623,3138,6761,13363,6347,7016,22690,214
06051,"Mono County, California",14051,7551,6500,30888,9287,2063,539,224,20,13964,1648,1135,2783,1222,571,651,7522,51
06069,"San Benito County, California",58051,29062,28989,30012,36661,4777,1439,500,233,57892,3810,2784,6594,6224,2664,3560,25603,124
06067,"Sacramento County, California",1479300,722955,756345,29693,978644,189759,64859,22097,9868,1464006,83477,68179,151656,260877,121935,138942,632480,5440
06017,"El Dorado County, California",183000,91349,91651,38156,130300,27316,10371,3390,1900,181900,7992,5920,13912,17839,8477,9362,78177,496
06053,"Monterey County, California",430201,219883,210318,27168,270496,38978,16843,4788,3361,413350,37175,29395,66570,66289,31000,35289,182614,12969
06091,"Sierra County, California",2931,1449,1482,31750,2381,352,82,20,17,2902,168,68,236,329,179,150,1186,0
23015,"Lincoln County, Maine",34165,16771,17394,31522,25993,4903,2580,434,517,33658,2194,1635,3829,4050,1881,2169,16306,180
23027,"Waldo County, Maine",39071,19311,19760,27763,28494,5238,2375,366,336,38861,2413,2213,4626,6097,2757,3340,17776,181
23019,"Penobscot County, Maine",152978,75521,77457,26347,106526,17025,6213,1371,1736,151304,8666,7240,15906,23793,10748,13045,71346,840
23021,"Piscataquis County, Maine",17044,8470,8574,23464,12999,1466,510,88,59,16910,1167,999,2166,3448,1566,1882,6417,29
23001,"Androscoggin County, Maine",107376,52566,54810,26276,74194,10309,3592,974,486,106345,5262,3935,9197,15370,7028,8342,52190,202
23003,"Aroostook County, Maine",69405,34255,35150,23631,50858,6495,1919,449,339,68334,3691,2785,6476,11929,5510,6419,29996,304
23029,"Washington County, Maine",31925,15779,16146,24311,23457,3089,1149,260,216,31349,2164,1808,3972,5561,2372,3189,12591,117
23005,"Cumberland County, Maine",288204,140167,148037,36780,205616,57284,22921,6886,3495,284982,12120,9233,21353,31192,14325,16867,152389,947
23013,"Knox County, Maine",39717,19601,20116,29806,29796,5860,2253,525,368,38590,2664,2138,4802,4577,2318,2259,18831,121
23023,"Sagadahoc County, Maine",35134,17052,18082,32947,25868,5637,2248,450,328,34981,1541,1173,2714,3718,1554,2164,17677,116
23031,"York County, Maine",200536,97912,102624,33635,145205,29182,10679,1978,1817,198742,10003,7224,17227,18486,7674,10812,102135,682
23011,"Kennebec County, Maine",120953,58816,62137,27336,86359,13097,6304,1252,1165,119555,5886,4242,10128,17110,7727,9383,55717,509
23007,"Franklin County, Maine",30270,14841,15429,24162,21515,3671,1381,211,279,30119,1638,1647,3285,4089,1819,2270,14040,68
23025,"Somerset County, Maine",51363,25361,26002,22641,37544,4106,1273,394,169,50873,3333,2434,5767,9118,4212,4906,21809,338
23009,"Hancock County, Maine",54483,26530,27953,31178,40820,8103,3663,708,798,54042,3895,3089,6984,6420,2729,3691,25550,250
24047,"Worcester County, Maryland",51441,24999,26442,34425,38616,7325,3098,754,383,50790,2337,1633,3970,5162,2237,2925,23365,225
24510,"Baltimore city, Maryland",621000,292168,328832,28488,422021,66163,38436,12068,8756,611099,31120,24075,55195,137964,60287,77677,270104,2384
24039,"Somerset County, Maryland",25899,13936,11963,18395,16959,1356,771,123,120,21455,917,1043,1960,4826,1896,2930,8013,123
24041,"Talbot County, Maryland",37668,17733,19935,44785,28138,5392,3037,891,763,37276,1418,1169,2587,4064,1617,2447,17383,95
24025,"Harford County, Maryland",249776,122076,127700,37972,171128,35441,18683,2478,2380,246870,6555,4704,11259,19012,7860,11152,127349,660
24027,"Howard County, Maryland",308447,151100,157347,51045,207335,62207,44000,10545,9814,305577,8139,7571,15710,15109,6277,8832,164257,1156
24033,"Prince George's County, Maryland",897693,431752,465941,34391,597885,107860,61867,8844,9489,890902,65256,49268,114524,84744,37050,47694,462632,2823
24005,"Baltimore County, Maryland",825666,391102,434564,37270,569088,121891,62727,16515,10559,817420,33410,26823,60233,74876,31332,43544,408917,3773
24021,"Frederick County, Maryland",243465,120072,123393,39566,163563,38413,19600,3220,3761,241125,8009,6657,14666,16995,7451,9544,127027,772
24023,"Garrett County, Maryland",29677,14701,14976,26303,21250,2205,1414,246,224,29195,1413,1177,2590,3666,1627,2039,13790,59
24029,"Kent County, Maryland",19819,9539,10280,32217,13928,2299,1230,348,377,19464,746,530,1276,2193,1051,1142,8919,68
24013,"Carroll County, Maryland",167535,82892,84643,39690,114734,24569,11083,1910,1105,165565,4179,3070,7249,9383,4159,5224,86900,290
24035,"Queen Anne's County, Maryland",48712,24151,24561,40553,34080,7229,3360,822,508,48165,1336,1063,2399,3139,1557,1582,25058,210
24017,"Charles County, Maryland",154357,74489,79868,38890,101706,16756,9113,1109,852,151456,3810,2864,6674,11637,4529,7108,77928,375
24043,"Washington County, Maryland",149571,76043,73528,28742,103724,12720,6500,1003,623,141178,6186,4933,11119,18166,7570,10596,65935,346
28015,"Carroll County, Mississippi",10301,5229,5072,22995,7274,716,306,102,50,10143,652,555,1207,1759,728,1031,3722,11
28039,"George County, Mississippi",23313,11736,11577,20973,15142,1298,542,69,73,22860,2131,1691,3822,4096,1882,2214,7901,187
28043,"Grenada County, Mississippi",21518,10281,11237,20150,14485,1579,732,79,48,21179,1542,1463,3005,5090,2403,2687,8159,121
28063,"Jefferson County, Mississippi",7528,3732,3796,13758,4937,340,459,54,27,7083,499,291,790,2812,1042,1770,2003,44
28101,"Newton County, Mississippi",21652,10184,11468,21177,13819,1429,612,37,105,21485,1369,1422,2791,4895,2041,2854,7951,150
28117,"Prentiss County, Mississippi",25339,12355,12984,19016,16756,1221,614,146,23,25050,1958,1964,3922,5485,2441,3044,9619,64
28125,"Sharkey County, Mississippi",4662,2148,2514,17192,3052,438,109,9,23,4563,569,398,967,1435,629,806,1439,5
28019,"Choctaw County, Mississippi",8320,4037,4283,19816,5701,545,242,50,42,8214,582,411,993,1993,842,1151,2895,79
28045,"Hancock County, Mississippi",46028,22404,23624,24373,31990,4182,1938,383,195,45882,4441,3743,8184,8490,3996,4494,19312,190
28057,"Itawamba County, Mississippi",23511,11643,11868,20859,15655,1358,571,89,39,23282,1551,1423,2974,4544,2137,2407,9003,62
28055,"Issaquena County, Mississippi",1352,831,521,16348,1054,50,28,10,7,1067,94,53,147,431,218,213,358,4
28059,"Jackson County, Mississippi",140850,69209,71641,24665,94378,11707,5937,1173,497,139496,10864,11387,22251,21818,9425,12393,58524,481
28083,"Leflore County, Mississippi",30500,14123,16377,15403,18494,2210,940,162,160,30002,2488,2427,4915,11765,4901,6864,9251,23
28143,"Tunica County, Mississippi",10407,4809,5598,18486,6292,826,280,88,0,10283,811,821,1632,2925,1145,1780,4147,34
28021,"Claiborne County, Mississippi",9209,4309,4900,13095,5277,549,351,66,48,9155,801,640,1441,3554,1717,1837,2336,28
28047,"Harrison County, Mississippi",198570,98115,100455,23127,129834,17647,7429,1572,1284,191097,17893,16414,34307,40538,17781,22757,87294,610
28075,"Lauderdale County, Mississippi",79233,38430,40803,23339,52341,6469,2618,616,361,76212,5080,6012,11092,17541,6844,10697,32346,375
28085,"Lincoln County, Mississippi",34691,16606,18085,20627,22981,2037,956,249,158,34097,2142,2340,4482,8687,3809,4878,12467,145
28127,"Simpson County, Mississippi",27279,13309,13970,19336,18086,1498,603,181,24,26683,2219,2095,4314,7299,3374,3925,10075,133
28159,"Winston County, Mississippi",18519,9046,9473,23527,12718,1500,484,85,126,18061,1045,1243,2288,5113,2023,3090,7124,136
28007,"Attala County, Mississippi",19085,8996,10089,20617,12622,1141,569,119,37,18780,1289,1026,2315,4574,1803,2771,6484,266
28073,"Lamar County, Mississippi",59623,28686,30937,28342,38492,9062,3350,961,792,58827,4086,4181,8267,9535,4285,5250,28211,1190
28081,"Lee County, Mississippi",85281,40811,44470,23968,55985,8267,3179,972,507,84330,5457,5015,10472,15531,6763,8768,37141,201
28135,"Tallahatchie County, Mississippi",14776,8726,6050,14163,10130,636,203,16,48,10687,735,643,1378,3002,1241,1761,3542,19
28129,"Smith County, Mississippi",16137,7733,8404,21864,10764,756,489,25,16,16050,824,1079,1903,3640,1470,2170,6242,188
28149,"Warren County, Mississippi",47834,22725,25109,22542,31728,4394,2328,396,379,47401,3586,3063,6649,11252,4605,6647,19254,153
28023,"Clarke County, Mississippi",16203,7616,8587,20564,11108,1035,415,103,11,16148,803,970,1773,3087,1260,1827,5894,186
28097,"Montgomery County, Mississippi",10353,4916,5437,22666,7013,842,333,74,37,10233,411,554,965,2913,1120,1793,3781,51
28105,"Oktibbeha County, Mississippi",49424,24879,24545,21322,24909,5321,3040,637,1459,49023,3087,2411,5498,14343,6753,7590,19993,68
28155,"Webster County, Mississippi",9922,4872,5050,20662,6812,870,329,17,45,9835,788,479,1267,2110,903,1207,3639,80
28003,"Alcorn County, Mississippi",37309,18354,18955,20527,25189,2560,1010,438,161,36857,3239,2638,5877,7305,3393,3912,14531,58
28025,"Clay County, Mississippi",20147,9343,10804,19220,13395,1608,768,108,52,19875,1501,1545,3046,5159,2175,2984,7628,4
28031,"Covington County, Mississippi",19503,9299,10204,18749,12798,970,624,192,61,19254,1578,1482,3060,4943,1956,2987,6958,132
28053,"Humphreys County, Mississippi",8822,4177,4645,15696,5579,476,278,15,9,8735,841,779,1620,3706,1742,1964,2542,15
42043,"Dauphin County, Pennsylvania",271962,131707,140255,31152,187723,33873,14064,4759,2353,268502,12050,9772,21822,35950,16279,19671,131751,1018
42055,"Franklin County, Pennsylvania",152707,75038,77669,28985,105687,13103,6254,1056,783,151345,9451,7745,17196,17504,7783,9721,70389,345
42119,"Union County, Pennsylvania",45178,24910,20268,25089,30738,3875,1719,438,774,39503,2591,1815,4406,3991,1574,2417,18052,203
42127,"Wayne County, Pennsylvania",51307,27266,24041,25569,38551,4652,2581,364,311,47723,2141,1534,3675,6034,2621,3413,20447,94
42009,"Bedford County, Pennsylvania",48852,24409,24443,24219,35306,2941,1371,360,187,48334,2379,2130,4509,6846,3158,3688,21648,218
42089,"Monroe County, Pennsylvania",167126,82532,84594,27439,113238,17027,7661,1118,866,166133,9103,7140,16243,20071,9525,10546,75073,377
42061,"Huntingdon County, Pennsylvania",45844,24289,21555,22908,32701,3134,1236,167,274,41997,1853,1358,3211,5572,2411,3161,18126,152
42125,"Washington County, Pennsylvania",208269,101979,106290,32828,148646,27553,10884,2068,1320,206621,6822,5058,11880,20471,8937,11534,97094,442
42101,"Philadelphia County, Pennsylvania",1559938,737899,822039,24811,1035252,160379,73892,24010,14505,1545722,104291,80684,184975,392356,175587,216769,639442,5969
42133,"York County, Pennsylvania",440604,217812,222792,30178,304525,45907,18421,4014,2050,435734,17801,13686,31487,45113,19463,25650,214133,1294
42063,"Indiana County, Pennsylvania",87491,43929,43562,25014,56145,7408,3377,474,1179,86008,4999,4429,9428,14533,6898,7635,37239,447
42041,"Cumberland County, Pennsylvania",243838,120485,123353,34246,169530,35250,16088,3467,2230,237370,8367,6684,15051,19828,8764,11064,120856,474
42003,"Allegheny County, Pennsylvania",1230360,593029,637331,35280,880163,201893,97630,25183,19170,1216195,42534,30836,73370,152390,65373,87017,606306,4692
42129,"Westmoreland County, Pennsylvania",359377,175500,183877,31827,263051,45089,19457,3487,2743,355475,10306,8507,18813,36398,15855,20543,169974,720
42053,"Forest County, Pennsylvania",7493,5881,1612,14989,6495,330,176,2,31,3048,104,91,195,387,175,212,992,5
42013,"Blair County, Pennsylvania",125917,61654,64263,25531,88815,11672,4181,921,575,124443,5130,3849,8979,18196,8111,10085,55739,531
42073,"Lawrence County, Pennsylvania",88528,42843,45685,26918,63036,8357,3269,724,464,87500,3280,2945,6225,12374,5382,6992,38329,263
42015,"Bradford County, Pennsylvania",61808,30540,31268,26937,43610,5187,1895,428,201,61190,3090,2345,5435,7562,3320,4242,26192,165
42021,"Cambria County, Pennsylvania",137762,67867,69895,24838,98242,12386,5265,1450,764,133557,4849,3699,8548,20274,8821,11453,56324,489
42029,"Chester County, Pennsylvania",512028,252007,260021,46256,344791,103913,49414,10576,9295,507179,19300,15661,34961,35883,15494,20389,259516,1629
42011,"Berks County, Pennsylvania",414097,203542,210555,29041,278049,42415,18196,3109,1950,409330,19381,15613,34994,57329,26003,31326,194981,1857
42087,"Mifflin County, Pennsylvania",46585,22871,23714,23568,32676,2723,955,181,84,46007,3275,2999,6274,6676,3009,3667,19693,287
29129,"Mercer County, Missouri",3702,1856,1846,20374,2515,271,126,14,13,3646,381,307,688,530,243,287,1583,14
51031,"Campbell County, Virginia",55061,26745,28316,26417,39041,5204,2126,325,296,54569,2741,2562,5303,6799,2800,3999,26049,321
51087,"Henrico County, Virginia",321921,152084,169837,36497,220192,55742,24647,5947,3535,319834,16501,15303,31804,33818,14599,19219,164021,923
51099,"King George County, Virginia",25260,12588,12672,35676,16483,3518,1916,71,175,24873,1032,854,1886,1395,498,897,12407,107
51103,"Lancaster County, Virginia",11055,5128,5927,33997,8694,1401,719,282,184,10961,687,627,1314,1095,397,698,4471,47
51105,"Lee County, Virginia",24911,13083,11828,18514,18465,1372,554,88,134,23396,2107,1607,3714,6080,2528,3552,7438,63
51115,"Mathews County, Virginia",8848,4144,4704,35252,6779,1048,584,109,61,8757,423,310,733,843,443,400,4028,93
51119,"Middlesex County, Virginia",10728,5295,5433,29871,8292,1209,478,155,96,10367,668,347,1015,1130,509,621,4297,74
51149,"Prince George County, Virginia",37664,20615,17049,27970,25977,3810,1525,210,186,32626,1729,1221,2950,3231,1530,1701,15882,372
51159,"Richmond County, Virginia",8868,4960,3908,19728,6679,624,221,5,47,7039,373,413,786,1173,498,675,3127,93
51169,"Scott County, Virginia",22378,11259,11119,20969,16512,1440,433,141,60,21697,1389,1104,2493,4355,1930,2425,8112,45
51177,"Spotsylvania County, Virginia",129181,63429,65752,33859,84467,15385,7986,934,694,128362,7033,6078,13111,10920,4931,5989,62876,506
51011,"Appomattox County, Virginia",15314,7424,7890,26347,10849,1179,722,71,149,15242,683,732,1415,2633,1215,1418,6525,232
51067,"Franklin County, Virginia",56230,27592,28638,27282,40412,5183,2467,457,238,55878,3394,3402,6796,7950,3514,4436,24937,289
51097,"King and Queen County, Virginia",7140,3673,3467,25831,5301,718,262,10,29,7140,489,430,919,1013,520,493,3093,107
51121,"Montgomery County, Virginia",97227,50364,46863,28277,53800,12136,7262,1489,3868,96586,3830,2827,6657,21191,11380,9811,45609,471
51127,"New Kent County, Virginia",20051,10215,9836,36768,14373,2275,1124,95,237,19473,576,650,1226,970,392,578,10070,93
51049,"Cumberland County, Virginia",9769,4779,4990,23488,6843,683,289,34,29,9756,856,582,1438,2204,1198,1006,4446,110
51051,"Dickenson County, Virginia",15304,7814,7490,21082,11043,692,421,39,31,14859,869,820,1689,3196,1485,1711,4815,21
51083,"Halifax County, Virginia",35305,16844,18461,21155,25226,2587,1050,271,84,34592,2418,2445,4863,6498,2857,3641,14051,583
51107,"Loudoun County, Virginia",362435,179315,183120,50456,230834,81174,44288,5527,4834,360391,14210,12715,26925,14313,5917,8396,191979,1244
51153,"Prince William County, Virginia",443630,220996,222634,38225,280543,65693,37684,4268,3032,435485,28830,25577,54407,30869,13809,17060,227832,2156
51175,"Southampton County, Virginia",18291,9555,8736,25784,13326,1472,544,78,50,16820,1173,913,2086,2475,1045,1430,7660,111
51091,"Highland County, Virginia",2230,994,1236,32648,1847,273,115,8,18,2230,163,174,337,279,86,193,962,7
51033,"Caroline County, Virginia",29640,14677,14963,28039,20285,2587,972,28,224,27537,1359,1321,2680,3600,1343,2257,14600,116
51073,"Gloucester County, Virginia",37021,18267,18754,32271,26385,3670,1741,344,195,36385,2185,1720,3905,2798,1070,1728,17787,310
51141,"Patrick County, Virginia",18180,8967,9213,21785,13632,1180,559,51,64,17921,1325,1270,2595,3968,1920,2048,7247,68
51145,"Powhatan County, Virginia",28286,15198,13088,33807,20402,3997,1543,211,63,25657,1069,1083,2152,1431,531,900,12979,203
51171,"Shenandoah County, Virginia",42857,20972,21885,27016,30844,3960,1445,315,273,42398,2285,2342,4627,4514,1770,2744,20061,132
51061,"Fauquier County, Virginia",68025,33659,34366,43067,46507,9642,4571,904,483,67570,3144,2648,5792,4042,1770,2272,34169,293
51790,"Staunton city, Virginia",24234,10937,13297,27571,17330,3343,1723,413,356,23617,1250,1560,2810,3622,1419,2203,11224,186
51065,"Fluvanna County, Virginia",26046,11826,14220,31952,18500,3244,1945,272,275,24798,1118,891,2009,1726,718,1008,11750,34
51007,"Amelia County, Virginia",12793,6642,6151,26118,8924,885,266,78,27,12696,977,847,1824,1465,773,692,5927,123
51750,"Radford city, Virginia",17186,8544,8642,19539,7481,1434,823,118,175,17071,893,661,1554,5580,2752,2828,6955,88
51840,"Winchester city, Virginia",27349,13355,13994,28429,18087,3215,1474,681,286,27102,2428,2055,4483,3847,1639,2208,12538,38
51001,"Accomack County, Virginia",33060,16125,16935,24266,23850,2647,1230,225,271,32677,3040,2826,5866,6341,2818,3523,14142,92
51045,"Craig County, Virginia",5195,2509,2686,26753,3953,389,74,25,24,5178,316,261,577,667,210,457,1942,31
51063,"Floyd County, Virginia",15587,7682,7905,25446,11413,1234,561,110,117,15497,869,617,1486,1832,819,1013,6884,116
51071,"Giles County, Virginia",16871,8233,8638,25004,12051,1133,504,116,158,16756,1299,983,2282,1970,955,1015,7452,73
51077,"Grayson County, Virginia",15180,7463,7717,20525,11446,878,261,29,52,14725,848,828,1676,2899,1215,1684,6165,12
51135,"Nottoway County, Virginia",15641,8483,7158,19452,11010,1095,469,104,10,14317,931,632,1563,3030,1420,1610,5690,193
51157,"Rappahannock County, Virginia",7416,3643,3773,38185,5589,1046,556,99,111,7399,585,560,1145,681,241,440,3454,16
51036,"Charles City County, Virginia",7086,3456,3630,32689,5449,405,212,28,49,7069,496,353,849,1032,362,670,3253,45
51047,"Culpeper County, Virginia",48952,24612,24340,29979,32652,4685,1970,438,197,47534,2821,2767,5588,4330,1725,2605,22194,308
51053,"Dinwiddie County, Virginia",28155,13903,14252,25981,19771,2260,943,57,87,27780,1739,1571,3310,4375,1876,2499,12638,153
51079,"Greene County, Virginia",19085,9321,9764,30215,13147,1974,915,122,200,18887,1409,1534,2943,2076,834,1242,8884,122
51085,"Hanover County, Virginia",102199,50104,52095,37924,69493,16877,6473,1226,912,101502,3136,2620,5756,6201,2650,3551,52846,661
51111,"Lunenburg County, Virginia",12450,6498,5952,18555,9102,726,290,7,47,11496,1002,855,1857,2361,1180,1181,4384,190
51137,"Orange County, Virginia",34873,17110,17763,30660,24552,3741,2184,313,130,34335,2321,1540,3861,3136,1149,1987,15541,142
51595,"Emporia city, Virginia",5565,2564,3001,18548,3699,341,153,38,35,5349,671,506,1177,1764,826,938,1906,0
51197,"Wythe County, Virginia",29171,14234,14937,24879,21223,2286,889,227,119,28954,1617,2164,3781,4677,2102,2575,12524,123
51550,"Chesapeake city, Virginia",233194,113888,119306,32123,154583,29912,13219,2447,1377,220652,9162,9225,18387,21418,8493,12925,112502,877
51660,"Harrisonburg city, Virginia",51979,24857,27122,20134,25193,5322,2550,426,834,51219,3615,3764,7379,14757,6900,7857,24289,95
51003,"Albemarle County, Virginia",104287,49946,54341,39273,70026,17855,10502,3786,3944,102688,3965,4234,8199,9341,4461,4880,49343,520
51019,"Bedford County, Virginia",76933,37888,39045,30633,55090,9619,4124,816,758,76510,3030,3401,6431,7028,3283,3745,35680,431
51029,"Buckingham County, Virginia",17030,9453,7577,19702,12342,984,328,88,69,15063,1268,884,2152,2632,1147,1485,6484,105
51195,"Wise County, Virginia",40074,20706,19368,21694,27966,2489,1085,263,197,37969,2505,2224,4729,7865,3445,4420,13210,46
51580,"Covington city, Virginia",5650,2903,2747,22098,3922,274,113,30,25,5489,350,380,730,1187,407,780,2268,31
51740,"Portsmouth city, Virginia",96071,46306,49765,24291,63473,8653,3528,655,539,92130,5631,5876,11507,16897,6444,10453,43324,447
13011,"Banks County, Georgia",18336,9276,9060,19451,12525,891,361,106,18,18322,1606,1544,3150,2837,1364,1473,7594,40
13031,"Bulloch County, Georgia",73141,36097,37044,20526,39691,6282,3001,770,1159,72293,5171,5446,10617,20922,9770,11152,31383,255
13059,"Clarke County, Georgia",122037,58029,64008,21203,66272,13591,7880,1862,3675,121095,9604,9040,18644,39327,18748,20579,54501,621
13061,"Clay County, Georgia",3068,1471,1597,14559,2084,35,102,16,2,3012,432,340,772,1199,483,716,820,0
20167,"Russell County, Kansas",6988,3511,3477,25686,4996,618,406,101,86,6868,299,303,602,893,461,432,3416,5
20117,"Marshall County, Kansas",9963,4971,4992,27908,7046,864,273,91,32,9776,452,306,758,923,363,560,4893,60
20001,"Allen County, Kansas",12951,6420,6531,23011,8782,1043,473,78,15,12745,685,627,1312,1916,809,1107,5769,43
20023,"Cheyenne County, Kansas",2679,1341,1338,27934,1889,376,57,22,9,2641,117,88,205,234,105,129,1233,7
20035,"Cowley County, Kansas",35977,18085,17892,23130,23421,3136,1129,215,56,34785,2101,1860,3961,5546,2583,2963,15426,150
20049,"Elk County, Kansas",2635,1315,1320,21156,2038,223,103,12,4,2586,126,175,301,449,219,230,1011,23
20059,"Franklin County, Kansas",25663,12513,13150,25701,16959,2237,881,138,122,25495,1026,1056,2082,3357,1492,1865,12312,166
20083,"Hodgeman County, Kansas",1919,967,952,28857,1384,251,84,13,8,1880,89,74,163,108,58,50,999,5
24045,"Wicomico County, Maryland",101527,48364,53163,27755,63454,9966,5279,1004,1123,100239,5204,3904,9108,15924,7004,8920,47925,319
24011,"Caroline County, Maryland",32653,15822,16831,25355,22037,2112,1046,126,87,32278,1884,1363,3247,5484,2276,3208,15162,200
25025,"Suffolk County, Massachusetts",767719,371314,396405,38031,522045,124874,64123,20095,13930,760729,21457,12382,33839,145744,62450,83294,403630,3396
25007,"Dukes County, Massachusetts",17137,8231,8906,42956,12726,3058,1292,459,254,17027,844,423,1267,1544,701,843,8227,21
25017,"Middlesex County, Massachusetts",1567610,765170,802440,47616,1092070,290215,195353,41669,51610,1552097,27861,17900,45761,124652,55065,69587,832827,5590
25005,"Bristol County, Massachusetts",554868,268739,286129,32406,383924,64704,28565,4911,3633,548298,11649,7257,18906,67338,29240,38098,266778,1196
25013,"Hampden County, Massachusetts",468072,225908,242164,28072,311830,48953,25138,5147,2569,462740,10422,5851,16273,80119,35147,44972,210668,1839
25009,"Essex County, Massachusetts",769362,370538,398824,38604,527506,119624,60568,12688,7785,762048,16568,9828,26396,84757,35734,49023,382711,5815
25011,"Franklin County, Massachusetts",70916,34721,36195,33010,52404,9749,6943,858,1263,70143,1167,801,1968,7881,3601,4280,36408,220
25027,"Worcester County, Massachusetts",813589,401320,412269,34691,552915,117602,56110,9921,8926,801421,14737,9445,24182,89860,39518,50342,401840,3327
25015,"Hampshire County, Massachusetts",161035,75315,85720,32198,98409,21496,14792,2910,4813,159618,2551,2047,4598,20315,9692,10623,81188,380
26033,"Chippewa County, Michigan",38330,21209,17121,21958,26407,3383,1284,237,301,34490,1984,1526,3510,5995,3052,2943,15013,85
26005,"Allegan County, Michigan",113666,56627,57039,27172,76426,11004,4182,648,536,112938,4812,3829,8641,13093,5870,7223,51808,266
26125,"Oakland County, Michigan",1235215,600602,634613,40941,860757,221412,121228,30749,14132,1229304,46020,39699,85719,117008,50993,66015,607233,3294
26003,"Alger County, Michigan",9396,5167,4229,21771,7245,925,315,19,52,8415,452,394,846,1096,584,512,3163,14
26121,"Muskegon County, Michigan",172148,85520,86628,22829,115950,14389,5311,796,401,167337,7460,5616,13076,32351,14736,17615,70147,249
26089,"Leelanau County, Michigan",21764,10686,11078,37061,16628,3901,2267,436,236,21619,982,716,1698,1872,919,953,9534,87
26087,"Lapeer County, Michigan",88310,44709,43601,26650,61478,6874,3211,422,422,86823,3813,3368,7181,8914,4006,4908,37122,188
26151,"Sanilac County, Michigan",41761,20737,21024,23924,29278,2380,1206,188,65,41457,2629,2267,4896,6476,2776,3700,17032,115
26073,"Isabella County, Michigan",70574,34284,36290,22009,37410,6022,3139,411,975,69978,4004,3375,7379,18428,8672,9756,31690,144
26131,"Ontonagon County, Michigan",6165,3160,3005,22958,5053,604,213,34,26,6102,410,368,778,928,420,508,1937,12
26157,"Tuscola County, Michigan",54014,27123,26891,23573,38124,3464,1533,219,64,53135,2520,2034,4554,8330,3851,4479,22661,114
26001,"Alcona County, Michigan",10461,5277,5184,24463,8552,789,306,91,50,10361,491,425,916,1536,711,825,3234,54
26067,"Ionia County, Michigan",64126,33776,30350,22715,43274,4854,1596,164,137,60422,2900,1937,4837,8597,4013,4584,26598,104
26079,"Kalkaska County, Michigan",17259,8835,8424,22822,12366,1049,460,98,76,17202,1085,837,1922,2839,1396,1443,6637,31
26021,"Berrien County, Michigan",155134,75899,79235,27505,106865,16937,8736,1818,1109,153951,8661,6918,15579,26963,11661,15302,68394,543
26135,"Oscoda County, Michigan",8374,4312,4062,22343,6228,453,137,42,5,8330,724,614,1338,1621,770,851,2694,80
26165,"Wexford County, Michigan",32829,16433,16396,22028,22657,2537,909,238,101,32582,2139,1490,3629,6080,2998,3082,13312,85
26037,"Clinton County, Michigan",77245,38180,39065,32792,52058,10330,3814,1050,794,76624,2564,1596,4160,8665,3916,4749,36170,171
26043,"Dickinson County, Michigan",25889,12837,13052,25998,18806,3058,939,292,112,25525,1213,781,1994,3720,1585,2135,10930,67
26063,"Huron County, Michigan",32021,15928,16093,26352,23515,2377,857,231,43,31646,1562,1151,2713,4399,2016,2383,13657,76
26065,"Ingham County, Michigan",284559,138257,146302,27399,170159,34987,18097,4756,6353,282798,12494,9471,21965,59145,27489,31656,131515,503
